абсолютный: абсолютного
август: август августа
австралия: австралии
автор: авторы автора
авторство: авторства
адыгабзэ: адыгабзэ
азиатский: азиатским
азия: азии
айдахар: айдахар
активный: активный
александр: александр
алконост: алконоста
алфавит: алфавиту
аналог: аналог
аналогичный: аналогичный аналогично
англ: англ
английский: английский английского
андрей: андрей
андрогин: андрогин
андромеда: андромеда
анна: анна
античный: античных
антрополог: антрополог
аористический: аористическая
апоп: апоп
апопа: апопа
апопом: апопом
аппетит: аппетит
апрель: апреля
арнем: арнем
арсеньев: арсеньев
археолог: археолог
археология: археология
архив: архив
архивировать: архивировано
архивный: архивная
архимандрит: архимандрита
ассоциация: ассоциации
ассоциироваться: ассоциируется
астрология: астрологии
атака: атак
атрибут: атрибутами атрибуты
б: б
бежать: бежать
беларуская: беларуская
беленицкий: беленицкий
беовульф: беовульф
бертуха: бертуха
беседа: беседа
бескрылый: бескрылые
бессмертие: бессмертием
бестиарий: бестиарий
библейский: библейская библейской библейских
библиографический: библиографических
библия: библии
билибин: билибин
битва: битва битве битвы
благодаря: благодаря
блаженный: блаженному
бласт: бласт
ближневосточный: ближневосточных
ближний: ближнего
близкий: близкое
бог: бога богов богом
богатырка: богатыркой
богатырский: богатырский
богослов: богослова
боевой: боевое
божественный: божественное
божество: божеств божествах
бой: бой
болгария: болгария
болгарский: болгарской
болотистый: болотистых
больший: большая больше
большинство: большинстве
большой: большое
бондарь: бондарь
ботаника: ботанике
бояться: боятся
брачный: брачной
бремнера: бремнера
британский: британской
брокгауза: брокгауза
бром: бром
бронзовый: бронзового
бум: бум
български: български
быть: суть были
бэйхай: бэйхай
вавельского: вавельского
вавельскому: вавельскому
вавилак: вавилак
вагинальный: вагинальной вагинальная
валерий: валерия
варварский: варварской
вариант: вариантов
варна: варны варне
вверх: вверх
вдохновить: вдохновлены
век: века веках веке
великий: великую
веровать: верующих
вероятно: вероятно
версия: версия
верх: верх
весь: вся
ветвь: ветвях
ветхий: ветхом
вещь: вещах
взгляд: взглядом
взращивать: взращивать
виверна: виверна
вивернами: вивернами
виверну: виверну
вид: вида
видеть: видеть видит вижу
видимо: видимо
видное: видное
викиданных: викиданных
викимедиа: викимедиа
викинг: викингов
викиновости: викиновости
википедии: википедии
википедия: википедия
викисклад: викисклад
викискладе: викискладе
викисловаре: викисловаре
викисловарь: викисловарь
викитеке: викитеке
викитеку: викитеку
викицитатник: викицитатник
викицитатнике: викицитатнике
винклер: винклер
висеть: висят
вишап: вишап
вклад: вклад
включать: включают включать
владимир: владимир
властитель: властителей
власть: власть
влияние: влияние
вместе: вместе
внешний: внешние внешнего
внимание: внимание
внутри: внутри
внутрь: внутрь
вовсе: вовсе
вод: воду
вода: водой
водный: водными
воды: вод
воздух: воздух
возможно: возможно
возмутить: возмутил
возмущение: возмущение
возникнуть: возникли
возродиться: возродиться
возрождение: возрождения
войти: вошло войти
вокруг: вокруг
волшебный: волшебной волшебные
волшебство: волшебства
вопрос: вопрос
восемь: восьми
восседать: восседает
восстановление: восстановления
вост: вост
восток: востока
восточноазиатский: восточноазиатских
восточный: восточный восточных
впервые: впервые
вплетаться: вплетается
впоследствии: впоследствии
враждебный: враждебным
вредитель: вредителя
временить: времени
временной: временной
время: временем время
вритру: вритру
все: всему всех всего
вскоре: вскоре
встреча: встреч
встречаться: встречается встречающихся встречаются
встроить: встроен
вступать: вступающих
втора: втор
вторжение: вторжения
вход: вход
выбираться: выбирался
выводить: выводит
выдвигать: выдвигает
выдыхать: выдыхать
вызвать: вызвала вызваны вызван
вызывать: вызывает вызывающим
вымереть: вымершего вымершие
выражаться: выражается
выразить: выражена
выращивание: выращиванию
высокий: высокого высокий
высота: высоту
выступать: выступает выступающие выступают
вытатуировать: вытатуированного
вытянутый: вытянутого вытянутым
вытянуться: вытянуться
вьетнамский: вьетнамский
г: г
гарри: гарри
георг: георг
георгий: георгия георгии
геральдика: геральдике геральдики
геральдический: геральдической
герб: герба
гербоведъ: гербоведъ
герой: героя героями
гибридный: гибридных
гигант: гигантах
гигантский: гигантская гигантские гигантских гигантский гигантское
гидра: гидру
гипотеза: гипотеза гипотезу
гл: гл
главное: главными
главный: главный
глагол: глагола
глаз: глазами глаз глаза
глубокий: глубоких
говорят: говорят
год: году годах год года
голова: голову
гонка: гонок
горазд: гораздо
горный: горных горной
горожанин: горожан
государственный: государственного
грек: греком
греча: греч
греческий: греческое греческого греческие греческой
гроза: грозы
гром: грома
группа: групп
далекий: дальше
даль: даля
дата: дата
датский: датская
дать: данным дал
два: две двух
дворец: дворца
дева: девы
девица: девицей девица
девственность: девственности
девушка: девушкой девушек
девять: девяти
действовать: действовать
декабрь: декабря
делать: делает
делаться: делается
дело: деле
денвен: денвен
день: дне
дерево: дерева дереве
держать: держащих
десакрализацию: десакрализацию
десятилетие: десятилетие
детская: детской
деть: дев
дж: дж
джеральд: джеральд
джефф: джефф
джон: джон
джонс: джонс
джордж: джорджа джорджем
диалект: диалекте
дикий: диких
династия: династии
динозавр: динозавров динозаврами динозаврам
длинный: длинным
дмитрий: дмитрий
дневной: дневное
добрыня: добрыня
добыть: добыть
дождь: дождями
доисторический: доисторическими доисторическим доисторических
доклад: докладов
долгий: долгое
должен: должны должна
домашний: домашнего
донаучный: донаучных
доп: доп
дополнительный: дополнительные
достигать: достигает
доступный: доступен доступная
дракон: дракона драконам дракону драконом драконе драконов драконами драконах драконы дракон
драконий: драконьей драконий драконья
драконоборец: драконоборец
драконоборцами: драконоборцами
драконоборце: драконоборце
драконоборческих: драконоборческих
драконообразные: драконообразные
драконоподобным: драконоподобным
драконоподобных: драконоподобных
дракофиллум: дракофиллум
дракохелис: дракохелис
драцена: драцена
древнеанглийский: древнеанглийское
древнегреческий: древнегреческие древнегреческого
древнеегипетский: древнеегипетская
древнефранцузского: древнефранцузского
древние: древних
древний: древнем древней древнего
древность: древности
древо: древа
дрессировщик: дрессировщика
друг: друзей другом друга
другой: другим другой другими другие других
дуат: дуат
дуате: дуате
дунфу: дунфу
духовная: духовным
дьявол: дьяволу дьявол
дьяволица: дьяволица
дэвид: дэвид
е: е
ева: ева
евр: евр
еврейский: еврейская еврейской
европа: европе европы
европейский: европейские европейский
египет: египта
египетский: египетской египетского египетском
еда: еду
единственный: единственным
единый: единого
ездовой: ездовых
елизаветинский: елизаветинской
ефрона: ефрона
жанр: жанров
ждановский: ждановская
женский: женский женской
женщина: женщины
живой: живых
животное: животного животным животных животными
жилища: жилища
жираф: жирафов
житель: жителями
жить: живущих живут
журнал: журнал
забирания: забирания
забирать: забирает
завет: завете
заглавный: заглавная
заимствовать: заимствовано
закат: закат
заключать: заключает
закрытый: закрыты
заменить: заменить
заменяться: заменяется
замести: заметен
занимать: занимают
заниматься: заниматься
заостряться: заостряется
западноевропейский: западноевропейской
западный: западной
запирание: запирания
запирать: запирает
запись: запись
заполнить: заполнить
заполучить: заполучил
запрос: запрос запросы
зарегистрировать: зарегистрированный
засвидетельствовать: засвидетельствованные
засуха: засуху
затмение: затмения
заявление: заявление
заявлять: заявляет
звук: звука
звукоподражание: звукоподражанием
здание: здания
землетрясение: землетрясения
земля: земля
зло: зло зла
злотницкий: злотницкий
змееборство: змееборства
змееборческие: змееборческие
змееборчества: змееборчества
змеевидный: змеевидным змеевидном
змееобразный: змееобразный
змееподобный: змееподобное змееподобных
змеиный: змеиную
змей: змеев
змея: змеи змей змеях змея змеями змее змеям
змий: змия змием змий
знак: знак
знакомый: знаком
знать: знал
значение: значению значения значение значениях
значительно: значительно
значительность: значительности
значительный: значительное
золотой: золотое
зоология: зоологии
зорич: зорич
зоркий: зоркими
зуб: зубами
игра: игра играх игре игры
игромедиа: игромедиа
игуана: игуаны
идентифицироваться: идентифицируются
иер: иер
избранный: избранные
избыток: избыток
извергать: извергать
известный: известные известным
извне: извне
изли: изли
изменение: изменение
изнутри: изнутри
изображать: изображающий изображают изображали
изображаться: изображались изображаются изображается
изображение: изображениями изображения изображение
изобразительный: изобразительном изобразительное
изучение: изучению
иконография: иконография
ил: ил
иллюстратор: иллюстратора
иллюстрация: иллюстрация иллюстрациями
именительный: именительный
именно: именно
иметь: имел имеющих имеют иметь имеет имели
император: императору император императором
империя: империи
имя: имени
инверсия: инверсией
инвертировать: инвертированы
индий: индии
индоевропейский: индоевропейской индоевропейских
индустрия: индустрии
инициант: инициант
инициационная: инициационная
инициационную: инициационную
инициация: инициации
иногда: иногда
иной: иных иной
иноязычный: иноязычного
инстинкт: инстинкт
инстинктивный: инстинктивные
инструмент: инструменты
интеллект: интеллект
интервью: интервью
интернет: интернет
иоанн: иоанна
ирон: ирон
ирэдзуми: ирэдзуми
искать: ищет
искусство: искусстве искусство
использование: использование использования использованием
использовать: используемым использующие
использоваться: используются используется
испытание: испытание
исследование: исследование
исследователь: исследователи
истад: истаде
исторический: исторический исторические
история: историях история истории
источник: источниках источниками источнике источником источник
исходить: исходит
итог: итоге
иудейский: иудейских
июнь: июня
каждый: каждой каждый
казаться: кажутся
калининград: калининград
кантонский: кантонском
караваев: караваев
картина: картинах картине
касаться: касается
каталанский: каталанская
каталог: каталогах
категория: категории
качество: качестве качествам
керамик: керамике
кета: кета
кинематограф: кинематографе
кит: кит
китай: китае китай китая
китайский: китайский китайских китайской
китч: китч
классификация: классификация
книга: книг книги книгам книге книга
код: код
кодекс: кодекс
кожа: кожу
коитальный: коитальный
количество: количество
кольцо: кольцах
комодо: комодо
компиляция: компиляцию
композиция: композиция
компьютерный: компьютерных компьютерные компьютерной
конечный: конечном
конференция: конференция
конфиденциальность: конфиденциальности
концзя: концзя
копить: копят
копия: копия
корабль: кораблях корабль
корейский: корейский корейской
корень: корней корни корень
королевский: королевскому
король: король короля
короткий: короткий
кость: костей кости
кот: кота
который: которое которому которой которого которые которых которая котором который
коуэлл: коуэлл
кошачий: кошачьих кошачьим
кошка: кошками кошки
кремень: кремня
крессиды: крессиды
кривошеина: кривошеина
кровь: крови кровь
крокодил: крокодилы
крокодиломорфами: крокодиломорфами
крупный: крупным крупной крупных
крылатый: крылатого
крыло: крылья
крыша: крыше
кто: кому
куда: куда
кук: куки
культура: культуре культурах культуры культур
кундалини: кундалини
курбский: курбский
кыргызча: кыргызча
лабиринт: лабиринт
ладона: ладона
лакиер: лакиер
лапа: лап лапы
ларри: ларри
латинский: латинские латинских латинского латинскому
левиафан: левиафана левиафан
легенда: легенде легенды
легендарный: легендарные легендарном
лед: льда
лейтон: лейтон
ленда: ленда
ленский: ленский
лернейский: лернейскую
лес: лесах
лесной: лесных
летать: летать
летописец: летописцами
летучий: летучие
либо: либо
ливень: ливни
литература: литературы литература литературе
лицензия: лицензии
личной: личных
лодка: лодок
локвуд: локвуд
локвуда: локвуда
локвудом: локвудом
локхарда: локхарда
лонг: лонг
луна: лун
любить: любил
любой: любых любой
люлей: люлей
люлея: люлея
м: м
майкл: майкл
майор: майор
македонский: македонски
максим: максимом
малый: малый
мартин: мартина мартином
массив: массивах
массивный: массивным
массовый: массовой
мастер: мастером
материал: материал
медиафайлы: медиафайлы
медицина: медицине
мелетинский: мелетинский
менее: менее
меняться: меняется
месопотамии: месопотамии
место: место местах
механик: механика
мешкерис: мешкерис
мигрировать: мигрирующие
мир: мира миру мир мире
мировой: мирового
мистерия: мистерия
мистический: мистического
миф: мифе мифа миф мифах мифов мифы
мифический: мифическое мифическим мифических
мифологический: мифологический мифологической мифологические мифологического
мифология: мифологии мифология
мк: мк
млекопитающее: млекопитающего
мнение: мнению мнения
многие: многие многих
много: более много
мобильный: мобильная
можно: можно
монстр: монстры
морской: морском морские морская
московский: московской
мотив: мотив
мочь: мог можете могли могут
мудрость: мудрость
мужской: мужской мужское
мускулатура: мускулатуру
мы: нами
мясо: мясо мяса
н: н
навеять: навеяны
навигация: навигации навигация
наводнение: наводнение
награда: награду
над: над
название: названия названий название
названый: назван
наиболее: наиболее
найти: найти
наконец: наконец
нанять: нанял
написать: написанный написан
напоминать: напоминать напоминающие напоминают
например: например
народ: народов народа
народный: народных
настолько: настолько
настольный: настольной
настоящее: настоящее настоящему
наука: наука
научный: научная научных научной
находить: находили находит
находиться: находящимся
находка: находках находками
начало: начало начале начал
наш: нашего наше
небо: неба
неверный: неверный
невеста: невеста невесту невесты
неем: неем
некий: неких
некого: некого
некоммерческий: некоммерческой
некорректный: некорректным
некоторые: некоторым некоторых некоторые
немалый: немало
ненасытный: ненасытный
необходимый: необходимый
необычайно: необычайно
необычность: необычностью
необычный: необычных
неожиданно: неожиданно
неолит: неолита
неопр: неопр
непорочный: непорочных
непосредственно: непосредственно
нередко: нередко
несколько: несколькими несколько
несмотря: несмотря
нетаксономических: нетаксономических
нетипичный: нетипично
неточный: неточных
нехебкау: нехебкау
неясный: неясно
низ: низ
никифор: никифора
николай: николай
ничто: ничем
новый: новом новые
ноль: ноль
норвежский: норвежская
нос: носы
носитель: носителя
носить: носят
нохчийн: нохчийн
ночь: ночи
ноябрь: ноября
нужно: нужно
ныне: ныне
об: об
обвивание: обвивание
обвиться: обвившимся
обезьяна: обезьяны
обитать: обитают обитающее
обладать: обладающими
обозначать: обозначающий
обозначаться: обозначалось
обосновать: обоснованы
образ: образов образа образом образ образе
образец: образцом
обратный: обратно
обращение: обращения
обсуждение: обсуждение
обучить: обучить
общий: общий общего
объединять: объединяющее
объясненье: объяснений
объяснить: объяснить
обычай: обычаев
обычно: обычно
обязательно: обязательно
огнедышащий: огнедышащего огнедышащую огнедышащих
огонь: огня огнем
огромный: огромный огромное
одежда: одежде
одержания: одержания
один: одной одного один одно одним
однако: однако
означать: означает означающего
ок: ок
оказать: оказала
оказываться: оказывается
окаменелость: окаменелостей окаменелости
океания: океании
октябрь: октябрь октября октябре
олицетворять: олицетворяет
он: нему
они: им ими них ними
онлайн: онлайн
опасный: опасными
описание: описаниях описаний описание описании
описать: описаны
описывать: описывает
организация: организации
организм: организмов
орден: орден
основа: основы основе
основать: основаны основано
основное: основного
основной: основная
особенно: особенно
особенность: особенности
особый: особое
оставаться: оставался
останки: останками останки
осторожно: осторожно
остров: острова
острый: острыми
ответственность: ответственности
отводить: отводит
отдельный: отдельную отдельных
отказ: отказ
откровение: откровении
открывать: открывавший открывал
открыть: открытыми
отличаться: отличающихся
отмечать: отмечает отмечающие
относиться: относится относились
отношение: отношения отношению отношение
ото: ото
отождествляться: отождествлялись
отредактировать: отредактирована
отрицательно: отрицательно
отрубить: отрубил
охранять: охранявший
очевидец: очевидцам
очевидный: очевиден
очеловечить: очеловеченным
очень: очень
очередь: очередь
ошибка: ошибке
п: п
павел: павла
падеж: падеж
палец: пальцами
памятник: памятник
пантеон: пантеона
паоло: паоло
папирус: папирус
парамотор: парамотор
парк: парк
парка: парке
паркий: парки парком
паркинсон: паркинсон
пассивность: пассивность
пассивный: пассивное пассивный
пасть: пасть
патрон: патрон
пекин: пекин
первобытный: первобытного
первое: первое
первопредков: первопредков
первый: первой
перевод: переводы переводе перевод перевода
перед: перед
передать: передано
передний: передних
переименовать: переименовали
перейти: перейти
перенаправляться: перенаправляется
перерождение: перерождения
пересекаться: пересекается
период: период
пернатое: пернатого
перси: персей
персонаж: персонаж персонажа персонажи
персональный: персональные
песнь: песнь
печать: печати
пещера: пещерах
пиньинь: пиньинь
пирамида: пирамид
писательница: писательницы писательница
письменный: письменный
питер: питере
пифона: пифона
пламя: пламя пламени
планет: планет
плейстоцен: плейстоцена
плодовый: плодов
победа: победы победа
победить: победить
побеждать: побеждающих
повадка: повадками
поведение: поведения
повергать: повергает
поверье: поверьях
повествовать: повествуют
повестить: повести
погода: погоды
погодный: погодных
подать: подать
поддержка: поддержки
подземный: подземном
поднимать: поднимающий
подобный: подобные
подразумевать: подразумевает
подробный: подробнее
подтвердить: подтвердила
пожар: пожар
пожертвовать: пожертвовать
позвонок: позвонки
поздний: поздний позднее позже поздней поздних
познание: познания
поиск: поиск поиску
показать: показало показал
показывать: показывает
поклонник: поклонников
покоиться: покоится
пол: пол
политик: политика
полный: полная
положительный: положительную положительного
полубог: полубогов
получить: получить
полюбить: полюбил
помещаться: помещается
помимо: помимо
помогать: помогавший
помочь: помочь
помощь: помощью
попадаться: попадались
популярный: популярное популярных популярной популярная популярен
попытка: попытку
пора: пор
поражение: поражение
порождение: порождении
порой: порой
портал: портал
поскольку: поскольку
последний: последнее последняя последний
послужить: послужить
послушание: послушание
посол: после
посредство: посредством
постоянно: постоянно
постоянный: постоянная
построить: построенный
потерпеть: потерпел
потомок: потомка
потомство: потомство
потребовать: потребовал
поттер: поттер поттера
похожий: похожим
почтить: почти
поэма: поэмы
поэтому: поэтому
появляться: появляются появляется
пр: пр
править: править
правка: правка правки
православный: православных
правый: право
практический: практически
предание: преданиях предания
предел: пределами
предок: предков
представиться: представились
представление: представление представления
представленье: представлений
представлять: представляющем представляют представляет
представляться: представляются
прежний: прежний
преимущественный: преимущественно
преодолеть: преодолев
пресмыкаться: пресмыкающихся
пресс: пресс
престижный: престижнейшим
престол: престолов
преувеличить: преувеличенных
привидение: привидениями
приготовить: приготовить
прийтись: пришлось
применение: применение
применять: применял
применяться: применяться
пример: примерами примерах примеру
примерный: примерно
примечание: примечания
принадлежать: принадлежащих
приносить: приносит приносящих
принц: принц
принять: принятая
приписывать: приписывают
природа: природу природы
приручать: приручать
приручить: приручить
про: про
пробудиться: пробудившись
пробуждаться: пробуждается
пробуждение: пробуждения пробуждение
провести: провели
проглатывание: проглатывания
проект: проектах проекту
прозрачный: прозрачную
произведение: произведениях
производная: производным
происходить: происходит
происхождение: происхождение происхождении
пройти: пройти
прообраз: прообразе
пропп: пропп
просмотр: просмотры
простор: просторах
пространство: пространства
прототип: прототипы прототип
профессиональный: профессиональном
процесс: процесс
прямой: прямое
пс: пс
псмит: псмит
птерозавр: птерозаврами
птица: птицам птица птиц
путаница: путаницу
р: р
ра: ра
работать: работали
ради: ради
радуга: радуги
развитие: развитию
развить: развитую
развлеченье: развлечений
раздел: разделе
разделять: разделяет разделяют
различаться: различаются
различный: различную различных
разместить: размещена
разновидность: разновидностью
разнообразный: разнообразными разнообразных
разный: разных разное
разработчик: разработчики
разрешаться: разрешалось
разумный: разумные разумного разумными
райнда: райнда
район: районах
ранний: ранних ранние
распространить: распространены
рассказать: рассказать
растенье: растений
расширение: расширение
расширить: расширив
рациональный: рациональных
реакция: реакции
реальность: реальность
реальный: реальных
ребенок: детей
регион: регионе регионах
редакция: ред
редко: редко
результат: результатом
религиозный: религиозных
рептилия: рептилий
ресурс: ресурсы
рецензия: рецензия
решить: решил
ригведе: ригведе
рисунок: рисунком рисунков
ритуальный: ритуально ритуальных
ричард: ричард
роберт: роберт
рог: рога
родительный: родительный
ролевой: ролевой
роль: роль
российский: российского
рост: роста
роулинг: роулинг
русская: русских русским
русский: русскому русский
русый: рус
рыба: рыба рыб
рю: рю
ряд: ряд рядами
сага: сага
сайт: сайтах
сам: самого самом сама самое
самец: самца
самка: самки самка самку
самотерия: самотерия
самый: самая самым самые
санкт-петербург: спб
санскритский: санскритский
санти: санти
сантиметр: см
сведение: сведения
свежий: свежие
света: света
свидетельствовать: свидетельствует
свободный: свободной
свое: своих свои своему своего своим
свой: своей своя свою
свойство: свойство
связанный: связанные связан
связаться: свяжитесь
связывать: связывают
связываться: связывается
связь: связи
святой: святом святого святыми
сделать: сделанном сделанных сделанного
себя: собой
северный: северной
седмица: седмица
сей: сих
семейство: семейство
семнадцатый: семнадцатая
сентябрь: сентябрь сентября
сердце: сердце
серия: серии серия
сет: сетом
сивалик: сивалик
сила: силу сила сил
символ: символ
символизировать: символизирует
символика: символики символикой символике символика
симпатия: симпатии
сингапур: сингапур
сингапурский: сингапурский
синоним: синонимы
сирруша: сирруша
система: системе
сказание: сказания
сказка: сказки
скандинавский: скандинавской
скачать: скачать
сквозь: сквозь
скорый: скорее
скрытый: скрытые
скульптура: скульптурой скульптура скульптурах
скульптурный: скульптурная
слабость: слабость
славянский: славянских
слияние: слиянии слиянию
словарь: словари словарь
слово: слов слову слова слово
сложный: сложном
служебный: служебные
служилый: служил
служить: служит
случай: случаях
случайный: случайная
смауг: смауг
смауга: смауга
смертоносный: смертоносным
смерть: смерти
смочь: смог
смысл: смысл
снаружи: снаружи
сначала: сначала
снова: снова
собирательный: собирательное
собор: собора
событие: события
советский: советская
современный: современными современная современные современных современной
согласно: согласно
содержание: содержание
соединиться: соединились
созвездие: созвездие
создание: создания созданиями
создать: создано создать
соитие: соитием соития
сокровище: сокровище сокровища
солнечный: солнечные
солнце: солнца
сон: сон сна
сонька: сонькой
сообщение: сообщения
сообщество: сообществе сообщество
сообщить: сообщить
соотношение: соотношение
составлять: составляет
состояние: состояние
сосуд: сосудах
сотня: сотни
сохранение: сохранением
сочинение: сочинения
спать: спящего
специальный: специальную
спина: спине спинах
спить: спит
способность: способностям
способный: способны
справка: справка
спуск: спуском
сражаться: сражающихся
сражение: сражение
среди: среди
средиземноморский: средиземноморском
средневековый: средневековые
средневековье: средневековья
средний: средней
српски: српски
српскохрватски: српскохрватски
ссылка: ссылка ссылками ссылки
статистика: статистика
статус: статус
стать: стал
статья: статью статья статье статьи
стен: стена стенах
стеречь: стерегут
стоить: стоит
стол: столу
сторона: сторону
страница: страницы страница страницу странице
страх: страх
строение: строении
строительство: строительства
существо: существо существ существа существом существам существе существах
сущность: сущность
сходство: сходство сходства
схожий: схожими
считать: считает считают
считаться: считается считалось считались
сырой: сырых
сюда: сюда
сюжет: сюжет сюжеты сюжетах сюжете
ся: ся
т: т
тайна: тайне
также: также
такой: такой таким таких такие
таксон: таксонов
талантливый: талантливые
танец: танцев
татарча: татарча
татуировка: татуировка
творец: творцы
тезис: тезисы
текст: текст тексты текстах тексте
текущий: текущие текущую текущем
телесериал: телесериале
тело: теле тело телом
тем: тем
тема: тему тема темы темой
тематика: тематику
тематический: тематические
теория: теории
термин: термина термины термин
техник: техники
технология: технологий
техномир: техномир
тип: тип
типаж: типаж
товарный: товарный
тодд: тодд
тодда: тодда
тоддом: тоддом
толкина: толкина
тот: том ту тех тому
традиционный: традиционной традиционных традиционное
трансформация: трансформация
требование: требование
требовать: требует
три: тремя
труд: труде
туда: туда
убийство: убийство
убить: убитым убита
удача: удачей
указание: указанием
указать: указан
указывать: указывая
украшать: украшают украшает
умереть: умерла
уметь: умеющими
унаследовать: унаследовали
универсальный: универсального
уничтожить: уничтоживший
упоминание: упоминаний
упоминаться: упоминается
упомянуть: упомянутый
употребление: употребление употребления
управлять: управляющих
условие: условий условия
установить: установленная
устремляться: устремляется
утверждать: утверждают утверждает
утверждение: утверждению
участие: участие
уччелло: уччелло
уэлан: уэлан
уэльский: уэльский
ф: ф
фа: фа
фаир: фаир
фаллический: фаллической фаллический
фамилия: фамилию
фантастика: фантастики фантастику
фантастический: фантастической фантастических
фараон: фараона
фафнира: фафнира
февраль: февраль
феномен: феноменом
фигура: фигурой
фигурировать: фигурирующих фигурирует
физический: физическим
философ: философа
фильм: фильм фильмах
фольклор: фольклоре
фольклорный: фольклорные
фонд: фонд
фонтан: фонтан
форма: форма форм
форум: форум
фразетта: фразетта
французский: французском
фредерик: фредерик
фридрих: фридриха
фрэнк: фрэнк
фэнтези: фэнтези
фэншуй: фэншуй
х: х
характер: характере
хау: хау
хвост: хвост
хищник: хищниками
хищный: хищным
хоббит: хоббит
хокусая: хокусая
хороший: лучше лучшие
хорошо: хорошо
христианский: христианских
христианство: христианство
хтонический: хтонической
хуанлун: хуанлун
художественный: художественных
художник: художник художники художника
худой: хуже
царство: царстве царств
царь: царь
цвет: цвету
цветковый: цветковых
целый: целое целом
цепь: цепи
цзо: цзо
цитата: цитаты
цитировать: цитирует цитировать
часто: часто
чей: чьи
человек: человек человеку человека людей люди
черта: черт чертами черты
четвероногий: четвероногие
четыре: четырьмя четыре
четырнадцатый: четырнадцатый
чешуйчатый: чешуйчатую
чжу: чжу
чжуань: чжуань
число: числе
читать: читать
чонг: чонг
что: чему
чтобы: чтобы
чудовище: чудовища
чужая: чужая
шаблон: шаблоном шаблонов
шакти: шакти
швеция: швеция
широкий: широкое широко
шумила: шумила
шуню: шуню
э: э
эдриэн: эдриэн
экз: экз
экранизация: экранизаций
элемент: элемент
элмор: элмор
энциклопедический: энциклопедический
энциклопедия: энциклопедия энциклопедии
эпоха: эпохи
этимология: этимология
это: это
этот: этой эта эту
ю: ю
явленье: явлений
являться: является являются
явно: явно
ягила: ягила
ядозуб: ядозубы
язык: язык языках языка языке
языковой: языковом
языческий: языческий
яйцо: яйцо
якоб: якобы
яков: якова
январь: января
яншуаня: яншуаня
японец: японцами
япония: японии
японский: японское японский японского
яркий: яркими
ящерица: ящериц
ящеровидным: ящеровидным
