аберфорт: аберфорт
аберфорта: аберфорта
август: августа
автор: авторы
авторство: авторства
агрегаторе: агрегаторе
агрессивный: агрессивен
азкабана: азкабана
активно: активно
актриса: актрисой
александр: александр
алфавит: алфавиту
альбус: альбус
альбуса: альбуса
американский: американский американского
англ: англ
английский: английский английское английском
антон: антона
апрель: апреле апреля
архивировать: архивировано
архивный: архивная
аурелиус: аурелиус
афиша: афиши
баллотироваться: баллотироваться
банальный: банален
банти: банти
барда: барда
безумие: безумие
беларуская: беларуская
берлин: берлин
библиографический: библиографических
бидля: бидля
битва: битва
благодарить: благодарит
ближний: ближайшее
близнец: близнеца близнецы
близость: близости
боль: боли
больший: большей большая больше
брат: брата
британо: британо
британский: британской британский
будущее: будущих будущее
бутан: бутане бутан
български: български
быть: были
бэрбоун: бэрбоун
бюджет: бюджете бюджет
вальд: вальд
вальда: вальда
вальдом: вальдом
вальду: вальду
вд: вд
великобритания: великобритания великобритании
вернуть: вернуть
вернуться: вернуться
верный: верных верные
версия: версия
верховный: верховного верховным
взгляд: взгляд
взрослый: взрослым
взять: взяли
викиданных: викиданных
викимедиа: викимедиа
викиновости: викиновости
википедии: википедии
википедия: википедия
викисклад: викисклад
викискладе: викискладе
викторий: виктория
винда: винда
вино: вину
висенсии: висенсии
висенсию: висенсию
висенсия: висенсия
вклад: вклад
власть: власти
вместе: вместе
вместо: вместо
внедрять: внедряют
внешний: внешние
возвращение: возвращение
возобновиться: возобновились
война: войне войну
войти: войти
волан: волан
волшебник: волшебника волшебников
волшебный: волшебную волшебные волшебных волшебного волшебный волшебному
восприятие: восприятие
временить: времени
временной: временной
время: временем время
все: всех всего всем
вселенная: вселенная
вспоминать: вспоминают
встретить: встретив
встречаться: встречаются
выбирать: выбираем выбирает
выбор: выбора выборах
выбрать: выберет
выдвинуть: выдвинутые
выжить: выжившим выжившего
выйти: вышла
выполнить: выполненной
газета: газеты
гарри: гарри
геллерт: геллерт
германий: германии
гермиона: гермиона
героизм: героизме
герой: героев
глава: главе
главное: главных
главный: главную
глупый: глуп
говорить: говоря
год: год годами годы года
голдштейн: голдштейн
гольдштейн: гольдштейн
гонорар: гонорара
город: городу
господство: господства
гость: гости
грейнджер: грейнджер
грин: грин
гуйлине: гуйлине
дальнейший: дальнейшие
дамблдор: дамблдор
дамблдора: дамблдора
дамблдоров: дамблдоров
дамблдором: дамблдором
дамблдору: дамблдору
дар: дары
дата: дата
дать: даст данной
два: двух
де: де
действовать: действовать
декабрь: декабря
демонстрировать: демонстрируют
день: дней
депп: депп
деппа: деппа
деппом: деппом
дж: дж
джеймс: джеймс джеймса
джессика: джессика
джоан: джоан
джонни: джонни
джордж: джордж
джуд: джуд
дилогия: дилогия
дистрибьютор: дистрибьютор
дитя: дитя
диффамация: диффамации
длительность: длительность
добавлять: добавляет
док: док
должен: должен
доллар: долларов
домашний: домашнего
домыть: домой
дополнительный: дополнительные
дорогой: дороги
достойный: достойный достойного
доступный: доступен
драко: драко
древность: древности
друг: другом
другой: другим другой другие других
дурмстранг: дурмстранг
душ: душу
дэвид: дэвида дэвид
дэн: дэн
жанр: жанр
жениться: женятся
живой: живого
жизнь: жизни
забирать: забирает
завершить: завершена
зависеть: зависеть
заглавный: заглавная
заглядывать: заглядывать
заклинание: заклинания заклинаний
заклятие: заклятием
закончиться: закончились
замена: замены
заменить: заменил заменили
заметно: заметно
заметный: заметной
замечать: замечает
замышлять: замышляют
занятый: занята
запись: запись
запланировать: запланирована
зарегистрировать: зарегистрированный
заставить: заставил
затем: затем
захватывать: захватывают
заходить: заходит
защищать: защищают
заявить: заявил
заявление: заявление
зверь: звери
зинаида: зинаида
знак: знак
зритель: зрителей
игра: игра игру игры
играть: играют играет
идея: идеи идея
избранный: избранные
известно: известно
известный: известна
изначально: изначально
ильверморни: ильверморни
инструмент: инструменты
искупить: искупить
исп: исп
исполнитель: исполнителя
использование: использования
использовать: используя использует использовать
истец: истец
история: история истории
источник: источник
июль: июля июле
июнь: июня
йейтс: йейтс
йейтса: йейтса
каждый: каждый
калейдоскопичность: калейдоскопичность
каллум: каллум
кама: каму кама
камень: камень
кандидат: кандидат кандидата
картина: картину картина картины картине
карточный: карточная
кассовый: кассовым
каталог: каталогах
категория: категории категория
качество: качестве
квиддич: квиддич
квиддичу: квиддичу
кинокомпания: кинокомпании
кинотрилогией: кинотрилогией
китай: китай
кланяться: кланяется
клише: клише
кловис: кловис
кловиса: кловиса
кловисом: кловисом
клясться: клянется
клятва: клятвы клятву
книга: книги
ковальски: ковальски
код: код
кодекс: кодекс
койл: койл
коллекционный: коллекционная
комната: комната
композитор: композитор
констатировать: констатировал констатирует констатировали
конструктор: конструктор
контракт: контракта
конфедерация: конфедерация
конфиденциальность: конфиденциальности
копия: копия
корби: корби
короткий: короткие короткий
который: которое которой которого которые которых которая котором который
криденс: криденс
криденса: криденса
криденсом: криденсом
криденсу: криденсу
критик: критиков
критика: критики критика
кровь: крови
круциатус: круциатус
кубок: кубок
кузнецов: кузнецов
куинни: куинни
кук: куки
кэтрин: кэтрин
лайонел: лайонел
лалли: лалли
легенда: легенда
легилименцию: легилименцию
лень: ленью
лидер: лидера лидером лидеры
лицензия: лицензии
лишение: лишениях
локация: локации
лондон: лондоне
лоу: лоу
лошадь: лошадь
лукотруса: лукотруса
льюис: льюис
маг: магов маги мага
магглам: магглам
магия: магия магии
маглов: маглов
магловской: магловской
маглы: маглы
мадс: мадс
мадса: мадса
макгонагалл: макгонагалл
малфой: малфой
марта: марта
материал: материал
мать: мать
мая: мая
медиафайлы: медиафайлы
международный: международная
менее: менее
мера: мер
место: места
месяц: месяце
меткий: метки
миккельсен: миккельсен
миккельсена: миккельсена
миллер: миллер
миллион: млн
мина: мин
минерва: минерва
минимальный: минимальное
министерство: министерство
мир: мира мир
мировой: мирового
миссис: миссис
мкв: мкв
младший: младшего
многие: многие
много: много
мобильный: мобильная
молодой: молод
морт: морт
мочь: могут
музыка: музыкой музыка
мы: нами
наблюдать: наблюдающего
навигация: навигации навигация
над: над
надежность: надежность
надилам: надилам
назад: назад
назвать: назвал
назойливый: назойливых
наиболее: наиболее
наименее: наименее
намереваться: намереваясь
намерен: намерены
нападать: нападают нападает
написать: написала
насильник: насильника
находиться: находится
начаться: началась
наш: наших
небрежность: небрежностью
неверный: неверным
невероятный: невероятной
недостоверный: недостоверный
незаконнорожденный: незаконнорожденный
некоммерческий: некоммерческой
некорректный: некорректный
некромантия: некромантию
немедленно: немедленно
немецкий: немецкую
ненадолго: ненадолго
необходимость: необходимости
неопр: неопр
неполный: неполный
непреложный: непреложной
непременно: непременно
нераспознанный: нераспознанным
несмотря: несмотря
несоответствие: несоответствие
неспособный: неспособный
неудача: неудачу
низкий: низкая
никогда: никогда
никто: никто
новообращенная: новообращенную
новорожденный: новорожденного
новый: нового новая новые новых
норрис: норрис
ноябрь: ноября ноябрю ноябре
нынешний: нынешнего
ньют: ньют
ньюта: ньюта
ньютом: ньютом
ньютон: ньютона ньютон
нюхля: нюхля
об: об
оба: обоих
обвинение: обвинениям обвинения
обвинять: обвиняют
обзор: обзор
обитание: обитания
обитать: обитают
обозреватель: обозревателя обозреватель
обратный: обратном
обращение: обращения
обсуждение: обсуждение
общий: общую
объявить: объявила
объявлять: объявляет
обязательство: обязательство
овладевать: овладевают
огонь: огня
один: одном один одним
одиноко: одиноко
одиночка: одиночке
однако: однако
одновременно: одновременно
оживлять: оживляет
оказать: оказанную
оказаться: оказалось
около: около
окружение: окружение
октябрь: октября октябре
они: ими им них
опасный: опасных
оператор: оператор
описание: описание
оправдывать: оправдывает
организация: организации
орден: орден
освобождать: освобождает
основа: основе
основной: основными
осуждать: осуждает
отвергнуть: отверг
ответственность: ответственности
отдельный: отдельных отдельные
отзыв: отзывов отзывы
отказ: отказ
отказываться: отказывается
отношение: отношениях
отправлять: отправляет
отправляться: отправляются
отработать: отработанной
отредактировать: отредактирована
отрекаться: отрекается
отряд: отряд
официальный: официальный
оффов: оффов
оценка: оценка оценку оценкой
очередной: очередные
ошибка: ошибке ошибки
пандемия: пандемии
парадное: парадном
параметр: параметром
парк: парк
пародия: пародии
пекарня: пекарне
первый: первый
перезапуск: перезапуском
перейти: перейти
перенести: перенесена
перерыв: перерывов
переть: при
персонаж: персонажи персонажей
персональный: персональные
печать: печати
план: план
планировать: планировала
плохой: плохую
поведение: поведения
поддерживать: поддерживал
подробный: подробнее
подтвердить: подтвердив подтвердил
подтверждать: подтверждая
подчинить: подчинили
пожертвовать: пожертвовать
пожиратель: пожиратели
позволять: позволяя
поздний: позже
поиск: поиск поиску
политик: политика политике
полный: полную полон
полтергейст: полтергейстах
полукровка: полукровка
получать: получает
получить: получила получил получили получить
полюбить: полюбит
помешать: помешать
помогать: помогает
помощник: помощники помощников
помощница: помощницу
помощь: помощи
поппи: поппи
популярный: популярного
попытка: попыткой попытки попытке
поражение: поражение
порпентина: порпентина
портал: портал
последний: последний последних последним
последовательность: последовательности
последующий: последующая
посол: после
постепенно: постепенно
постоянный: постоянная
поттер: поттер поттере
похищать: похищают
появляться: появляется
править: править
правка: правки
предвидение: предвидению
предвидеть: предвидел
предвыборный: предвыборном
предлагать: предлагая
предлагаться: предлагается
предлог: предлог
предмет: предметы
предосторожность: предосторожности
предотвращать: предотвращают
предполагаться: предполагалось
предсказать: предсказав
представить: представлен
представиться: представились
предыдущий: предыдущих предыдущим предыдущий
предыстория: предыстория
премьер: премьеры премьера
преступление: преступления
приближаться: приближающихся
прибывать: прибывают
привести: привести
привлекать: привлекала
призыв: призыва
призывать: призывает
приквелов: приквелов
приквелы: приквелы
примечание: примечания
принимать: принимает
принц: принц
принять: принятое
приостановить: приостановлены приостановлено
припарковать: припаркована
приспешник: приспешники приспешниками приспешникам
присутствие: присутствии
проблема: проблем
провалиться: провалившейся
проверить: проверить
прогулка: прогулка
продавец: продавцы
продолжать: продолжать
продюсер: продюсер продюсеры
проект: проектах
произведенье: произведений
производство: производство
произойти: произошедших
прокат: прокате прокат
проклясть: проклятое
прокомментировать: прокомментировал
пронченко: пронченко
просмотр: просмотры
пространство: пространства
против: против
противоречивый: противоречивые
прочий: прочее
прощание: прощание
пустынный: пустынному
путеводитель: путеводитель
пытать: пытает
пытаться: пытается
пять: пяти
работа: работа
развивать: развивать
разоблачать: разоблачают
разрабатывать: разрабатывать
разработчик: разработчики
разрушать: разрушают
раненый: раненого
раскрывать: раскрывает
раскрыть: раскрыл
распределять: распределяющая
рассказ: рассказы
рваный: рваный
редмэйн: редмэйн
результат: результатов
рейтинг: рейтинг
религиозный: религиозные
репутация: репутацию
ресурс: ресурсы
рецензент: рецензент
рецензия: рецензия
ритуал: ритуал
ричард: ричард
ричмонд: ричмонд
роджер: роджера
родить: родить
родиться: родились
розье: розье
роль: роль ролях роли
роман: романов
рон: рон
роулинг: роулинг
ру: ру
рубеус: рубеус
русский: русский
сайт: сайта сайте сайт сайты
саламандер: саламандер
саламандером: саламандером
сам: сами сама
самка: самки
самый: самая самым
сантиметр: см
сантос: сантос
саундтрек: саундтрек
сбор: сборы
сведение: сведения
свежий: свежие
света: свет
свободный: свободной
свое: своих свои своего
свой: своей
связанный: связанные
связаться: свяжитесь
сдохнуть: сдохла
северус: северус
секретный: секретную
сенегальско: сенегальско
сентябрь: сентябре сентября
сериал: сериал сериалом
серия: серии серию серия
система: системе
сказка: сказки
скачать: скачать
скорый: скорее
скрытый: скрытые
скука: скуку
следующий: следующий следующего
слишком: слишком
служебный: служебные
случай: случаях
случайный: случайная
смерть: смерти
смешанный: смешанные
снегг: снегг
снимать: снимает
снять: снять
собираться: собираются
соблюдение: соблюдением
собрать: собрали собрала
событие: события событий
совместно: совместно
содержание: содержание
содержаться: содержится
создать: создать
сообщество: сообщество
сообщить: сообщить сообщил
соратник: соратники соратников
сорвать: сорвать
сослаться: сославшись
состоять: состоять
состояться: состоялась
сохранение: сохранением
спас: спас
спасать: спасает
спина: спин
список: список
спора: споры
способность: способность
способный: способному
справка: справка
спродюсированные: спродюсированные
сражаться: сражаются
сразиться: сразиться
средневзвешенный: средневзвешенную
средний: средние средней
српски: српски
ссылка: ссылка ссылки
сталкиваться: сталкивающиеся
старое: старых
статистика: статистика
стать: стал стало стала стать станут став стали
статья: статья статьи
стив: стивом стива стив
сторона: стороны
страна: страны
страница: страницы страница страницу странице
студия: студии
сугубо: сугубо
судол: судол
судья: судья
сумма: сумму
супружеский: супружеских
существо: существо существа существу
сценарий: сценария сценарием сценарию сценарий
сценарист: сценарист
считать: считал
сша: сша
сыграть: сыграл
сын: сына сын
сюда: сюда
сюжет: сюжет сюжетом сюжете
сюрприз: сюрпризом
тайна: тайн
тайный: тайная тайны
также: также
такой: такой
тарзан: тарзан
тварь: твари тварей
текст: текст
текущий: текущие
телевидение: телевидение
телепортируются: телепортируются
тем: тем
тематический: тематический тематические
тернер: тернер
терпеть: терпит
тесеус: тесеус
тесеуса: тесеуса
тим: тим
тина: тина тины
тичборн: тичборн
товарный: товарный
топорный: топорной
тот: том тот
трансгрессирует: трансгрессирует
третье: третьего
триквелы: триквелы
трилогия: трилогией
тупик: тупик
тусклый: тусклым
туча: туч
тюрьма: тюрьму
убедить: убедить
убивать: убивают убивает
убийство: убийства убийство
убить: убитого убить
уверять: уверяя
уголовный: уголовным
ужасать: ужасающего
ужин: ужине
узнать: узнав
узник: узник
уигрэм: уигрэм
уизли: уизли
уильям: уильям
уильямс: уильямс
указание: указанием
указать: указан
указывать: указывающую указывая
улица: улицы
уничтожить: уничтожить
уотерстон: уотерстон
урок: уроки
усиливать: усиливая
условие: условиям условий условия
успешный: успешно
установление: установлению
уходить: уходит
участие: участие
учительница: учительницу
фантастика: фантастики
фантастический: фантастических фантастические
фанфикшен: фанфикшен
февраль: февраля феврале
феникс: феникса
философский: философский
фильм: фильм фильме фильмов фильма фильмы фильмом
флорида: флориде
фогеля: фогеля
фоглер: фоглер
фонд: фонд
формализм: формализм
форум: форум
французский: французского
франшиза: франшизе франшизы
фэнтези: фэнтези
фэнтезийный: фэнтезийный
хагрид: хагрид
хватать: хватает
хейман: хейман
хельмут: хельмут
херд: херд
хикс: хикс
хобби: хобби
ховард: ховард
ховарда: ховарда
хогвартс: хогвартс
хогвартса: хогвартса
хороший: лучше
хронология: хронологии
худой: хуже
церемония: церемонии
цилинем: цилинем
цилинь: цилинь
цилиню: цилиню
цилиня: цилиня
циничный: циничной
цитировать: цитировать
чайный: чайной
частить: части
часть: часть частях
чемодан: чемоданом чемодан
чемпионат: чемпионат
черта: чертами
честь: честь
число: числе
чистый: чисто
читать: читать
чтобы: чтобы
шаблон: шаблон
шанс: шанс
шармбатон: шармбатон
школа: школы
шляпа: шляпа
шпион: шпиона
эберта: эберта
эдди: эдди
эзра: эзра
экранизация: экранизации
эксплуатация: эксплуатации
элемент: элемент
элисон: элисон
эмбер: эмбер
энциклопедия: энциклопедии
эркстаг: эркстаг
эркстага: эркстага
это: это этому
этот: эта
юлали: юлали
юность: юности
юношеский: юношеской
юсуф: юсуф юсуфа
язык: язык языках языке языком
якоб: якоба якоб
январь: января
