абернэти: абернэти
август: августа
австрийский: австрийской
автор: автор
авторство: авторства
азкабана: азкабана
алфавит: алфавиту
алхимик: алхимик
альбус: альбус
альбуса: альбуса
америка: америки америку
американский: американские
англ: англ
английский: английский английское английском
апрель: апреля
арнольд: арнольд
артистка: артисткой
архивировать: архивировано
аурелиус: аурелиус
баз: базе
балл: балла
банти: банти
барбэ: барбэ
барда: барда
бауэр: бауэр
безжалостный: безжалостным
безопасно: безопасно
беларуская: беларуская
бессмертный: бессмертный
библиографический: библиографических
бидля: бидля
биологический: биологической
боль: боли
больший: большая
борьба: борьбе
брак: браки
брат: брата брат
браун: браун
бронтис: бронтис
будущий: будущей
български: български
быть: бывшей были
бэрбоун: бэрбоун
бэрбоуна: бэрбоуна
бюджет: бюджет
вальд: вальд
вальда: вальда
вальдом: вальдом
вальду: вальду
вд: вд
великобритания: великобритания великобритании
вернуться: вернулись
версия: версия версии
вечный: вечное
видение: видение
викиданных: викиданных
викимедиа: викимедиа
викиновости: викиновости
википедии: википедии
википедия: википедия
викисклад: викисклад
викискладе: викискладе
викторий: виктория
винда: винда
вклад: вклад
власть: власти
вместе: вместе
внешний: внешние
возвращение: возвращение
возможный: возможную
война: войны
войти: войти
волан: волан
волшебник: волшебника волшебники волшебниками волшебникам
волшебный: волшебную волшебные волшебный
вольф: вольф
воспоминание: воспоминания
воссоединяться: воссоединяются
время: временем время
вселенная: вселенная
всеять: всей
вскоре: вскоре
встречаться: встречается встречаться
второе: второго
выбирать: выбираем
выдержать: выдержав
выйти: выйти
выполнять: выполняет
выпустить: выпущен
выслеживать: выслеживают
выступать: выступает
выход: выход
выясниться: выяснилось
гарри: гарри
гасить: гасят
гатри: гатри
геллерт: геллерта геллерт
гермиона: гермиона
героизм: героизме
герой: героев
главное: главных
гласкотт: гласкотт
глобальный: глобальной
говориться: говорилось
год: году год годы года
голдштейн: голдштейн
голова: головами
голубой: голубого
гость: гости
грейнджер: грейнджер
гриммсон: гриммсон
гриммсоном: гриммсоном
грин: грин
гриндевальда: гриндевальда
группа: группа
гузман: гузман
гуннар: гуннар гуннаром
давно: давно
дамблдор: дамблдор
дамблдора: дамблдора
дамблдором: дамблдором
дамблдору: дамблдору
дар: дары
дарита: дарит
дарри: дарри
дата: дата
дать: дал
де: де
действие: действие
действовать: действовать
декабрь: декабря
демонстрировать: демонстрирует
день: дней
депп: депп
дерек: дерек
дж: дж
джейми: джейми
джеймс: джеймс джеймса
джессика: джессика
джоан: джоан
джон: джон
джонни: джонни
джуд: джуд
дилогия: дилогия
дистрибьютор: дистрибьютор
дитя: дитя
длительность: длительность
док: док
документ: документы
дополнительный: дополнительные
дорогой: дороги
доступный: доступен
драко: драко
драться: драться
древность: древности
друг: друзья
другой: другим другой другие других
дугард: дугард
дурмстранг: дурмстранг
дуэль: дуэли
дэвид: дэвида дэвид
дэн: дэн
европа: европе европу
единоутробный: единоутробной
жанр: жанре жанр
желание: желания
жениться: жениться женился
жертвовать: жертвует
заглавный: заглавная
заключить: заключенная
заклятие: заклятия
заколдовать: заколдовала
закон: законов
закончить: закончил
заложник: заложниках
замок: замке
замуж: замуж
запись: запись
запрет: запрет
запрещать: запрещающих
зарегистрировать: зарегистрированный
заявление: заявление
зверь: звери
злой: злого
змея: змею
знак: знак
знать: зная
значительно: значительно
зоя: зои
игра: игра игры
идея: идеи
изаура: изаура
избранный: избранные
изначально: изначально
иметь: имеет
империус: империус
имя: имена
ингвар: ингвар
инструмент: инструменты
ирма: ирму
искать: ищет
использование: использования
использовать: использующие используют
исправить: исправить
истец: истец
история: история
источник: источник
июль: июля июле
июнь: июня
йейтс: йейтс
йейтса: йейтса
йорк: йорк
каллум: каллум
кама: кама камой
камень: камень
канал: канале
кармена: кармен
картина: картины
карточный: карточная
каталог: каталогах
катастрофа: катастрофа
категория: категории категория
качество: качестве
квиддич: квиддич
квиддичу: квиддичу
кевин: кевин
ким: ким
кинокомпания: кинокомпании
кинокритик: кинокритиков
клаудия: клаудия
кловис: кловис
клятва: клятва
книга: книги
ковальски: ковальски
код: код
кодекс: кодекс
коллекционный: коллекционная
кольцо: кольцо
комната: комната
композитор: композитор
конгресс: конгресс
конструктор: конструктор
конфиденциальность: конфиденциальности
корабль: корабле
корби: корби
корвус: корвус
корвуса: корвуса
корвусом: корвусом
корнелл: корнелл
короткий: короткие короткий
косвенно: косвенно
который: которым которое которыми которые которая который
кравиц: кравиц
кралл: кралл
криденс: криденс
криденса: криденса
криденсом: криденсом
криденсу: криденсу
критика: критика
кровь: крови
крэйг: крэйг
кто: кем
кубок: кубок
куини: куини
куинни: куинни
кук: куки
кыргызча: кыргызча
кэмпбелл: кэмпбелл
кэтрин: кэтрин
лайонел: лайонел
легенда: легенда
лестрейндж: лестрейндж
лестрейнджей: лестрейнджей
лестрейнджем: лестрейнджем
лита: лита литой литы
лицензия: лицензии
лицо: лицу лицом
личность: личность
лишение: лишениях
локация: локации
лондон: лондоне лондон
лорена: лорену лорена
лоу: лоу
маг: мага магами маг
магический: магический
магия: магия магии
маглы: маглы
макгонагалл: макгонагалл
макуса: макуса
малфой: малфой
манипулировать: манипулируя
маркетинг: маркетинг
марта: марта
материал: материал
мать: мать матери
мая: мая
медиафайлы: медиафайлы
международный: международный международные
место: места
месть: мести
месяц: месяца
миллер: миллер
миллион: млн
мина: мин
минерва: минерва
министерство: министерство
мир: мира мир мире
миссис: миссис
мистер: мистер
митинг: митинг
младенец: младенцем
младший: младшего
множественный: множественные
мобильный: мобильная
можно: можно
молодая: молодой
морт: морт
мочь: могут
мракоборцев: мракоборцев
мракоборцы: мракоборцы
музыка: музыкой музыка
мустафа: мустафы
мы: нами
навещать: навещают
навигация: навигации навигация
нагайна: нагайна
нагайной: нагайной
нагайны: нагайны
надилам: надилам
название: название
назойливый: назойливых
найти: найти
намеренно: намеренно
написать: написала
находить: находят
находиться: находится находясь
начало: начала
начаться: начались начался
наш: наших
невеста: невестой
недостоверный: недостоверный
некоммерческий: некоммерческой
немой: нем
неопр: неопр
неполный: неполный
непреднамеренный: непреднамеренно
непреложный: непреложный
несмотря: несмотря
низкий: низкие
никогда: никогда
николас: николас
новый: новые
норрис: норрис
ноябрь: ноября ноябре
нурменгард: нурменгард
нью: нью
ньют: ньют
ньюта: ньюта
ньютон: ньютона ньютон
нюхль: нюхль
об: об
обезопасить: обезопасить
обет: обет
обзор: обзор
обитание: обитания
обитать: обитают
обнаруживать: обнаруживают
обойти: обойти
обращение: обращения
обслуживание: обслуживание
обсуждение: обсуждение
общий: общая
объяснять: объясняя объясняет
огонь: огонь огня
один: одной
однако: однако
одновременно: одновременно
одноклассница: одноклассницей
ожить: ожившее
оказаться: оказавшийся
окружать: окружают
октябрь: октября октябре
он: нему
они: им
опасаться: опасаясь
опасный: опасных
оператор: оператор
описание: описание
опубликовать: опубликован
опытный: опытными
организация: организации
орден: орден
оригинальный: оригинальный
основа: основе
основной: основные основная
остаться: оставшиеся
ответственность: ответственности
отдельный: отдельных отдельные
отец: отца
отзыв: отзывов отзывы
отказ: отказ
отказываться: отказывается
отличаться: отличаться
отменить: отменить
отомстить: отомстить
отправить: отправил
отправляться: отправляются отправляется
отредактировать: отредактирована
отряд: отряд
отступать: отступающих
оулавюр: оулавюр
оулафссон: оулафссон
официальный: официальный
охотник: охотником
оценка: оценкой оценки
ошибка: ошибке
ошибочно: ошибочно
палочка: палочку
париж: париже
парк: парк
пародия: пародии
первый: первый
перевозить: перевозит
передвижение: передвижения
перейти: перейти
перенести: перенесен
пересекать: пересекают
пересечь: пересечь
переть: при
персонаж: персонажи
персональный: персональные
печать: печати
пиквери: пиквери
план: план
плач: плача
пленный: пленной
плыть: плывя
поведение: поведения
подменить: подменила
подобный: подобные
подробный: подробнее
подтвердить: подтвердила подтвердил
подтверждать: подтверждающие
поездка: поездки
пожертвовать: пожертвовать
пожиратель: пожиратели
позволять: позволяет
поиск: поиски поисках поиск поиску
пока: пока
полагать: полагая
полгода: полгода
политик: политика политике
положительный: положительных
полтергейст: полтергейстах
полукровка: полукровка
получить: получил получить
полуэльфа: полуэльфа
помолвить: помолвлены помолвлен
помочь: помочь
помощь: помощью
понимать: понимает
попасть: попал
поппи: поппи
порпентина: порпентина
портал: портал
послание: послание
послать: послал
последний: последний последнему
последователь: последователи последователем последователей
последствие: последствий
посол: после
постановщик: постановщик
постоянный: постоянная постоянного
потерять: потерянный
поттер: поттер поттере
похитить: похищена
появиться: появился
править: править
правка: правок правки
превращение: превращение
преданный: преданные
предмет: предметы
предотвращать: предотвращать
представиться: представились
представлять: представляет
предстоять: предстоит
предыдущий: предыдущий
предыстория: предыстория
прежде: прежде
премьер: премьера
преступление: преступления
привезти: привезла
приводить: приводят
приехать: приехала
призывать: призывает
приквелы: приквелы
приключенческий: приключенческие
примерный: примерно
примечание: примечания
принц: принц
присоединиться: присоединилась
присоединяться: присоединяется
присутствовать: присутствующих
причина: причиной
проверить: проверенной
проверка: проверки
проверяться: проверялась
продавец: продавцы
продолжение: продолжение
продюсер: продюсеры
проект: проектах
произведенье: произведений
производство: производство
произойти: произошла
прокат: прокат
проклясть: проклятое проклятой
проникать: проникают
просить: просит
просмотр: просмотры
пространство: пространства
просьба: просьбы просьбу
протест: протесты
против: против
противостояние: противостоянии
прочий: прочее
прошлый: прошлом
путеводитель: путеводитель
путь: пути
пять: пяти
работать: работать
развиваться: развивается
разработчик: разработчики
разыскивать: разыскивающим
раскрывать: раскрывает
раскрыть: раскрыл
расписание: расписание
распределять: распределяющая
распространить: распространить
рассказ: рассказы
рассказывать: рассказывает
расстроить: расстроенная расстроенную
расширение: расширение
редмэйн: редмэйн
религиозный: религиозные
ресурс: ресурсы
рецензия: рецензий
решить: решила
ридделл: ридделл
родиться: родился
роды: родах
рождение: рождения
розье: розье
ролик: ролик
роль: ролях
роман: романов
рон: рон
рот: рот
роулинг: роулинг
рубеус: рубеус
рудольф: рудольф
русло: русло
русский: русский
сажать: сажает
сайт: сайте сайт сайты
сакурай: сакурай
саламандер: саламандер
саламандера: саламандера
самый: самые
сантиметр: см
саундтрек: саундтрек
сбегать: сбегают сбегает
сбор: сборы
сведение: сведения
свежий: свежие
свободный: свободной
сводной: сводного
сводный: сводный
свое: своих своего
свой: своей свою
связанный: связанные
связаться: свяжитесь
сеанс: сеансов
себя: собой
северный: северной
северус: северус
сентябрь: сентябре сентября
серафина: серафина
сериал: сериал
серия: серии серию серия
сестра: сестра сестры
сеть: сети сетях
сигурдссон: сигурдссон
сиквела: сиквела
сиквелы: сиквелы
система: системе
сказка: сказки
скачать: скачать
скендер: скендер
скрытый: скрытые
следовать: следуют
следующий: следующий
служанка: служанку
служебный: служебные
случай: случаях
случайный: случайная
смерть: смерти
сми: сми
снегг: снегг
снимать: снимает
снова: снова
собраться: собравшихся
событие: события
согласиться: согласится
содержание: содержание
содержаться: содержится
создавать: создает
создать: создать
сообщество: сообщество
сообщить: сообщить
состоять: состоять
состояться: состоялась
сохранение: сохранением
социальный: социальных
спастись: спастись
список: список
спора: споры
способ: способ
способность: способностях
справка: справка
спродюсированные: спродюсированные
спустя: спустя
среди: среди
средний: средней
српски: српски
ссылка: ссылка ссылки
сталкиваться: сталкивается
статистика: статистика
стать: стала
статья: статья статьи
стертый: стерты
стив: стив
стоить: стоящего
столкнуться: столкнется
сторона: стороны
страна: страны
страница: страницы страница страницу странице
студия: студии
стюарт: стюарт
судно: суда
судол: судол
существо: существа
сцена: сцен
сценарий: сценария сценарий
считать: считает
сша: сша
сын: сына
сюда: сюда
сюжет: сюжет
тайный: тайная тайным тайны
также: также
тарзан: тарзан
тварь: твари тварей
текст: текст
текущий: текущие текущая
телевидение: телевидение
тем: тем
тематический: тематический тематические
темный: темного
тереть: три
тесеус: тесеус
тесеуса: тесеуса
тесеусу: тесеусу
тизер: тизер
тина: тину тина тины
тичборн: тичборн
товарный: товарный
торкуил: торкуил
тот: том тот та
трагедия: трагедии
требовать: требуют
трейлер: трейлер
третий: третий
третье: третьего
трэверс: трэверс
туча: туч
убивать: убивает
убийство: убийство
убить: убить
удовлетворять: удовлетворяет
узнать: узнав узнает
узник: узник
уигрэм: уигрэм
уизли: уизли
уильям: уильям
уильямс: уильямс
уйти: уйти
указание: указанием
указать: указан
украсть: украл
умереть: умерла
уничтожить: уничтожить
уотерстон: уотерстон
урок: уроки
условие: условий условии условия
усыновление: усыновление усыновления
усыпальница: усыпальницу
утонуть: утонул
уходить: уходят
участие: участие
участник: участниками
фамильный: фамильную
фантастический: фантастических фантастические
февраль: февраля
феникс: феникса фениксом
филипп: филипп
философский: философский
фильм: фильм фильмов фильма фильмы
фиона: фиона
флакон: флакон
фламель: фламель
фоглер: фоглер
фонд: фонд
форум: форум
фото: фото
французский: французское
фэнтези: фэнтези
фэнтезийный: фэнтезийный
хагрид: хагрид
хейман: хейман
хикс: хикс
хобби: хобби
ховард: ховард
ховарда: ховарда
хогвартс: хогвартс
хогвартса: хогвартса
хогвартсе: хогвартсе
хогвартсу: хогвартсу
ходоровски: ходоровски
художник: художник
цирк: цирка
цитировать: цитировать
чар: чары
часть: часть
чемпионат: чемпионат
чистый: чисто
читать: читать
чтобы: чтобы
шармбатон: шармбатон
шляпа: шляпа
шпильман: шпильман
эггерт: эггерт
эдди: эдди
эджого: эджого
эзра: эзра
экранизация: экранизации
элемент: элемент
элисон: элисон
энциклопедия: энциклопедии
этот: эта
юлали: юлали
юность: юности
юсуф: юсуф юсуфа юсуфом
язык: язык языках языке
якоб: якоба якоб
январь: января
