август: август августа
автобус: автобус
автограф: автографом
автор: автор
авторский: авторские
авторство: авторства
агрессия: агрессии
азкабан: азкабан
азкабана: азкабана
аккурат: аккурат
алфавит: алфавиту
альбус: альбус
американский: американской американским
англ: англ
английский: английский
анимага: анимага
анимагии: анимагии
анимагом: анимагом
анонимный: анонимный
апрель: апреля апрель
аргумент: аргументы
арестовать: арестован
артур: артур артура
архив: архив
архивировать: архивировано
ассоциация: ассоциацией
бар: баре
барда: барда
башня: башне башни
беглец: беглеца
беда: беды
бежать: бегущая бежавшего
безопасность: безопасности
беларуская: беларуская
белизна: белизна
белые: белыми
бесполезный: бесполезны
бессовестный: бессовестным
бестселлер: бестселлеров
библиографический: библиографических библиографическими
библиотека: библиотек
бидля: бидля
благодаря: благодаря
блестеть: блестящий
близкие: близким
блэк: блэк
блэка: блэка
блэком: блэком
боггарта: боггарта
болтун: болтуна
больничный: больничном
больший: большим больше
большой: большой
бояться: боится
брат: братьев
брэма: брэма
будущее: будущем
буйный: буйный
български: български
быстрый: быструю
быть: будут
вакансия: вакансия
вариант: вариант
варить: варит
вежливый: вежливого
везти: везло
великобритания: великобритании
верить: верит
вернона: вернона
верный: верного
версия: версию версия версии
весить: весь
весомый: весомые
вести: ведут вести
вечер: вечером
взрослый: взрослых
взяться: взялась
вид: вид виде
видеть: видят видел
визжать: визжащую
викиданных: викиданных
викимедиа: викимедиа
википедии: википедии
википедия: википедия
викисклад: викисклад
викискладе: викискладе
виновник: виновником
вклад: вклад
власть: власти
влетать: влетает
влияние: влиянию
вместе: вместе
вместо: вместо
вмешательство: вмешательству
внешний: внешние
вновь: вновь
внятно: внятно
вовремя: вовремя
возвращать: возвращает
возвращаться: возвращается
возвращение: возвращение возвращения
воздействие: воздействия
воздушный: воздушного
возможно: возможно
возможность: возможности возможность
возможный: возможную
войти: войти
волан: волан
волчий: волчье
волшебник: волшебником волшебника
волшебный: волшебной волшебную волшебные волшебный волшебными
волшебство: волшебства
воплотить: воплотить
воспоминание: воспоминание
восходить: восходит
вражда: вражда
врезаться: врезается
временить: времени
время: временем время
врываться: врывается
все: всех всего всеми
всеять: всей
вскоре: вскоре
вслед: вслед
вспоминать: вспоминать
встретиться: встретившись встретиться
встречать: встречают
встречаться: встречается
всячески: всячески
втайне: втайне
второй: вторую
выбор: выбор
выводить: выводя
выделяться: выделяется
вызвать: вызвал вызвать
вызывать: вызывает
выиграть: выиграть выиграла выиграл
выйти: вышло выйти вышла вышел
вылазка: вылазок
выматывать: выматывая
вынудить: вынужден
выпить: выпить
выпуск: выпуска выпуском выпуск
выпустить: выпущен
высказаться: высказался высказалась
выставить: выставив
выставлять: выставлял
выход: выхода
выходить: выходит
выходка: выходку
выясняться: выясняется
газета: газете
гарри: гарри
гермиона: гермиона гермионы гермионой гермионе гермиону
героизм: героизме
герой: героем героев
гибрид: гибридами
гиппогриф: гиппогрифами гиппогрифа
главное: главных
главный: главный
глаз: глаза
глубина: глубине
гнев: гневе гнев
говорить: говорит
год: году лет год годы года
гость: гостя
грегори: грегори
грейнджер: грейнджер
гремучий: гремучую
грим: грим
гриффиндора: гриффиндора
гриффиндору: гриффиндору
громадный: громадным
дабы: дабы
давать: давать
дама: дамы
дамблдор: дамблдор
дамблдора: дамблдора
дар: дары
дата: дата
дать: дал
два: две двух
двенадцать: двенадцать
двор: дворе
де: де
действительно: действительно
действовать: действовать
декабрь: декабря декабрь
делать: делать
дело: делу деле
дементор: дементор
дементора: дементора
дементорами: дементорами
дементоров: дементоров
дементоры: дементоры
день: дней дня
деревня: деревни
держать: держат
детская: детскую детской
деть: день дела
дж: дж
джеймс: джеймс джеймсом джеймса
джим: джим
джоан: джоан
джордж: джорджа
дикий: дико
дилогия: дилогия
дитя: дитя
добираться: добираются
доверие: доверие
доверить: доверил
довод: доводы
довозить: довозит
довольный: доволен
док: док
должен: должно
доллар: долларов
дом: доме
дома: дома
домыть: домой
дописать: дописала
дополнительный: дополнительные
досада: досады
достаться: доставшуюся
доступный: доступен
доходить: доходит
драка: драке
драко: драко
древность: древности
друг: друзья друзьями друг друзей другом друзьям
другой: другое другим другие других
дружить: дружили
дурмстранг: дурмстранг
дурной: дурная
дырявый: дырявый
дэвидсон: дэвидсона
дядя: дяди
е: е
единственный: единственный
единый: единому
жанр: жанр
ждать: ждать
жертва: жертву жертвой
жестокий: жестоко
живоглот: живоглоту живоглот
живой: живых
животное: животного животное животными
жизнь: жизни
жуткий: жуткие
заболевать: заболевает
забор: забору
завоевать: завоевать завоевал
заглавный: заглавная
задумываться: задумывается
зайцев: зайцев
заканчиваться: заканчивается
заклятие: заклятие заклятиями
закоулок: закоулками
заменить: заменить
замечать: замечает
замок: замка
заново: заново
занятие: занятий
занять: занял
запись: запись
запретить: запрещены
зарегистрировать: зарегистрированный
затем: затем
заточение: заточении
зачем: зачем
защита: защиты защиту
защитный: защитное
защищать: защищать
заявить: заявив
заявление: заявление
заявлять: заявляет
звериный: звериную
зверь: зверь звери
здоровенный: здоровенного
здравый: здравом
зелье: зелье
зельеварения: зельеварения
златопуста: златопуста
зло: зла
зловещий: зловещее
злодеяние: злодеяний
знак: знак
знать: знает
значение: значения
зов: зов
золотой: золотую
ив: иву
игра: игра игре игры
избавиться: избавиться
избежать: избежал
избирать: избирает
избранный: избранные
издание: издания издание изданий
издательство: издательством издательство
издеваться: издевается
излишний: излишнему
изображать: изображать
изрезать: изрезал
икабог: икабог
иллюстрация: иллюстрациями
иллюстрировать: иллюстрированная
именно: именно
имя: именем
инструмент: инструменты
информация: информацию
искать: искать ищут
искусство: искусств
использование: использования
использовать: использует использующие
история: историю история
источник: источники источниками источник
итог: итоге
июль: июля июле июль
июнь: июня июнь
кадзу: кадзу
каждый: каждой каждый
казнить: казни
какой: какие
камень: камень
карликовый: карликовая
карта: карты карту карта
карточный: карточная
карьер: карьеры
касаться: касается
каталог: каталогах
категория: категории
квиддич: квиддич
квиддичу: квиддичу
кей: кей
кибуиси: кибуиси
класс: класса классу
кличка: кличке
клэр: клэр
клювокрыл: клювокрыл
клювокрыла: клювокрыла
клювокрыле: клювокрыле
клятва: клятву
книга: книг книги книгой книгу книге книга
коготь: когтями
когтеврана: когтеврана
код: код
кодекс: кодекс
козел: козла
колдун: колдуна
колкий: колкие
коллекционный: коллекционная
команда: команда
комната: комната
компания: компанию
конец: конца
конструктор: конструктор
конфиденциальность: конфиденциальности
конь: коней
копье: копий
корморане: корморане
корнелиус: корнелиусом
короста: коросту короста
короткий: короткие короткий
косой: косом
кот: коту кот
который: которое которому которой которого которые которая котором который
крестник: крестник крестнику
крик: крик крики
критика: критика
кричать: кричал
кровать: кровати
кровь: крови кровь
крыло: крыле
крыса: крысы крысу крыса
кто: кого кому
кубок: кубка кубок
куда: куда
кук: куки
кукушка: кукушки
кульминация: кульминацию
купить: купила
курс: курсе
куст: кустов
кыргызча: кыргызча
лаборатория: лаборатория
лауреат: лауреатом
лес: лес
лесничий: лесничего
летие: летию
летний: летнего
лето: летом
либо: либо
линия: линию
лист: лист
литература: литературы литература
литературный: литературную литературные
лицензия: лицензии
лично: лично
лишение: лишениях
лишить: лишив
лишь: лишь
локация: локации
локонса: локонса
ломаться: ломается
лондон: лондона
лорд: лорда лорд
луна: луна
любить: любимым
люпин: люпин люпина люпине
магический: магический магическими
магия: магия магию магии
маглами: маглами
маглов: маглов
маглы: маглы
магуайр: магуайр
майя: май
макгонагалл: макгонагалл
македонский: македонски
маленький: маленькая
малодушный: малодушный
малфой: малфой
малфоя: малфоя
мальчик: мальчика мальчику
манера: манерой
мардж: мардж
марта: марта
материал: материал
матч: матча матчи
мать: матери
маховик: маховик
мая: мае мая
мгновение: мгновение
медаль: медаль
медиафайлы: медиафайлы
мелински: мелински
меллински: меллински
мерещиться: мерещился
место: место места месте
местонахождение: местонахождении
метла: метлу метла метлы
мечта: мечты
миллион: миллионов
министерство: министерство министерству
министр: министром
мир: мира мир мире
миссис: миссис
много: более много
мобильный: мобильная
могила: могила
можно: можно
молния: молнию
момент: момент
монгол: монгол
морт: морт
морта: морта
морту: морту
мочь: мог могут могла
мошенник: мошенника
мощный: мощного мощную
мучиться: мучился
мчаться: мчится
мы: нами
мысль: мыслями
мягкий: мягкой
навигация: навигации навигация
наговорить: наговорили
над: над
надоумить: надоумить
назад: назад
названый: названа
назвать: назвал назвали
назло: назло
назначаться: назначается
назойливый: назойливых
называть: называли называет
найти: найдя найти
наколдовать: наколдовал
наконец: наконец
намекать: намекает
нападать: нападать нападает
написание: написания
написать: написала
народный: народный
нарушать: нарушать
наступать: наступает
находиться: находится находясь
начало: начала
начать: начали
начаться: начавшейся начался
начинать: начинает
наш: наших
неавторитетный: неавторитетными
небо: небе
неверный: неверным
невероятный: невероятным
невинный: невинные
невиновный: невиновных
невыносимый: невыносимо
негативный: негативно
неделя: неделю
недопустимый: недопустимым
недостаток: недостатков
недостоверный: недостоверный
незваный: незваного
незнакомец: незнакомец
неизбирательно: неизбирательно
некий: некоего
некогда: некогда
некоммерческий: некоммерческой
некорректный: некорректный
некоторые: некоторые
нелюбимый: нелюбимых
неопр: неопр
неосознанный: неосознанно
неполный: неполный
несколько: нескольких несколько
несмотря: несмотря
неспроста: неспроста
несчастие: несчастью
нетерпение: нетерпением
неудачный: неудачного
никогда: никогда
никто: никого никто
ничто: ничем
новый: новым новый новейшую новые новых
нога: ногу
нож: ножом
номинация: номинация
номинирована: номинирована
норрис: норрис
нотация: нотацию
ночной: ночной
ночь: ночь ночью
ноябрь: ноября ноябрь
нрав: нрав
нужно: нужно
об: об
оба: обоих
обвинение: обвинения
обвинить: обвинил
обезглавливание: обезглавливание
обещание: обещание
обещать: обещает
обижаться: обижаются
обитание: обитания
облик: облике
обложка: обложке обложки обложкой обложка обложек
обмен: обмен
обморок: обморок
обнаруживать: обнаруживают
оборотень: оборотня оборотень оборотней
образ: образом
обратный: обратном
обращаться: обращается
обращение: обращения
обстоятельство: обстоятельству
обсуждение: обсуждение
обуздать: обуздать
обучиться: обучившись
объявить: объявлен
объявиться: объявился
объяснить: объяснила
оглушать: оглушают
огонь: огня
огромный: огромный
один: одной одного один одни
однажды: однажды
однако: однако
оказываться: оказываются оказывается
октябрь: октябрь октября октябре
олень: оленя
он: нему
они: ими им них
онлайн: онлайн
опасаться: опасается опасался
опасность: опасности
опасный: опасными опасных опасное опасный
опекун: опекунов
описание: описание
оправдать: оправдать
опубликовать: опубликована
организация: организации
орден: орден
орел: орлов
оригинал: оригинала
осваивать: осваивает
освобождать: освобождают
оскорбительный: оскорбительную
оскорблять: оскорбляет
особо: особо
оставаться: оставался оставаться
останавливать: останавливает
остаться: остаться остался
отбирать: отбирает
ответ: ответ
ответственность: ответственности
отвлечь: отвлечь
отдать: отдав
отдельный: отдельных отдельные
отец: отца отцом отец
отказ: отказ
открывать: открывают
отличие: отличие
отмахнуться: отмахнувшись
отметить: отметило отметил
ото: ото
оторвать: оторвав
отпускать: отпускать
отпущение: отпущения
отредактировать: отредактирована
отряд: отряд
отсутствие: отсутствию
оттуда: оттуда
отчаянный: отчаянный
отъезд: отъезда
оформление: оформлением
охотиться: охотится охотиться
охранница: охранницы
охранять: охраняющие
оценить: оценить
оценка: оценке оценки
очень: очень
очередь: очередь
ошибка: ошибке
ощущать: ощущает
ощущение: ощущение
падать: падает
падение: падения
палач: палач
палец: пальцы палец
палочка: палочкой
память: память
паника: панике
параметр: параметром
парк: парк
пародия: пародии
парравано: парравано
патронуса: патронуса
патрулировать: патрулировать
первое: первого первые первом
первый: первой первая
перед: перед
передать: передать
переехать: переехать
перейти: перейти
перемещаться: перемещаются
переть: при
переулок: переулке
периодический: периодически
персонаж: персонажи
персональный: персональные
пес: пса псом
петтигрю: петтигрю
печатный: печатные
печать: печати
писать: писать
письмо: письмом
питаться: питаются
питер: питер питера
план: плану плане
платформа: платформ
победить: победить
поведение: поведением поведение поведения
повторить: повторить
погибнуть: погибла
подавленность: подавленность
подарок: подарок
подменять: подменяет
подозреваться: подозревается
подоспевать: подоспевает
подписать: подписать
подпись: подписями
подполье: подполье
подробный: подробнее
подряд: подряд
подслушивать: подслушивает
подстроить: подстроил
подтверждать: подтверждаемым
подход: подхода
поезд: поезд поезде
пожертвовать: пожертвовать
пожизненный: пожизненный
пожиратель: пожиратели
поздний: позже
познакомить: познакомить
поиск: поиск поиску
поймать: поймать
пока: пока
показать: показала
показывать: показывает
пол: поле
ползти: ползти
политик: политика политике
полнолуние: полнолуние
полный: полной полная
пологий: полог
полтергейст: полтергейстах
полукровка: полукровка
получать: получает
получить: получил получить
пользоваться: пользовалась
помогать: помогает
помощь: помощью помощь
понимать: понимает
попадаться: попадается
попасть: попал попасть попавшая
попутный: попутно
попытка: попытки
пора: пора
поработать: поработал
портал: портал
портрет: портрет
посетить: посетить
посещать: посещать
посещение: посещение
поскольку: поскольку
последний: последнее последняя последний последнего последнем
последующий: последующих
посмешище: посмешище
посол: после
постоянно: постоянно
постоянный: постоянная
поступить: поступил
потерять: потерявшая
поттер: поттер поттера поттеров поттере
поцелуй: поцелуя
почему: почему
пошутить: пошутили
появляться: появляется
правда: правду
правило: правилам
править: править
правка: правки
правый: права
пребывание: пребывания
превратиться: превратился
превращаться: превращающегося превращаться превращался превращается
предавать: предавал
предатель: предателя
предательство: предательстве
предать: предал
предлагать: предлагает
предложить: предложив
предмет: предметы предмет
предотвращать: предотвращают
предсказуемый: предсказуемые
представить: представленных представить
представиться: представились
представление: представление
предупреждать: предупреждает
предупреждение: предупреждение
предшественник: предшественника
предыдущий: предыдущее предыдущие
предыстория: предыстория
прекрасно: прекрасно
прекратиться: прекратилась
премиум: премиум
премия: премией премий премии премию
преподавание: преподавания
преподаватель: преподаватель преподавателей преподаватели преподавателем
преподавательский: преподавательской
преследовать: преследует
пресс: прессы
преступление: преступление преступления
преступник: преступник
приветственный: приветственно
привидение: привидение
привычный: привычное
приговаривать: приговаривает
придумать: придумали
признать: признаны
призрак: призрак
приложить: приложит
применять: применяет
примечание: примечания
принимать: принимает
принц: принц
принять: принять
прислать: прислал прислан
приступать: приступают
присутствие: присутствии присутствия
присутствовать: присутствует
приходить: приходит
причина: причины причинам
про: про
пробираться: пробирается пробираются
проблема: проблем
проблемный: проблемных
проболтаться: проболтался
проверить: проверила
провоцировать: провоцирует
прогнать: прогнавший
проговориться: проговорился
продажа: продажи
продать: продано
проект: проектах проекта
проиграть: проиграла
проигрывать: проигрывает
произведение: произведения
производство: производство
происшествие: происшествие
проклясть: проклятое проклята
проклятие: проклятия
прорицание: прорицаниям прорицания
пророчество: пророчество
пророчить: пророчит
просить: просит
просмотр: просмотры
простой: проще
пространство: пространства
против: против
противоядие: противоядие
профессор: профессор
проходить: проходят проходит
прочий: прочее
прочить: прочь
прошлый: прошлого
публикация: публикации
публичный: публично
пустота: пустоту
путеводитель: путеводитель
путешествие: путешествиях
путь: пути
пуффендуя: пуффендуя
пытаться: пытался пытаются пытающийся пытается пытаясь
работа: работе работа
работать: работал
радостный: радостными
радость: радости
раз: разом
разговор: разговор
раздирать: раздирает
раздувать: раздувает
размер: размеров
разный: разными
разоблачать: разоблачает
разобраться: разобраться
разработчик: разработчики
разрешение: разрешение разрешения
рамка: рамках рамке
ранее: ранее
раскрыть: раскрыл
расписание: расписание
распознать: распознать
распределять: распределяющая
распродать: распродано
рассказ: рассказы
рассказать: рассказав
рассказывать: рассказывает рассказывать
рассудок: рассудок
расширение: расширение
ребенок: детей
ревью: ревью
редактор: редакторов редакторам
рекордсмен: рекордсменом
религиозный: религиозные
ресурс: ресурсы
решать: решает
решающий: решающей
решение: решения
римус: римус
римуса: римуса
римусу: римусу
родитель: родителей
родственник: родственников
родственница: родственницы
рождественский: рождественский
рождество: рождество рождеством
роль: роли
роман: романов романа роман романы
рон: роном рона рон
роулинг: роулинг
рубеус: рубеус
рука: руку руки
русский: русский
ручной: ручной
рушиться: рушатся рушится
рыцарь: рыцарь
ряд: рядом
сайт: сайты
сам: самого самой самом самому
самосуд: самосуд
самоуверенный: самоуверенного
самый: самую самый самым самые
сантиметр: см
саундтрек: саундтрек
сбегать: сбегает
сбежать: сбежав сбежать
свадьба: свадьбе
сваливаться: сваливаются
сведение: сведения
свежий: свежие
светящийся: светящийся
свободно: свободно
свободный: свободной
свое: своих свои своему свое своего своим своими своем
своенравный: своенравными
свой: своей своя свою
свыше: свыше
связанный: связанные
связаться: свяжитесь
сдать: сдать
сделать: сделало
сдерживать: сдерживать
северус: северус
северусу: северусу
седок: седока
сентиментальность: сентиментальности
сентябрь: сентябрь сентября
сердце: сердце
серебристый: серебристый
сериал: сериал
серия: серии серию серия
сивилла: сивиллы сивилла
сильный: сильно
символ: символом
символизировать: символизирующие символизирует
синеть: синей
сириус: сириуса сириус сириусу сириусом
система: системе
сказать: сказали
сказка: сказки
скандал: скандалом
скандалить: скандалят
скармливать: скармливает
скачать: скачать
сквозь: сквозь
склонность: склонность
скоро: скоро
скорость: скорости
скорый: скорее
скрытый: скрытые
следить: следит
следовать: следует следовать
следующий: следующее
слизерина: слизерина
слизеринцами: слизеринцами
слишком: слишком
словарь: словари
слово: словам слову
сложный: сложное
слуга: слуги
служба: службе
служебный: служебные
слух: слухи
случай: случаю случае случаях
случайно: случайно
случайный: случайная
случаться: случается
слышать: слышат слышал слышит
смертельный: смертельная
смерть: смерть смерти
смотреть: смотрит
смотря: смотря
сначала: сначала
снегг: снегг
снегга: снегга
снеггу: снеггу
снять: снять
собака: собаки собака
собираться: собирается
собрать: собрала
собственный: собственная
событие: события событий
сова: сову сова
совершать: совершать
совпадение: совпадению
соглашаться: соглашается
содержание: содержание
содержимое: содержимым
создать: создана создать
сознание: сознание
сообразительный: сообразительный
сообщать: сообщает сообщал
сообщество: сообщество
сообщить: сообщить
соответствующий: соответствующие
составить: составили составлен
сотворить: сотворив
сохранение: сохранением
спальня: спальню спальне
спам: спам
спас: спас
спасти: спасти
специальный: специальный
список: списке список
сполна: сполна
спора: споры
способ: способ
справка: справка
сравнимый: сравнимый
сражаться: сражаться
сразу: сразу
среди: среди
срок: срок
српски: српски
српскохрватски: српскохрватски
срываться: срывается
ссылка: ссылка ссылками ссылки ссылок
ставить: ставит
сталкиваться: сталкиваются
старший: старшего
статистика: статистика
стать: стал
статья: статья статье статьи
стокер: стокера
сторона: стороны
страйке: страйке
страна: стране
страница: страницы страница страницу странице
странный: странному
страх: страх
страшный: страшные
стычка: стычку
суд: суд суде
суметь: сумел
существо: существа существами
существовать: существуют
счастливый: счастливое
считать: считает считают
сша: сша
съедение: съедение
съесть: съесть
сюда: сюда
сюжет: сюжет сюжета
сюжетный: сюжетную сюжетные
тайком: тайком
тайный: тайная тайными тайно
также: также
такой: такое таким такие
талантливый: талантливым
татарча: татарча
тварь: тварями
текст: текст
текущий: текущие
тело: тела
тем: тем
тематический: тематический тематические
тереть: три
термин: термина
терпение: терпение
терпеть: терпят
терять: теряет теряя
товарный: товарный
топор: топора топором
тот: том ту те тот та
точка: точки точка
точно: точно
требовать: требует требующими
трелони: трелони
третий: третьей третья
треть: третью
третье: третьем
трое: трое
труд: трудом
тупик: тупик
тысяча: тысяч
тюрьма: тюрьме тюрьмы
убедить: убедить
убеждать: убеждает
убивать: убивал убивают
убить: убил убитый убив убит
уводить: уводит
угнетать: угнетающего
удалить: удалить
удар: удар удара
ударить: ударил
ужас: ужас
ужасный: ужасной
узнать: узнав узнает
узник: узник узника
уизли: уизли
уйти: уйти
указание: указанием
указать: указан
ум: уме
умение: умение
уметь: умеющим
умудриться: умудрился
унывать: унывает
упустить: упустив
урок: уроке уроки уроков урок
условие: условий условия
успевать: успевать успевает
успеть: успел
успешный: успешно
успокаивать: успокаивает
уставать: уставая
утаскивать: утаскивает
уход: ухода уходом
уходить: уходит
участие: участие
участить: участи
учащийся: учащийся
учебный: учебному учебного учебные
ученик: учеников ученикам
учить: учит
фаджем: фаджем
фантастика: фантастики
фантастический: фантастические фантастический
февраль: февраля февраль
феникс: феникса
фиаско: фиаско
философский: философский
фильм: фильм фильмов
финансовый: финансовых
фиолетовый: фиолетовой
фонд: фонд
форма: форме
форум: форум
фред: фреда
фэнтези: фэнтези
хагрид: хагрид
хагрида: хагрида
хамский: хамским
хижина: хижине хижину хижины
хобби: хобби
хогвартс: хогвартс
хогвартса: хогвартса
хогвартсе: хогвартсе
хогсмид: хогсмид
хогсмида: хогсмида
ход: ходами ходы
холден: холден
хороший: лучших лучшая лучший лучшей хорошему
хорошо: хорошо
хотеть: хотят
художник: художником
хьюго: хьюго
цель: целях цель целью
ценный: ценную
цикл: цикл
цитировать: цитировать
чародейство: чародейства
час: часа
частить: части
частное: частные
часы: часы
человек: человек людей человеком
чемпионат: чемпионат
через: через
чернильный: чернильно
число: число
читатель: читателей читатели
читать: читает читать
чтение: чтения
чтобы: чтобы
чудовище: чудовище
чуть: чуть
шаблон: шаблонами
шалость: шалостям
шар: шар шара
шармбатон: шармбатон
шафер: шафером
шелкопряд: шелкопряд
школа: школу школе школы
шкура: шкуре
шляпа: шляпа
шортлист: шортлист
шумок: шумок
шутка: шутки
щепка: щепки
экзамен: экзамене экзаменов
экземпляр: экземпляров
экранизация: экранизация
экспресс: экспресс
элемент: элемент
эндрю: эндрю
энтони: энтони
энциклопедия: энциклопедии
это: этом это этому
этот: этой этих эта
юбилей: юбилея
юбилейный: юбилейный
юный: юных
язык: язык языках
январь: января
