авад: авада
авантюра: авантюру
август: августа
автограф: автографом
автор: автор
авторитет: авторитет
авторство: авторства
азимова: азимова
азкабан: азкабан
азкабана: азкабана
айзека: айзека
академия: академия
акоселла: акоселла
аластор: аластор
аластора: аластора
алмазный: алмазный
алфавит: алфавиту
альбус: альбус
альфред: альфреда
американский: американских американские
амнистия: амнистию
англ: англ
английский: английский английской
англия: англии
анимаг: анимаг
апрель: апреля
аркадя: аркади
артур: артуром артура
архивировать: архивировано
архивный: архивная
атмосфера: атмосфера
бабушка: бабушка бабушку
баз: база
бал: бал балу
балл: баллы
банк: банку
барда: барда
барраяр: барраяр
бартемиус: бартемиус
бартемиуса: бартемиуса
бартемиусу: бартемиусу
барти: барти
бачигалупи: бачигалупи
бдительность: бдительности
бегать: бегает
беда: беда
бежать: бегущая
бездна: бездной
беларуская: беларуская
белизна: белизна
бесконечный: бесконечная бесконечный
бессвязный: бессвязной
бесследно: бесследно
бессмертный: бессмертный
бестера: бестера
библиографический: библиографических
бидля: бидля
благодаря: благодаря
блестеть: блестящей
близкий: близкого
близнец: близнецам
блиша: блиша
блэка: блэка
бог: боги
бой: бою
болгарин: болгары
болгария: болгария
болгарский: болгарский
болдуин: болдуин
больший: большая большую больше
большой: большое
бояться: боится
брайса: брайса
браннера: браннера
брат: брата
брина: брина
бросать: бросая бросают
бросить: бросил
брэдбери: брэдбери
брэдфорд: брэдфорд
брэкетт: брэкетт
буджолд: буджолд
бухгалтер: бухгалтера бухгалтер
български: български
быт: быту
быть: будут были
бэгмена: бэгмена
бэгменом: бэгменом
бэгмену: бэгмену
вагон: вагон вагона
вакансия: вакансия
ван: ван
ванна: ванне ванну
вариант: вариантами
ведьма: ведьма
вейлой: вейлой
век: век
великобритания: великобритании
великое: великим
верить: верить верит
вернон: вернон
вернора: вернора
вернуться: вернулся
версия: версия версии
весить: весь
вести: ведут
весьма: весьма
вечно: вечно
вечность: вечности
вещь: вещей
взросления: взросления
взять: взять
вид: виде
видеть: видя видел
викиданных: викиданных
викимедиа: викимедиа
википедии: википедии
википедия: википедия
викисклад: викисклад
викискладе: викискладе
викицитатник: викицитатник
викицитатнике: викицитатнике
виктор: виктор виктора виктором
вильгельм: вильгельм
виндж: виндж
винджа: винджа
винки: винки
вклад: вклад
вкладывать: вкладываемая
включительно: включительно
включить: включила
владелец: владельцы
власть: власти
вместе: вместе
вместо: вместо
внезапно: внезапно
внешний: внешние
внимание: внимания
внимательный: внимательных
вовлекаться: вовлекается
вовсе: вовсе
вогта: вогта
вода: водой
возвращение: возвращение возвращения возвращении
возвышение: возвышение
возникнуть: возник возникла
возродиться: возродившийся
возрождение: возрождению
война: войне война
войти: войти
вокзал: вокзала
волан: волан
волос: волосы
волшебник: волшебников волшебник
волшебный: волшебной волшебные волшебных волшебная волшебном волшебный волшебное
воля: воли
вонды: вонды
вообще: вообще
вопиющий: вопиющую
вопль: воплей вопль
вопреки: вопреки
вопрос: вопрос
воскрешать: воскрешаемого
воспитывать: воспитывала
воспоминание: воспоминания воспоминаний
воспринимать: воспринимают
восстать: восстаньте
впасть: впавшая
впервые: впервые
впечатлила: впечатлила
впоследствии: впоследствии
враг: врага врагом
врата: врата
временить: времени
время: временем время
все: всех всего всем
вскрыть: вскрыть
вспоминать: вспоминая
встретить: встретили
встречаться: встречается
всячески: всячески
второе: вторым второе
второстепенный: второстепенные
выбиваться: выбивается
выбрасывать: выбрасывает
выбрать: выбрала выбравшие
выдать: выдал
выдумать: выдуманные
вызволить: вызволить
вызволять: вызволяя
вызов: вызов
вызывать: вызывает вызывало
выиграть: выигранные выиграли
выигрыш: выигрыш
выйти: вышел
выкрасить: выкрашен
выкурить: выкурить
выплатить: выплатив
выпустить: выпустила
выследить: выследить
высокий: высоком высокие высоко высокой
выставлять: выставляет
выступать: выступать
выход: выход
вычислительный: вычислительные
выяснение: выяснения
выясняться: выясняется
габриэль: габриэль
газета: газете
галлеонов: галлеонов
гарри: гарри
гейман: геймана
герберт: герберта
гермиона: гермиона гермионы гермионой гермиону
героизм: героизме
героиня: героини
герой: героев герои
гибель: гибели
гибсона: гибсона
гиперион: гиперион
глава: главу главы
глаз: глаз глаза глазах
глубина: глубина
говорить: говорил говоря
говориться: говорится
год: году лет год годы года годам
голова: головы
голос: голос
голубой: голубой
гоминид: гоминиды
гора: горе
горазд: гораздо
гореть: горящим
горизонт: горизонты
город: город
господин: господина
гость: гостями
готовить: готовил
готовиться: готовится готовиться
градус: градус
грань: гранью
грейнджер: грейнджер
грозный: грозный
громить: громя
грузовик: грузовиков
грюм: грюм
грюма: грюма
грядущий: грядущей грядущее
гуин: гуин
давать: давали
давление: давлением
давность: давности
дальнейший: дальнейшем
дамблдор: дамблдор
дамблдора: дамблдора
дар: дары
дата: дата
даться: далась
два: два двух
двойник: двойник
двоюродный: двоюродного
де: де
девочка: девочку
девятая: девятую
действие: действие
действовать: действовать
декабрь: декабря декабрь
делакур: делакур
делать: делают
делегация: делегации
дело: деле делам делом
дементора: дементора
демонстрация: демонстрации
день: дней дне
деньга: деньги
держаться: держаться
десант: десант
деть: день дело
дж: дж
джей: джей
джеймс: джеймс джеймса
джемисин: джемисин
дженсен: дженсен
джефф: джефф
джо: джо
джоан: джоан
джон: джона
джонатан: джонатан
джордж: джордж джорджа
диггори: диггори
дидкот: дидкот
дизельный: дизельный
дикий: дика
дилогия: дилогия
директор: директорами директор директора
дитя: дитя
дно: дна
добби: добби
добираться: добираются
добраться: добралась
добровольно: добровольно
довершить: довершить
довольный: довольно
док: док
доказать: доказать
долгий: долгие
долгопупса: долгопупса
должен: должны должна
доля: долю
дома: дома
домовой: домовых
допоздна: допоздна
дополнительный: дополнительные
доработать: доработать
дорогой: дорога
доставка: доставки
доступный: доступен
дочь: дочь дочерью
дощечка: дощечка
драко: драко
дракон: дракона дракону драконом драконы
драма: драма
древность: древности
друг: друзья друзьями друг другом друга другу
другой: другим другие других
дружеский: дружеском
дура: дуры
дурмстранг: дурмстранг
дурмстранга: дурмстранга
дурной: дурная
дурслям: дурслям
душ: души душ
дуэль: дуэли дуэль
дыра: дыры
дышать: дышит дышать
дэвид: дэвида
дэвис: дэвисом
дэна: дэна
дюна: дюна
е: е
еврейский: еврейских
енд: енд
ехать: ехала
жабросли: жабросли
жанр: жанр
ждать: ждут
желание: желании
желать: желающей желающие
железнодорожный: железнодорожный железнодорожной
железный: железная
желязны: желязны
жертва: жертв
живой: живой
жизнь: жизнью
жук: жука жуком
журналистка: журналистки журналистка журналистке
жуткий: жуткий
жюри: жюри
забирать: забирает
забрать: забрать забрав
забыть: забыть
завершение: завершения
заводной: заводная
загадка: загадку
заглавный: заглавная
заглядывать: заглядывает
задание: задание задании заданием задания заданию
задаром: задаром
задача: задача задачи
задумываться: задумываются
зажигаться: зажигается
заканчивать: заканчивая
заканчиваться: заканчивается
заклятие: заклятие заклятий заклятием заклятия
закон: законом
закупить: закупило
заливать: заливает
заложник: заложники
замечать: замечает
замок: замке замка
занзибар: занзибаре
занятие: занятии
запись: запись
запросить: запросила
запутаться: запутались
запытал: запытал
заработать: заработать
зарегистрировать: зарегистрированный
заслуживать: заслуживают
затем: затем
затемнение: затемнение
затея: затея
затягивать: затягивающей
захватывать: захватывая
защита: защиты защиту
заявление: заявление
заявлять: заявляет заявляла
звезда: звездой
зверь: звери
здоровье: здоровьем
зелье: зелью зелье
зло: злом зла
злодей: злодея
змея: змей
знак: знак
знакомиться: знакомится
знакомый: знакомым знакомые
знаменитость: знаменитости
знать: знает знал
значение: значения
значительно: значительно
зов: зов
золотой: золотом золотые
зритель: зрителей
игорь: игорь
игра: игра игр игры
играть: играют играл
игрок: игроком
идея: идеи идее идею
избавиться: избавился
избаловать: избалован
избирательно: избирательно
избранный: избранные
известный: известное известных
издание: издания изданиях
издат: издат
издательство: издательство издательства
измениться: изменилась
изначально: изначально
икабог: икабог
именно: именно
империус: империус
империя: империя империей
имя: имена имя имени
инкантатем: инкантатем
иной: иной
иностранный: иностранными
инструмент: инструменты
интервью: интервью
ирландия: ирландия
искренне: искренне
искусно: искусно
искусство: искусств
исполниться: исполнилось
использование: использования
использовать: использующие
исправить: исправили
исправиться: исправиться
истерик: истерика истерику
история: история истории
источник: источник
исход: исход
исчезать: исчезает
исчезнуть: исчез
итог: итогам итоге
июль: июля июль
июнь: июня
йорк: йорк
кабинет: кабинет кабинете
какой: какая какое каким
каменный: каменную каменные
камень: камню камень камне
капитан: капитаном
карда: карда
каркаров: каркаров
карта: карте карту
карточный: карточная
каталог: каталогах
категория: категории
качество: качестве
квиддич: квиддич
квиддичу: квиддичу
кедавра: кедавра
кейт: кейт
ким: кима
кинг: кинг
кингс: кингс
кладбище: кладбища кладбище кладбищем
кларк: кларк кларка
класс: класса
клифтона: клифтона
клиффорда: клиффорда
ключ: ключи
книга: книг книгах книги книгу книгой книге книга
князь: князь
коваль: коваль
когтеврана: когтеврана
код: код
кодекс: кодекс
козел: козлом
коллекционный: коллекционная
колонка: колонке
кольцо: кольцо
команда: команды
комната: комната
конец: конце конец конца
конни: конни
конструктор: конструктор
конфиденциальность: конфиденциальности
конфликт: конфликтов
концовка: концовка
копия: копия
копье: копий
корморане: корморане
корнелиус: корнелиус
королев: королева
короткий: короткие короткий
кость: кость
который: которым которое которому которой которую которого которые которых которая котором который
кошмар: кошмаров
край: краю
крам: крам
крама: крама
крамом: крамом
краму: краму
крапива: крапива
красный: красный красном
крауч: крауч
крауча: крауча
краучу: краучу
кредитор: кредиторами
кристен: кристен
кристина: кристин
критик: критиков
критика: критика
кровь: кровь
кросс: кросс
крупный: крупное
крутой: крутой
круциатус: круциатус
крю: крю
кто: кем кого кому
кубок: кубка кубок
куда: куда
кук: куки
кукушка: кукушки
кульминационный: кульминационный
кульминация: кульминация
курсировать: курсировал
кухня: кухне
кыргызча: кыргызча
лаборатория: лаборатория
лагерь: лагеря
ларри: ларри
ле: ле
левый: левая
лейбера: лейбера
лейбовицу: лейбовицу
лек: леки
леммерман: леммерман
лестрейндж: лестрейндж
летний: летней
лили: лили
линия: линии
литература: литературы
литературный: литературные
лицензия: лицензии
лицо: лица
личина: личиной
лично: лично
лишаться: лишается
лишение: лишениях
лишить: лишив
лишь: лишь
ловец: ловцом ловец
ложный: ложному
лоис: лоис
локация: локации
локомотив: локомотив
лондонский: лондонского
лопотать: лопочет
лорд: лорда лорд
луна: луна
лучить: лучи
лю: лю
любой: любая
любопытство: любопытства
людо: людо
люциуса: люциуса
м: м
магазин: магазина
магический: магического магических магическом
магия: магия магии
маглы: маглы
мадам: мадам
майк: майк
майкл: майкла
макгонагалл: макгонагалл
македонский: македонски
макинтайр: макинтайр
макмастер: макмастер
максим: максим
маленький: меньше
малфой: малфой
малфоя: малфоя
мальфальда: мальфальда
манчестер: манчестер
марка: марка
марс: марс
марта: марты марта март
мартин: мартина
маршрут: маршруту
масло: масла
масштаб: масштабы
материал: материал
матч: матч матча
машина: машина
мая: мая
медиафайлы: медиафайлы
мельком: мельком
местный: местной
место: места
месяц: месяцев
метка: метку
меткий: метка
метла: метле
меч: меч
миллер: миллера
миллион: миллионов
министерский: министерскому
министерство: министерство министерству
министр: министр
мир: мира мир миром мире
мириться: мирится
мирный: мирное
мировой: мировой
миссис: миссис
мистер: мистера мистер
младший: младшего младший
многие: многие многих
много: более много
многочисленный: многочисленных многочисленные
мобильный: мобильная
могила: могилы могила
могильный: могильному
молли: молли
молния: молния
момент: момента момент
монгол: монгол
морт: морт
морта: морта
мортом: мортом
мочь: могут
мракоборец: мракоборец
мрачный: мрачнее
музей: музей
мучительный: мучительных
мы: нами
мьевиля: мьевиля
мэри: мэри
н: н
навигация: навигации навигация
награда: наградами
над: над
надпись: надписью
назад: назад
название: названия названием
назвать: назвали
назойливый: назойливых
наиболее: наиболее
найти: найти
наказание: наказание
намекать: намекать
намереваться: намеревается
нападать: нападает
нападение: нападения нападение
написание: написание написания
написать: написанная
наречие: наречиями
насильно: насильно
настоящее: настоящим настоящего
настоящий: настоящий
настырный: настырного
научиться: научился
национальный: национальный
начало: начале начала
начальник: начальником
начинать: начинают начинает начиная
начинаться: начинается
наш: наших
небо: небеса небе
невилла: невилла
невиновный: невиновен невиновным
невозможно: невозможно
недостоверный: недостоверный
незарегистрированный: незарегистрированный
нейромант: нейромант
некоммерческий: некоммерческой
некоторые: некоторых
немезиды: немезиды
немилость: немилость
необходимость: необходимость
неопр: неопр
неполный: неполный
непростительный: непростительные
неровно: неровно
несколько: нескольких несколько
несправедливость: несправедливости несправедливость
несчастие: несчастью
неудобный: неудобное
нивена: нивена
никогда: никогда
никто: никому никто
нил: нила
нить: нити
новый: новом новую новые новых
норрелл: норрелл
норрис: норрис
ночное: ночных
ноябрь: ноября ноябрь
нрав: нрав
нужно: нужно
ньюкасл: ньюкасл
ньюэлл: ньюэлл
об: об
обвинение: обвинения
обвинять: обвиняя
обелиск: обелиска
обещать: обещает обещая
обижаться: обижается
обитание: обитания
обложка: обложка
обмен: обмен
оборотный: оборотное оборотному
образ: образом
образец: образцом
образовать: образуют
образоваться: образовались
обратный: обратно
обращаться: обращающийся
обращение: обращения
обсуждать: обсуждают
обсуждение: обсуждение
обучить: обучить
обширный: обширной
общаться: общаться
общество: обществе
объявить: объявлено
объявлять: объявляет
объяснить: объяснила
объяснять: объясняет
обязываться: обязуется
овощ: овощем
огонь: огонь огня
один: одну одной одного один одним
одинаковый: одинаковой
однако: однако
одновременно: одновременно
ожидаться: ожидалось
озеро: озера
оказаться: оказался
оказываться: оказывается
около: около
октябрь: октября
олимпий: олимпия
омут: омут
она: ею
они: ими ними
онлайн: онлайн
оно: оно
опасность: опасности
опасный: опасных опасному
описание: описание
оплатить: оплатило
оправдать: оправданы
оправдаться: оправдаться
опубликовать: опубликована
опытный: опытными
организатор: организаторы
организация: организации
организоваться: организуется
орден: орден
оригинал: оригинала
орсона: орсона
освещать: освещающая
оскорбительный: оскорбительного
ослабнуть: ослабший
основа: основе
основание: основание
основной: основных основную
особенно: особенно
осознавать: осознавая
отбой: отбой
ответственность: ответственности
отвлекать: отвлекают
отдавать: отдают
отдать: отдал
отдел: отдела
отдельный: отдельных отдельные
отец: отца отцом отцу
отказ: отказ
отказаться: отказаться
откладывать: откладывая
открывать: открывает
открываться: открывается
открытие: открытии открытию
открыто: открыто
отличаться: отличаться отличаются
отличить: отличить
отлучаться: отлучается
отметить: отметила отметил
относиться: относятся
отношение: отношения отношению
отобрать: отобрать отобранном
отомстить: отомстить
отпечатать: отпечатано
отправиться: отправился
отправлять: отправляет
отправляться: отправляется
отпущение: отпущения
отраженье: отражений
отредактировать: отредактирована
отрезать: отрезает
отряд: отряд
отследить: отследить
отставной: отставной
отсутствовать: отсутствует
отсюда: отсюда
отчаянный: отчаянная
отъезд: отъезду
охранять: охраняемые
оцениваться: оценивается
оценка: оценкой
очень: очень
очередной: очередной
очередь: очередь
очернять: очерняя
ошибка: ошибке ошибку
падение: падения
падмой: падмой
паладин: паладин
палатка: палатки
палочка: палочек палочки
память: памяти память
паника: панику
паоло: паоло
парад: параде
параноик: параноик
парвати: парвати
парень: парня
парк: парк
пародия: пародии
парравано: парравано
патил: патил
первое: первым первого первых первом
первый: первой первый
переговариваться: переговариваются
перегрузить: перегруженной
перед: перед
передаться: передались
переиздание: переизданиях
перейти: перейти
перекрасить: перекрашен
переносить: переносит
переноситься: переносится
переписывать: переписывать
пересадочный: пересадочная
переть: перт при
перехитрить: перехитрить
переходить: переходил
период: период
перо: пера
персонаж: персонажи
персональный: персональные
петтигрю: петтигрю
петь: пели
печать: печати
пиккадилли: пиккадилли
писательница: писательницей писательница
писать: писать
письмо: письма
питер: питер питеру
пламя: пламя
план: план плане
планировать: планируют
платформа: платформы
плоть: плоть
плохой: плохих
победа: победе
победитель: победителем
поведать: поведать
поведение: поведения
погибнуть: погибли
подарить: подаренный
подвергать: подвергают
подливать: подливает
подлизаться: подлизаться
подлость: подлость
подниматься: поднимается
подобный: подобной
подозрительно: подозрительно
подписаться: подписался
подражать: подражать
подробный: подробные подробнее
подростковый: подростков
подручный: подручный
подсказка: подсказку
подсказывать: подсказывая
подслушать: подслушавшего
подслушивать: подслушивающий
подходить: подходит
подчинение: подчинения
поезд: поезд поезде
пожертвовать: пожертвовать
пожиратель: пожирателей пожирателем пожиратели
поздний: позже
позитивно: позитивно
поиск: поиск поиску
поймать: поймают
пока: пока
показание: показаний
показательный: показательную
показать: показать
показаться: показаться покажется
показывать: показывая показывает
поклонница: поклонниц
покрасоваться: покрасоваться
пол: пола
полагаться: полагалось
полисмен: полисменов
политик: политика политике
положение: положение положением
полтергейст: полтергейстах
полукровка: полукровка
получить: получила получил получили получит получив получить
получиться: получилось
помешать: помешан
помогать: помогают помогал помогает
помощь: помощь
понимать: понимает
попадаться: попадаться
попасть: попали попал
попросить: попросил попросит
попросту: попросту
попутный: попутно
попытаться: попытается попытался
поражение: поражение
портал: портал
посвятить: посвятила
посетить: посетить
поскольку: поскольку
последний: последняя последний последнего последние
последователь: последователи
последовать: последовать
последующий: последующих
посол: после
поставить: поставить
постоянно: постоянно
постоянный: постоянная постоянной
поступить: поступила
поступок: поступки поступок
потасовка: потасовки
потрясать: потрясает
поттер: поттер поттера поттеры поттере
поцелуй: поцелую
почтить: почти
пошло: пошло
поэтому: поэтому
появляться: появляются появлялся
пояснять: поясняют
правда: правды правду
правило: правилам
править: править
правка: правки
правосудие: правосудия
правый: прав
прах: прах праха
превратиться: превратился
превращать: превращает
предлагать: предлагает предлагающий
предмет: предметы
предрассудок: предрассудков
представитель: представители
представить: представила представить
представиться: представились
представление: представлению
предстоять: предстоит
предупредить: предупредила предупредить
предыдущий: предыдущее предыдущим
предыстория: предыстория
прежде: прежде
прежний: прежние
прекращать: прекращает
премия: премии премия премию
приближаться: приближающейся
прибывать: прибывают
прибыть: прибыв
привлечь: привлекло
приводить: приводит
пригласить: пригласила
приз: приза
признавать: признавая
признание: признанию
признать: признал
призывать: призывая
прийтись: пришлось
приключение: приключениях
приковывать: приковывает
прилив: прилив
примереть: пример
примечание: примечания
примириться: примириться
принести: принесло
принц: принц
принять: принять
приори: приори
приспешник: приспешники приспешников
причина: причиной
причинить: причинить
проблема: проблемы
провал: провалом
проверить: проверенной
проверка: проверки
проверяться: проверялась
проводить: проводит
проводиться: проводился
прогонять: прогоняет
продажа: продажи продажу
продать: продано продать
продолжать: продолжает
проект: проектах
проиграть: проиграют проиграл
произведение: произведения
производство: производство
происходить: происходит
пройти: пройдя
проклясть: проклятое
просмотр: просмотры
просто: просто
пространство: пространства
просьба: просьбой
против: против
профессор: профессором
прочий: прочее
прошлый: прошлом
птица: птицы
публикация: публикация публикации
публиковать: публикуя публиковавший
пустошь: пустошь
путеводитель: путеводитель
путешествие: путешествие
путь: пути
пуффендуй: пуффендуй
пытаться: пытаются пытался пытается пытаясь пытались
пытка: пыток
пятый: пятый
работать: работают работает
рабочий: рабочего
равенство: равенства
равный: равные
радовать: радует
радуга: радуг
раз: раза
развиваться: развиваться развивается
развитие: развитие
разгадать: разгадать
разгадка: разгадкам
разговор: разговор
раздавать: раздавала
раздор: раздоры
раздувать: раздувая
раздумывать: раздумывая
разобраться: разобраться
разорвать: разорвала
разработчик: разработчики
разругаться: разругался
разрушить: разрушить
разъяснение: разъяснения
разъяснить: разъяснить
райли: райли
рама: рамой
раскрыть: раскрыла
расправиться: расправиться
распределять: распределяющая
распространять: распространять
рассеиваться: рассеивается
рассказ: рассказу рассказы
рассказывать: рассказывая
расставание: расставания
рассудок: рассудка
рассчитаться: рассчитался
расширение: расширение
расширяться: расширялся
рая: рая
реакция: реакция
реальный: реального реальный
ребенок: детей дети
ревновать: ревнует
ревность: ревности
ревю: ревю
реклама: рекламы
религиозный: религиозные
ресурс: ресурсы
ретро: ретро
решать: решать
решаться: решаются решается
решающий: решающем
решение: решении
решиться: решится
рисковать: рисковал
рита: рите рита риты
ритуал: ритуал
роберт: роберта
робинетт: робинетт
робинсон: робинсона
роджер: роджером роджера
родитель: родителями родителей родителях
родственник: родственникам
родственница: родственница
рождественский: рождественский
рождество: рождество
роман: романов роман романы
рон: роном рона рон
росмэн: росмэн
роулинг: роулинг
роулингу: роулингу
рубеус: рубеус
рука: руку рука
русский: русский
ручной: ручной
рэя: рэя
садовник: садовника
саймака: саймака
сайт: сайте сайты
сам: самой самом сами
самозванец: самозванцем
самый: самый самым самых
сантиметр: см
саундтрек: саундтрек
сбежать: сбежал сбежать
сбивать: сбивает
сбрасывать: сбрасывать
сведение: сведения
свежий: свежие
света: света
светящийся: светящиеся
свидание: свидание
свободный: свободной
свое: своих свои своему свое своего своим своими
свой: свой своей свою
связанный: связанные
связаться: свяжитесь
связь: связи
святочный: святочный
северн: северн
северус: северус
северуса: северуса
седрик: седрика седриком седрик седрику
сезон: сезон
семь: семи
семья: семье семьи
сердце: сердце
сердцевина: сердцевиной
серебряный: серебряную
сериал: сериал
серия: серии серию серия
сестра: сестра сестрой
сетевой: сетевой
сеять: сеют
си: си
сила: сил
сильный: сильно
символ: символ
симмонса: симмонса
синий: синим
сириус: сириуса
система: системе
сказание: сказанием
сказать: сказав сказала
сказка: сказки
скальци: скальци
скандал: скандалов
скандальный: скандальной
скачать: скачать
скептический: скептически
скитер: скитер
скоро: скоро
скотт: скотта
скрывать: скрывает
скрываться: скрывался
скрытый: скрытые
слава: славу слава
сладкий: сладко
след: следу следа
следующий: следующее
слишком: слишком
словарь: словари
слово: словам
слуга: слуги
служба: службе
служебный: служебные
служилый: служила
случай: случаях
случайный: случайная
случиться: случилось
слушать: слушает
слышать: слышат слышит
слэн: слэн
смертельный: смертельная
смерть: смерть смерти
смешанный: смешанное
сми: сми
смириться: смирившиеся
смысл: смыслах смыслом
снегг: снегг
снегга: снегга
снеггу: снеггу
снежный: снежная
снитч: снитч
сновиденье: сновидений
собака: собаке
собрать: собрав
собственный: собственном
событие: события событие
совершать: совершают
совестить: совести
совет: совету совет
содержание: содержание
создать: созданы создать
созывать: созывает
сойера: сойера
сойти: сошедший
сон: сна сном
сообщество: сообществе сообщество
сообщить: сообщить
сопротивление: сопротивления
соревнование: соревнование соревнований
соревноваться: соревноваться
состав: составе
состригать: состригал
сохранение: сохранением
союз: союз
спальный: спальный
специальный: специальный специально
спина: спин
список: список
сплетня: сплетни
спора: споры
спорт: спорта
способ: способ
способствовать: способствовал
справиться: справиться
справка: справка
справляться: справляется
спрятать: спрятано
сразиться: сразиться
сразу: сразу
среди: среди
срикошетить: срикошетило
српски: српски
српскохрватски: српскохрватски
ссора: ссора
ссориться: ссориться
ссылка: ссылка ссылки
ставка: ставку
сталкиваться: сталкиваются
становиться: становится становясь
станция: станция станции
старое: старым старые
староста: старост
статистика: статистика
стать: стал стало стать стали станет
статья: статья статьи
стенли: стенли
стереотип: стереотип
стесняться: стесняется
стивен: стивен
стивенсон: стивенсона
сторона: сторону
стоять: стоять стоявшем
страйке: страйке
страна: стране
страница: страницы страница страницу странице
странник: странник
страсть: страсти
страшный: страшного
стремиться: стремилась
стрендж: стрендж
строчить: строчить
стряхивать: стряхивает
студент: студентам
суббота: субботу
суд: суд
судно: суда
судьба: судьбы
судья: судьями
сундук: сундуке
супруг: супругами
суровый: суровая
существо: существа
существовать: существуют
сфальсифицировать: сфальсифицировал
схватывать: схватывают
схлестнуться: схлестнулись
считать: считает
сша: сша
сыворотка: сыворотку
сын: сын сыну
сыпаться: сыпаться
сытин: сытин
сюда: сюда
сюжет: сюжет сюжету сюжете
сюжетный: сюжетные
сюзанна: сюзанны
таинственно: таинственно
тайком: тайком
тайна: тайне тайну тайнах тайн
тайный: тайная тайно
также: также
такой: такую
танец: танец
татарча: татарча
тейлор: тейлор
текст: текст
текущий: текущие текущая
тело: тел тело
тем: тем
тема: тему
тематический: тематический тематические
теплый: тепло
теренса: теренса
термин: термина
течение: течение
теша: теш
товарный: товарный
толпа: толпа
томас: томас
тоня: тоне
тот: том тех те тот тому
тоу: тоу
точно: точно
традиционно: традиционно
традиция: традициям
траур: траур
требовать: требуют
тревога: тревоги
третье: третьем третьему
триллер: триллером
труд: труда
туда: туда
тур: тура
турнир: турнир турнира турнире
тщательно: тщательно
тщеславие: тщеславии
тысяча: тысячу тысяч
тьма: тьмы
тяжелый: тяжело
уайт: уайта
убивать: убивая убивает
убийство: убийство
убить: убитых убит
угодно: угодно
угроза: угрозе
уделяться: уделяется
удобный: удобное
удостоить: удостоенные
уезжать: уезжает
узнать: узнают
узник: узник
уизли: уизли
уик: уик
уиллис: уиллис
уилсона: уилсона
уильям: уильяма
указание: указанием
указать: указан указали
указываться: указывалось
ум: ума
умереть: умер
уметь: умеет
умудряться: умудряется
уолтер: уолтера
уолтон: уолтон
упираться: упиравшимся
упоминать: упоминая упоминал
упоминаться: упоминаться
урок: уроки
урсула: урсулы
условие: условий условия
успевать: успевает
успешный: успешно
установить: установлена
участвовать: участвовать
участие: участие
участник: участниками участникам участников
ученик: учеников
ущерб: ущерб
уэйверли: уэйверли
уэлли: уэлли
уэллс: уэллс
фабрика: фабрикой
фадж: фадж
фактически: фактически
факультет: факультета
фанатик: фанатики
фантастика: фантастики
фантастический: фантастические
фаренгейт: фаренгейту
фармера: фармера
февраль: февраля
феникс: феникса феникс
фермер: фермер
филип: филипа
философский: философский
фильм: фильм фильмов фильма
финал: финала финал финале
фон: фоне
фонд: фонд
фонтан: фонтаны
форов: форов
форум: форум
фоукс: фоукс
фред: фред фреда
фредерик: фредерика
фриц: фрица
фрэнк: фрэнка
фэнтези: фэнтези
хагрид: хагрид
хагрида: хагрида
хагридом: хагридом
хайнлайна: хайнлайна
хаос: хаос
хвост: хвоста
хобби: хобби
хогвартс: хогвартс
хогвартса: хогвартса
ход: ходе
хозяйка: хозяйка
холдемана: холдемана
хорек: хорька
хороший: лучший лучшего хорошее
хосе: хосе
хотеть: хочет хотела
хьюго: хьюго
хэллоуин: хэллоуин
цвет: цвет
целый: целом
цикл: цикл
цитата: цитаты
цитировать: цитировать
цысиня: цысиня
чайный: чайны
чанг: чанг
чарльз: чарльз
часть: частям часть
чаша: чашу
чей: чья
человек: человек человека люди
чемпион: чемпионов
чемпионат: чемпионат чемпионата чемпионате
чемпионка: чемпионка
чернильный: чернильно
черри: черри
черта: черты
честно: честно
чжоу: чжоу
чиновник: чиновнику
число: числе
чистокровность: чистокровности
чистый: чисто
читатель: читателей читатели
читать: читать
чтобы: чтобы
чужак: чужак
чужая: чужой
шаг: шаг
шалость: шалостей
шанс: шанс
шармбатон: шармбатон
шармбатона: шармбатона
шейбона: шейбона
шелкопряд: шелкопряд
школа: школами школе школ
шляпа: шляпа
шотландский: шотландской
эдинбург: эдинбург
экземпляр: экземпляр
электронный: электронная
элемент: элемент
эльф: эльфах эльф эльфов
эльфийка: эльфийка
эмиль: эмили
эндера: эндера
энергия: энергия
энна: энн
энциклопедия: энциклопедии
эпиграф: эпиграфе
этап: этапов
это: это этим
этот: этой эта эту
эффект: эффект
юмор: юмор
юный: юных
являться: является являются
язык: язык языках
яйцо: яйца яйцо яйцом яйце
якоб: якобы
январь: января
яркий: яркого
