аббот: аббот
аберфорт: аберфорт
аберфота: аберфота
абсолютно: абсолютно
авад: авада
август: августы августа
августус: августус
автобус: автобуса
автограф: автографом автографы
автор: автор авторе
авторство: авторства
адрес: адрес
адский: адского адский
аз: азы
азкабан: азкабан
азкабана: азкабана
азкабане: азкабане
айзекс: айзекс
аквариум: аквариум
акромантулами: акромантулами
акромантулы: акромантулы
активно: активно
активный: активное активной активный
актриса: актриса
акцент: акцентом
акция: акциях
алан: алан
аластор: аластор
албания: албании
алекто: алекто
алиса: алисы
алисия: алисией
алфавит: алфавиту
альбус: альбус
альбуса: альбуса
альбусом: альбусом
альбусу: альбусу
альфарда: альфарда
альфред: альфред
амбридж: амбридж
американский: американский
амикус: амикус
амикуса: амикуса
амнистировать: амнистирован
анаграмма: анаграммы анаграммой
англ: англ
английски: английски
английский: английскому английский английской английская
англия: англия англии
анджелина: анджелине анджелины анджелина
анимаг: анимаг
анимагами: анимагами
анимагии: анимагии
анимагической: анимагической
анимагов: анимагов
анимагом: анимагом
анимация: анимации
анна: анна
антагонист: антагонист
антилопа: антилопа
антонин: антонин
апполина: апполин
апрель: апреля
арагога: арагога
аргумент: аргументом
аргус: аргус
арест: ареста арест аресты
арестовать: арестовали арестован арестовать арестовавший
арестовывать: арестовывать
ариан: ариана арианы
аристократ: аристократа
аристократический: аристократической
арк: арку
арктурус: арктурус
армандо: армандо
артур: артура артур
архив: архив
архивировать: архивировано
архивный: архивная
астория: астории
астрель: астрель
астрономический: астрономической
атака: атак
атаковать: атакованы
атмосфера: атмосферу
атмосферный: атмосферной
б: б
бабочка: бабочку
бабушка: бабушка бабушки
бак: баками
бал: бал балу
балл: баллы балл баллов
банк: банке банк банка
бант: бантом
бар: баре
барда: барда
барон: барона
бартемиус: бартемиус
бартемиуса: бартемиуса
бартемиусом: бартемиусом
бартемия: бартемия
барти: барти
бас: басом
батильды: батильды
башня: башне башен
бег: бега
бега: бегах
беглец: беглецам
бегство: бегства
бедный: беден
бежать: бежит бежал бежать
безголовый: безголового безголовых безголовый
безделушка: безделушек
бездетный: бездетная
беззащитный: беззащитного
безобидность: безобидность
безобразие: безобразия безобразие
безопасность: безопасностью безопасность безопасности
безопасный: безопасное
безответный: безответной
безумие: безумию
безумная: безумные
безумно: безумно
безупречно: безупречно
безуспешно: безуспешно
бейн: бейн
бейна: бейна
бейтсон: бейтсон
беларуская: беларуская
белац: белац
белка: белка
белла: белл
беллатриса: беллатриса
беллатрисой: беллатрисой
беллатрису: беллатрису
беллатрисы: беллатрисы
белокурый: белокурые
белые: белые
бенджамин: бенджамин
береза: береза
беречь: берегу
берт: берту берты
беседа: беседы
бесплатно: бесплатно
бесплотный: бесплотным бесплотен
беспокоить: беспокоит
беспокоиться: беспокоится
беспорядок: беспорядок
бессмертие: бессмертия
бессмысленный: бессмысленным
бестолковость: бестолковости
бесцветный: бесцветные
бешеный: бешеное
биггерстафф: биггерстафф
бидля: бидля
бизнес: бизнес
билл: билла биллу билл
биография: биография биографию
бирн: бирн
битва: битве битву битвы
битый: битый
бифштекс: бифштексы
благодарность: благодарности
благодаря: благодаря
благородство: благородство
бладжером: бладжером
бледный: бледная бледные
блейзом: блейзом
блестеть: блестят блестящие блестящий
близкие: близких
близкий: ближе близко близкий поближе
близнец: близнецов близнецами близнецы близнецам
близость: близость близости
блонда: блонд
блондинка: блондинка
блэк: блэк
блэка: блэка
блэков: блэков
блэком: блэком
блэку: блэку
богатый: богатый
боев: боевой боевых
боец: боец
бой: бою бой
болг: болг
болгарин: болгарин
болгария: болгарии
болгарский: болгарской
болеть: болеет
болото: болото
больница: больницу больницы больнице
больничный: больничным больничное больничного больничном
больной: больна
больший: большим большей большими большие большую больше
большинство: большинстве большинству большинство
большой: большого большом большой большое
бомба: бомбе
бонни: бонни
бонэм: бонэм
борец: борцом
борьба: борьбы борьбе
ботинок: ботинки
боязливый: боязливого
боярышник: боярышник
бояться: боятся боялась боится боялись
брак: брак
браный: брана
браслет: браслетов
брат: брата братьев братом брат брату братья
браун: браун
брелок: брелоков
бреммер: бреммер
брендан: брендан
британский: британскими
бровь: брови
бродбент: бродбент
бродяга: бродяги бродяга
бросать: бросая бросает бросал
бросить: брошенным бросил
бруно: бруно
бруствер: бруствере бруствер бруствером
брэдли: брэдли
бубенчик: бубенчиками
будущее: будущем
будущий: будущей
бузинный: бузинной бузинную бузинная
букля: букля
бульдог: бульдога
бусина: бусины
бут: бут
български: български
былой: былую
быстро: быстро
быстрый: быстрее
быть: будут бывшим бывшей будучи бывший бывших бывшего были
бэгмен: бэгмен
бэгшот: бэгшот
важный: важное
вальбурге: вальбурге
вальда: вальда
вальдом: вальдом
варить: варить
василиск: василиском василиска василиск
вводить: вводит
вглубь: вглубь
ведомо: ведома
ведьма: ведьма ведьм
везде: везде
вейла: вейла
вейлой: вейлой
вейлы: вейлы
вейн: вейн
веко: веки
велеть: велел
великан: великан великанов великана
великанша: великанши
великий: великая величайших великий
великобритания: великобритании
великолепный: великолепный
величина: величиной
вепрь: вепрь
верить: верила верит
вернон: вернон
вернона: вернона
верноном: верноном
вернуться: вернуться вернувшись вернувшийся вернулся
верный: верный верно
вероятно: вероятно
вероятность: вероятность
версия: версия версии версий
верх: верх
верховный: верховный
весело: весело
весить: весь
весной: весной
вести: ведущую ведущий вести
весь: вся
весьма: весьма
ветеран: ветеран
вечно: вечно
вечный: вечные
вещь: вещей вещи
веять: веяло
взаимно: взаимно
взаимность: взаимностью
взамен: взамен
взбесить: взбесило
взгляд: взгляд взгляда взглядом
вздохнуть: вздохнувшее
взрослый: взрослый взрослая
взрыв: взрывы взрыва
взрыть: взрыв
взяток: взятки
взять: взятого взял взять взяли
вид: видом вида вид виде
видеть: видит видели видят видя
видимо: видимо
видимость: видимость
визгливый: визгливый
визенгамота: визенгамота
визжать: визжащей визжащую
викиданных: викиданных
викимедиа: викимедиа
википедии: википедии
википедия: википедия
викисклад: викисклад
виктор: виктор виктора виктору
викторий: виктория
виктуар: виктуар
вильгельмина: вильгельмина
винки: винки
вино: вину
виноватый: виноват
виновник: виновник
виновный: виновным
виноградный: виноградная
винсент: винсент
висеть: висеть висело
витиеватый: витиевато
вишневый: вишневое
вишня: вишня
вклад: вклад
включать: включая
включительно: включительно
владелец: владельцем
владелица: владелицей владелице
владеть: владеет
владимир: владимира
власть: власти властью власть
влияние: влияние влиянию
влиятельный: влиятельных влиятельный
вложить: вложенной
влюбить: влюблена
влюбиться: влюбился
влюбляться: влюбляется
вместе: вместе
вместо: вместо
вмешательство: вмешательство
вне: вне
внезапно: внезапно
внешне: внешне
внешний: внешнем
внешность: внешностью внешности внешность
внимание: внимание
вновь: вновь
вносить: вносит
внутри: внутри
внять: вняв
вовсе: вовсе
вовсю: вовсю
вод: воду
водяной: водяного
возвращать: возвращает
возвращаться: возвращается возвращаются возвращаться
возвращение: возвращение возвращения возвращении
возвышение: возвышение
возглавить: возглавил
возглавлять: возглавляет возглавлял
возглас: возгласы
воздействие: воздействием воздействия
воздействовать: воздействовать
воздух: воздухе
возле: возле
возможно: возможно
возможность: возможность
возможный: возможного возможный возможных
возмущение: возмущение
возникать: возникающие
возражение: возражениям
возраст: возрасте
возродиться: возродился
возрождаться: возрождается
возрождение: возрождении возрождение возрождения
воин: воин
война: войны войн войне война
войско: войск
войти: войти
вокзал: вокзал вокзале
вокруг: вокруг
волан: волан
волант: волант
волдеморт: волдеморт
волевой: волевая
волк: волк волка
волкодав: волкодаве
волна: волной
волновать: волнует
волноваться: волнуется
волос: волосы волосах волос волосом волосами
волчий: волчьем волчьей
волшебник: волшебником волшебника волшебников волшебник волшебнику волшебники волшебниками
волшебница: волшебницы волшебница
волшебный: волшебной волшебную волшебные волшебных волшебного волшебная волшебном волшебный волшебными волшебное
волшебство: волшебства волшебство
вон: вон
воображение: воображения
вообразить: вообразить
вообще: вообще
вопреки: вопреки
вопрос: вопросы
вор: вора
ворваться: ворвавшихся
воротник: воротником
ворчание: ворчания
воспитание: воспитание
воспитать: воспитали воспитать
воспитывать: воспитывает
воспламенение: воспламенения
воспользоваться: воспользоваться воспользовался
воспоминание: воспоминание воспоминания воспоминаниях воспоминании
воспринимать: воспринимает
воспротивиться: воспротивился
восставать: восставал
восстановить: восстановлен
восстать: восставший
восхищение: восхищение
восьмой: восьмой
впервые: впервые
впечатление: впечатление
вплоть: вплоть
вполне: вполне
впоследствии: впоследствии
впрочем: впрочем
враг: врага враг врагу
враждовать: враждовал
вратарь: вратаря вратарь
вредилки: вредилки
врезаться: врезаясь врезалась
временить: времени
временно: временно
временной: временную
время: времена время времен
врываться: врываются
вряд: вряд
все: всему всех всего всем
всевозможный: всевозможными всевозможные всевозможной
всеуслышание: всеуслышание
всеять: всей
вскоре: вскоре
вслед: вслед
вследствие: вследствие
вслух: вслух
вспоминать: вспоминают
вспомнить: вспомнив
вспыльчивый: вспыльчивая вспыльчив вспыльчива
вставать: вставать
вставить: вставил
встать: встать
встретить: встреченным встретил
встреча: встреча встрече
встречать: встречает
встречаться: встречается встречалась встречаться встречаясь
вступать: вступает вступают
вступить: вступил вступившим
всячески: всячески
вторжение: вторжения
второе: втором второе второго
второй: вторая второй
второкурсник: второкурсников
второсортности: второсортности
втянуть: втянут
вуд: вуд
вуда: вуда
вульфрик: вульфрик
вход: вход входом
входить: входя
вчетвером: вчетвером
выбор: выбору выбор выбором
выбрать: выбрана выбран
выбраться: выбраться
выведать: выведать
вывести: выведено
выводить: выводит
выглядеть: выглядят выглядит
выгнать: выгнала
выгодный: выгодной
выдавать: выдавал
выдаваться: выдающихся
выдать: выдал выдала
выдержать: выдержанного
выдра: выдра
выжить: выживший выжил
вызвать: вызвал вызвать вызвав вызванной вызванных вызванного вызвало вызвана
вызволить: вызволить вызволил
вызволять: вызволяет
вызов: вызов
вызывать: вызывал вызывает вызывают
выиграть: выигравшими выиграть выигранные выиграл
выигрывать: выигрывала
выигрыш: выигрыш
выйти: вышло выйти вышла вышел
выкидывать: выкидывал
выкинуть: выкинуть
выклевать: выклевав
выкрикнуть: выкрикнула
вылазка: вылазок вылазке
вынесение: вынесение
вынудить: вынужден вынуждена
выпивать: выпивает
выпить: выпил выпить
выполнение: выполнении
выполнить: выполненные
выполнять: выполняет выполнять
выпроваживать: выпроваживает
выпуск: выпуска выпусков
выпускать: выпускает
выпустить: выпущенного
выпытывать: выпытывают
выработать: выработала
выражаться: выражаться
выражение: выражение
выразить: выразила
вырасти: вырос
выращивание: выращиванием
вырваться: вырваться вырвался
вырезать: вырезая вырезаны
выровнять: выровнены
выручать: выручай
вырывать: вырывает
высказывание: высказываниям
выследить: выследили
высматривать: высматривать
высокий: высший высокого высокий высоким высшие
высокомерный: высокомерна высокомерен
высокопоставленный: высокопоставленным
выступать: выступающий выступает
высушить: высушенное
вытащить: вытащил
выход: выходу выхода
выходить: выходит
выходка: выходки
выходной: выходной
выявление: выявления
выясниться: выяснилось
выяснять: выясняет
выясняться: выясняется
вьющийся: вьющимися
вяз: вяз
вязка: вязки
г: г
гадкий: гадким
газета: газете
газетный: газетных
гай: гай
галеон: галеонов
галлеон: галлеон
галстук: галстук галстуке
гарпия: гарпии
гарри: гарри
гаррик: гаррик
геллерт: геллертом
генеральный: генеральным
генри: генри
гера: герой
гермиона: гермиона гермионы гермионой гермионе гермиону
героизм: героизме
героин: героине
героиня: героинь
героический: героических
герой: героя героям героев герои
гибель: гибели
гибкий: гибкая
гидеон: гидеон
гидеона: гидеона
гиперъязычок: гиперъязычок
гиппогриф: гиппогрифа гиппогриф
глава: главу главе главы глава
главное: главным главного главных главное
главный: главный
главый: главой
глаз: глазом глазами глаз глаза глазах
глазок: глазки
глисон: глисон
глубина: глубины глубине
глубокий: глубоком
глупость: глупости
глупый: глупый глупа
гнев: гнева
гнуться: гнется
гоблин: гоблинам гоблин гоблины гоблинов гоблинами гоблину
говорить: говорить говорит говорил говоря
говорят: говорят
год: гг году лета лет год годы года
гойл: гойл
гойла: гойла
гойлом: гойлом
голдстейн: голдстейн
голова: голову голова головы головой голове
голос: голос
голубой: голубые
голый: голой
гонимый: гонимая
гонт: гонт
гора: горе горой
горазд: гораздо
гораций: горация гораций горацием
гореть: горю горящими
горностай: горностай
горный: горного
госпиталь: госпитале
господин: господин
господство: господства
гостиная: гостиную
гот: готов
готовить: готовит
готовность: готовностью готовность
готовый: готова
граббли: граббли
граница: границ
граннингс: граннингс
грация: грация
грегори: грегори
грейнджер: грейнджер
грейнжер: грейнжер
гремучий: гремучей гремучую
грецкий: грецкий
грива: грива
гриммо: гриммо
грин: грин
гринготтс: гринготтс
гринграсс: гринграсс
гринт: гринт
гриффиндор: гриффиндор
гриффиндора: гриффиндора
гриффиндоркой: гриффиндоркой
гриффиндором: гриффиндором
гриффиндорской: гриффиндорской
гриффиндору: гриффиндору
гриффиндорцам: гриффиндорцам
гриффиндорцами: гриффиндорцами
гриффиндорцы: гриффиндорцы
гриффитс: гриффитс
грозность: грозностью
грозный: грозный грозного грозным
громкий: громкое
грохх: грохх
гроххом: гроххом
грошик: грошиком
грубить: грубит
грубоватый: грубоват
группа: группы
грустить: грустит
груша: грушей
грюм: грюм
грюма: грюма
грюмом: грюмом
грядка: грядках
грязнокровкой: грязнокровкой
грязный: грязный грязные
гурп: гурп
густой: густым густая густые
гэмбон: гэмбон
гэри: гэри
дабы: дабы
давать: давал давать
даваться: давалась
давление: давлением давление
давний: давние
давно: давно
дадли: дадли
далее: далее
далекий: подальше дальше
далеко: далеко
дальнейший: дальнейшем дальнейшее дальнейшая
дамблдор: дамблдор
дамблдора: дамблдора
дамблдоре: дамблдоре
дамблдором: дамблдором
дамблдору: дамблдору
даниэль: даниэль
дар: даров дарах дары
дарита: дарит
дарси: дарси
дата: дата
дать: дали данным данном дав дало дала данной дал
два: два две двух
двадцать: двадцати
дважды: дважды
двенадцать: двенадцати двенадцать
дверь: дверь
движение: движениях
двое: двое
двойной: двойной
двор: дворе
двоюродный: двоюродный двоюродного
де: де
деверь: деверем
девичество: девичестве
девичий: девичья
девон: девон
девочка: девочка девочку девочки
девушка: девушек девушка
дедушка: дедушки дедушкой
дезинформировать: дезинформировать
дезориентировать: дезориентировавшей
дейв: дейв
действенность: действенность
действие: действия действий действием действию
действительно: действительно
действовать: действовать действовала действует
декабрь: декабря
декан: декан деканами деканом
декрет: декреты
делакур: делакур
делать: делает делал делать делают
делегация: делегацией
дело: деле делом
дельфи: дельфи
дельфингтон: дельфингтон
дементора: дементора
дементорам: дементорам
дементорами: дементорами
дементоров: дементоров
дементоры: дементоры
демонстрация: демонстрацией
демонстрировать: демонстрировать демонстрировал демонстрируют
деннис: денниса
день: дней дня
деньга: деньги деньгами
департамент: департамента
дерево: дерево деревья
деревянный: деревянный
держать: держать держал держит держат
держаться: держаться
десять: десять
детская: детским
детство: детства детстве
деть: день дел дело дела
деяние: деяниях
деятельность: деятельности
деятельный: деятельное
дж: дж
джарвис: джарвис
джейми: джейми
джеймс: джеймс джеймсу джеймсом джеймса
джейн: джейн
джейсон: джейсон
джек: джеком
джемма: джемма
джеральдин: джеральдин
джесси: джесси
джим: джим
джин: джин
джинни: джинни
джоан: джоан
джон: джон
джонс: джонс
джонсон: джонсон
джордан: джордана джорданом
джордж: джордж джорджа джорджем
джорджина: джорджина
джоржа: джоржа
джоркинс: джоркинс
джошуа: джошуа
джули: джули
диадема: диадеме
диггори: диггори
диета: диету
дикий: диких
диллэйн: диллэйн
дилогия: дилогия
дин: дином
дина: дину дин дина
диппета: диппета
директор: директором директору директора директор
директриса: директрисой
дирекция: дирекция
дирижабль: дирижабли
дирк: дирк
дискредитация: дискредитации
дискредитировать: дискредитировать
дискриминация: дискриминация
дисциплинарный: дисциплинарном
дитя: дитя
дкр: дкр
длина: длиной длина
длинный: длинными длинные длинном длинный длинной
длиться: длится
дневник: дневник дневника
добби: добби
добиваться: добивается добивался
добираться: добирается
добиться: добился добившись
добровольно: добровольно
добродушие: добродушие
добродушный: добродушным
добрый: добрая добрый доброе
добывать: добывает добывать
доверие: доверия
доверить: доверили
довершить: довершить
довести: доведя доведших
доводить: доводить доводит
довольный: довольно довольна
догадаться: догадался догадавшийся
догадываться: догадывался догадывается
дож: дожем
дождаться: дождаться
дожить: дожила
дозор: дозор
дойл: дойл
дойти: дойти
док: док
доказательство: доказательства доказательств доказательство
доказывать: доказывает
долг: долг
долгий: долго долгое долгой
долгожданный: долгожданный
долгопупс: долгопупс
долгопупса: долгопупса
долгопупсов: долгопупсов
долгопупсом: долгопупсом
должен: должна должен
должность: должности должность
долиш: долиш
долиша: долиша
долорес: долорес
долохов: долохов
долоховым: долоховым
дом: дом домам домом доме
дома: дома
домашние: домашних домашние домашним домашними
домашний: домашнее домашний
доминик: доминик
домовик: домовик домовиком домовика домовикам домовику
домовой: домовыми домового домовой домовым
домовый: домовую домовый
домосед: домосед
домохозяйка: домохозяйка
домочадец: домочадцев
домысел: домысла
домыть: домой
донал: донал
донашивать: донашивал
донос: доноса
доноситься: доносится
дополнительный: дополнительные
допрашиваться: допрашивается
допрос: допросу допроса
допросить: допросить
допустить: допустил
дорогой: дорогих
досаждать: досаждала
дословный: дословно
дослужиться: дослужился
доставаться: доставались
доставить: доставлен доставить
доставлять: доставляет
достаточно: достаточно
достать: достал
достаться: достался досталась доставшийся
достигать: достигают
достигнуть: достигший
достижение: достижении
достоинство: достоинству
доступный: доступен
дотронуться: дотронуться
доходить: доходили доходило
дочка: дочки
дочь: дочь дочери
дразнить: дразнит дразнил
драка: драке
драко: драко
дракон: дракона драконам драконом драконе драконов драконами
драконий: драконьей
древность: древности
дреды: дреды
дрель: дрели
друг: друзья друзьями друг друзей другом друзьям друга другу
другой: другим другой другими другие других
дружба: дружбу дружба
дружелюбный: дружелюбный
дружеский: дружеских
дружина: дружине дружины дружину
дружить: дружил
дряхлый: дряхлая
дуб: дуб
думать: думала думая думали
дурмстранг: дурмстранг
дурмстранга: дурмстранга
дурслей: дурслей
дурсли: дурсли
дурсль: дурсль
дурсля: дурсля
дурслям: дурслям
душ: душу души
душа: душой
дуэльный: дуэльном дуэльного
дырявый: дырявого
дыхание: дыхание
дьявольский: дьявольские
дэвид: дэвид
дэвис: дэвисом дэвис
дэйл: дэйл
дэниел: дэниел
дюйм: дюймов дюйма
дядя: дяди дядей дядя
егерь: егерей егерями егерям
египетский: египетском
еда: еду
едва: едва
единорог: единорога единороги
единственный: единственное единственным единственная единственный единственного
ежедневный: ежедневного ежедневном
еженедельник: еженедельника
еиналеж: еиналеж
есть: ест
ехать: ехать едет
жаба: жаба жабу
жабросли: жабросли
жаброслях: жаброслях
жалкий: жалком
ждать: ждал ждало ждала
желание: желании
желать: желая
жена: жены жена женой жену
женатый: женат
женевьев: женевьев
жениться: женится женившись женился
женский: женский женской женском
женствена: женствена
женщина: женщина женщину
женя: жене
жертва: жертву жертвы
жесткий: жесткая
жестокий: жестоко жестока
жестокость: жестокостью жестокость
живить: живя
живоглот: живоглот живоглота
живой: жив живых живой живого
животное: животного животное животных
жизнерадостный: жизнерадостна
жизнь: жизни жизнь жизнью
жила: жила
жирок: жирком
жить: жить
жук: жука
жулик: жуликов
журить: журила
журнал: журнал журнале
журналист: журналистами
жуткий: жуткое
жюри: жюри
забава: забавы
забавный: забавными
забвение: забвения
забини: забини
забирать: забирает
заблуждение: заблуждение
заболевание: заболеваний
забор: заборами
заботиться: заботится заботиться
заботливый: заботливая
забрало: забрал
забрать: забрать
забывчивый: забывчивым
заведовать: заведует
завершать: завершающий
завершение: завершения
заветный: заветная
завещание: завещанию
завещать: завещанные
заводить: заводит
заводиться: заводится
завоевать: завоевал
завоевывать: завоевывала
завхоз: завхоз
завязать: завязанными
завязаться: завязавшейся
заглавный: заглавная
загонщик: загонщиком загонщика
загораться: загорается
загрызть: загрызть
задавать: задавать задавал
задание: задание задания заданию
задача: задачах задачей
задержание: задержании
задушить: задушенный
зажить: зажил
заикаться: заикается
заканчивать: заканчивала
заклинание: заклинанием заклинания заклинаний заклинаниями заклинание
заключать: заключает
заключение: заключению заключения
заключительный: заключительном
заклятие: заклятие заклятию заклятием заклятиями заклятия
заколдованный: заколдованные заколдованную
заколдовать: заколдовала заколдовали заколдовал заколдован
заколдовыванием: заколдовыванием
заколдовывать: заколдовывает
закон: законы законе
законодательство: законодательству
закричать: закричал
заливать: заливает
зало: зале
заманить: заманить
замаскированный: замаскированного
замедлить: замедленного
замена: замену замены
заменить: заменить заменил
заменять: заменяет
заместитель: заместитель
заметить: замечена
заметный: заметной
замечание: замечание
замечательный: замечательный
замечать: замечая замечает
замок: замку замке замок замка
замуж: замуж
замужем: замужем
замучить: замучить
замышляться: замышляется
занимать: занимает
заниматься: занимается занимались занимаясь
заносчивый: заносчив заносчивого заносчивым
занятие: занятия занятий занятии занятиях
занять: занявших занял заняла
заодно: заодно
запас: запасов
запах: запах
запинаться: запинается
запирать: запирали
записка: записки
запись: запись
заплатать: заплатанной
заподозрить: заподозрил
заполнить: заполнил
запомнить: запомнить запомнил
запрет: запрета запретам
запретить: запретили
запретный: запретного запретном запретный
запускать: запускал
запустить: запустили
заработать: заработал заработали
заражать: заражает
зарегистрировать: зарегистрированным зарегистрированный
зарывать: зарывает
засада: засаду
заседание: заседание
заставить: заставила заставил
заставлять: заставляет
заступаться: заступается
заступиться: заступилась
засунуть: засунула
засчитывать: засчитывать
затем: затем
зато: зато
заточение: заточение
затравить: затравленное
затылок: затылке затылок
затянуть: затянули
захария: захария
захватить: захватили захвачен захватил захвачено
захватывать: захватывает
зачислить: зачислен
зачислять: зачисляют
зачисляться: зачисляется
защита: защиты защита защитой защите защиту
защитить: защитив защитить
защитник: защитникам
защитный: защитных
защищать: защищала защищают защищает
заявить: заявила
заявление: заявление
заявлять: заявляя заявляет заявляют
заяц: заяц
зверь: звери
здоровье: здоровья
зелье: зельем зелье зелья
зельеварение: зельеварение
зельеварению: зельеварению
зельеварения: зельеварения
земля: земле землю
зеркало: зеркале зеркалу зеркала зеркало
златопуст: златопуст
златопуста: златопуста
златопусту: златопусту
злобный: злобные
злыдень: злыдня
змееуста: змееуста
змея: змею змеями змее
знак: знак
знакомство: знакомство
знакомый: знаком
знаменитость: знаменитостей
знаменитый: знаменитым знаменитая
знать: знавшие знает знали знал знала зная
значение: значения
значимый: значимый значимую
значительно: значительно
значительный: значительное
золотой: золотом золотая золотого золотые золотую золотой
зонт: зонт
зоя: зои
зрительный: зрительный
зуб: зубами зубы
ив: ивы ива иву
игорь: игорь
игра: игра игр игру игре игрой игры
играть: играют играет играли играя играть играл играла
игрок: игроков игрокам игроком игрок
идеально: идеально
идея: идею
идти: шла
избавиться: избавиться
избавляться: избавляется
избегать: избегает
избежать: избежать
избить: избить
избранный: избранные избран избранный
известно: известно
известный: известна известных известны известный известная известен
извиняться: извиняется
изгнать: изгнан
изготовитель: изготовитель
издавать: издающим
издевательство: издевательства
излечение: излечения
излечивать: излечивают
излечить: излечить излечен
изменить: изменил изменить
измениться: изменилось
изменять: изменять изменяет
измерение: измерения
изначально: изначально
изобретатель: изобретатель
изобретение: изобретениям изобретений
изрядно: изрядно
изучать: изучать изучает
изучение: изучение
изучить: изучив
изъесть: изъеденной
имельда: имельда
именно: именно
иметь: имеющий имел имеют имела имеющая имеющим имеет
иметься: имеется
империус: империус
империуса: империуса
империусу: империусу
имя: именем имя имени
иначе: иначе
ингредиент: ингредиенты
индюшка: индюшку
инициатива: инициативу инициативе
инна: инна
иногда: иногда
иной: ином иным
иностранный: иностранными
инспектор: инспектором
инспекционный: инспекционную инспекционной
инструмент: инструменты
инсценировать: инсценировал
интервью: интервью
интерес: интерес
интересный: интересных интересный
интересоваться: интересуясь интересуется
инфернала: инфернала
инферналы: инферналы
информационный: информационный информационные информационной
информация: информацию информацией информации
инцидент: инцидент
ириска: ириску
ирландский: ирландский
искатель: искатель
исключение: исключением
исключить: исключило
искренне: искренне
искусство: искусств
испачкать: испачкана
исполинский: исполинского
исполнить: исполнил
исполнять: исполняет исполняющим исполняют
использование: использования
использовать: используя использовала использует использовать использующие
исправить: исправленное
испытание: испытании испытания
истерика: истерикой
истина: истину
истинный: истинная
истолковать: истолковал
история: историю история историй истории
источник: источников источник
исчезать: исчезают
исчезновение: исчезновения
исчезнуть: исчезла исчез исчезнув исчезнут
итог: итоге
иэн: иэн
иэна: иэна
июль: июля
июнь: июня
й: й
йейтс: йейтс
кабан: кабан
кабаний: кабанья кабаньей
кабинет: кабинет кабинете
кавалер: кавалер
каждый: каждые каждый
кажется: кажется
казаться: казалось
казнить: казнить казни
какао: какао
каков: каков
какой: какая каких какое каким
камень: камню камень камне камня
камин: камины камина
кампания: кампании кампанию
канарейка: канарейка
кандиды: кандиды
каникулы: каникулы каникулах каникулами
капитан: капитан капитаном
капля: капля
карий: карими
каркаров: каркаров
карман: кармана
карта: карты карте карту
картер: картер
карточный: карточная
карьер: карьеру
касаться: касается
кассандра: кассандра
категория: категории
качественный: качественно
качество: качестве качеством качеств
каштан: каштан
каштановый: каштановых каштановые
квартира: квартиры квартира квартиру квартирой
квиддич: квиддич
квиддиче: квиддиче
квиддичу: квиддичу
квиринус: квиринус
квиррелл: квиррелл
квиррелла: квиррелла
квирреллом: квирреллом
кедавра: кедавра
кедр: кедр
кейв: кейв
келпи: келпи
кеннет: кеннет
кентавр: кентавра кентавров кентавры кентавр
киаран: киаран
кидать: кидая
кикимер: кикимер
кикимера: кикимера
кикимером: кикимером
кикимеру: кикимеру
кингс: кингс
кингсли: кингсли
кинжал: кинжал
кино: кино
киногерои: киногерои
киносерии: киносерии
кирпичный: кирпично
кладбище: кладбища
класс: класса класс
клеманс: клеманс
клетчатый: клетчатый
клиент: клиента
клиз: клиз
кличка: кличка кличкой кличку кличке
клуб: клуб клубе клуба
клык: клыка
клюв: клюв
клювокрыл: клювокрыл
клювокрыла: клювокрыла
ключ: ключей
клятва: клятвы
книга: книг книгами книгах книги книгу книгой книгам книге
книжный: книжный
коварный: коварна
когтевран: когтевран
когтеврана: когтеврана
когтевране: когтевране
когтевранцев: когтевранцев
код: код
кодекс: кодекс
кожа: кожа кожи кожей коже
колдовать: колдовать
колдовство: колдовство
колдун: колдуном колдун колдунов
колено: колено
колин: колин
количество: количество
коллега: коллега коллеги
коллекционный: коллекционная
колоссальный: колоссальное
колтрейн: колтрейн
кольцо: кольца
команда: команды команда команду команде
командовать: командовал
комиссия: комиссии
комментарий: комментарий
комментатор: комментатора комментатор
комментаторский: комментаторское
комментировать: комментирует
комната: комнате комнату комната комнаты
компания: компании
комплекс: комплекс
комсомольский: комсомольская
кондуктор: кондуктором
конец: концов конце концу конца
конский: конский
конспирологические: конспирологические
конструктор: конструктор
консультация: консультации
контакт: контакт контакты
контролировать: контролировать
контроль: контроль контроля
конференция: конференции
конфета: конфету конфеты
конфиденциальность: конфиденциальности
конфиденциальный: конфиденциальную
конфискация: конфискации
конфликт: конфликты
конфундус: конфундус
кончить: конченный
копия: копией копия
корбан: корбан
коренастый: коренастый
корень: корнем
кормак: кормак
кормака: кормака
корнелиус: корнелиус корнелиуса
корнер: корнера корнером корнер
корова: коровой
короста: коросте коросту коростой короста
короткий: коротких короткие короткой короткими короткий
корректный: корректный
корреспондент: корреспондентом корреспондент
коррупция: коррупция
косой: косо
кость: кость костей кости
костюм: костюм костюме
кот: кот кота
котел: котла
котлы: котлами
котоподобное: котоподобное
который: которым которое которому которыми которой которую которого которые которых которая котором который
коттедж: коттедже коттеджа
коулсон: коулсон
кошачий: кошачьим
кошка: кошку кошек кошка кошках кошки
кошмарный: кошмарных
крам: крам
крама: крама
краму: краму
красавец: красавца
красивый: красивый красива
красить: красив
красный: красный красное
красота: красоты красоту
краткий: краткое
крауч: крауч
крауча: крауча
краучей: краучей
краучем: краучем
краучу: краучу
кребба: кребба
кредитор: кредиторам
крессвелл: крессвелл
крестный: крестного
крестраж: крестраж
крестражами: крестражами
крестражах: крестражах
крестражей: крестражей
кривить: криви
крик: крика
крикнуть: крикнул
крис: крис
кристиан: кристиан
критиковать: критикует
кричать: кричал
кровавый: кровавого
кровняк: кровняк
кровожадность: кровожадностью
кровь: крови кровью кровь
кроме: кроме
кросс: кросс
крохотный: крохотный
круглый: круглые
крум: крум
крупный: крупнее крупный
крутой: крутым
круциатус: круциатус
крыло: крыле крылом крылья
крыса: крысы крысой крысу крыса
крысиный: крысиный
крыть: крыла крыло
крэбб: крэбб
крэбба: крэбба
крэббом: крэббом
крэббу: крэббу
крюкохват: крюкохват
крюкохвату: крюкохвату
крючковатый: крючковатый
кстати: кстати
кто: кого кому
кубок: кубком кубок кубке
куда: куда
кузен: кузена
кук: куки
кульминация: кульминации
кумейко: кумейко
купить: купила
курить: курит
курс: курсе курс курса
кусачий: кусачих
кусочек: кусочке
кустистый: кустистые
кухня: кухню кухне
кэрроу: кэрроу
кэти: кэти
кэтрин: кэтрин
лаванда: лаванда лаванды
лавгуд: лавгуд
лазейка: лазейку
лаковый: лаковые
лань: лань
лапа: лапам лапы
ласково: ласково
лгать: лгать
лебедь: лебедь лебедя
лев: льва
левый: левое
легкий: легче
легко: легко
леджено: леджено
лежать: лежит лежавший
леонидас: леонидас
лепреконовским: лепреконовским
лес: лесу леса лес лесах
лесник: лесник
лесничий: лесничим лесничего
лестрейндж: лестрейндж
лестрейнджами: лестрейнджами
лестрейнджей: лестрейнджей
лестрейнджем: лестрейнджем
летать: летающем летать летает летали летающий летающего
лететь: летя
летний: летние летних летний
лето: летом
летучемышиный: летучемышиный
летучий: летучей летучего
лечить: лечила
лечиться: лечился
лже: лже
либо: либо
лига: лиги
лидер: лидером
ликантропия: ликантропией
ликвидатор: ликвидатором
лили: лили
линден: линден
линейка: линейке
линия: линии
линч: линч
липа: липа
лис: лиса лис
лиса: лисой
литературный: литературных
лиф: лиф
лицензия: лицензии
лицо: лице лицо лицом
личико: личиком
лично: лично
личной: личного
лишать: лишает
лишение: лишениях
лишить: лишить
лишиться: лишился
лишний: лишние лишнего
лишь: лишь
ллойд: ллойд
лоб: лбу
ловец: ловца ловцом ловец
ловить: ловит
ложный: ложный ложного
ложь: ложью
лоза: лоза
локация: локации
локонс: локонс
локонса: локонса
ломать: ломает
лондон: лондоне лондона лондон
лондонский: лондонское
лорд: лорда лордом лорду лорд
лошадиный: лошадиными
лошадь: лошадь
лояльный: лоялен лояльное
луи: луи
луиса: луис
лунатик: лунатик
лысый: лысый
льюис: льюис
льюнг: льюнг
любезный: любезна
любимейший: любимейших
любимец: любимцем
любимчик: любимчик
любить: любят любил любить любящая любимой любит любя
любовь: любовью любовь
любой: любыми любого любом
людный: людной
людо: людо
люк: люк
люпин: люпин люпином люпина люпину
люся: люси
люциус: люциус
люциуса: люциуса
люциусом: люциусом
люциусу: люциусу
м: м
маг: магов мага
магазин: магазине магазин магазина
магический: магического магической магических магическим магическому магическими
магия: магия магию магии магией
магл: магл
маглам: маглам
маглами: маглами
маглов: маглов
магловедение: магловедение
магловским: магловским
магловских: магловских
магловской: магловской
магловском: магловском
маглы: маглы
магозоолог: магозоолог
магозоологом: магозоологом
мадам: мадам
майалл: майалл
майкл: майкл майкла майклом
макберни: макберни
макгонагалл: макгонагалл
макдональд: макдональд
македонский: македонски
маккрори: маккрори
маклагген: маклагген
маклаггена: маклаггена
максим: максим
максимально: максимально
маленький: маленький маленького малейшем маленькие маленькой меньше мало
малиновый: малинового
маллан: маллан
малоизвестный: малоизвестным
малфоев: малфоев
малфоем: малфоем
малфой: малфой
малфою: малфою
малфоя: малфоя
малфоям: малфоям
малыш: малыша
мальчик: мальчиком мальчик мальчики мальчика мальчику
мама: мама
мандрагора: мандрагорами мандрагоры мандрагор
мантикоры: мантикоры
мантия: мантией мантии
марволо: марволо
маргулис: маргулис
мардж: мардж
марджори: марджори
мари: мари
мариэтта: мариэтты мариэтта
марк: марк
маркс: маркс
маркус: маркуса
мародер: мародеров
марта: марта марте
массовый: массового массовый
мастер: мастером мастеру
мастерство: мастерство
материал: материал
материнский: материнской
матч: матч матча матчах матчей матче
мать: мать матери
махаон: махаон
маховик: маховика
машина: машина
мая: мая
медальон: медальоны медальоне медальоном медальон медальона
медведь: медведь
медицинский: медицинской
медлить: медлит
международный: международного международной
мелкий: мелкие мелких
меллинг: меллинг
менее: менее
меняться: меняется
мерлина: мерлина
место: место места месте
местонахождение: местонахождения местонахождение
месть: мести
месяц: месяцев месяц
метаморфа: метаморфа
метать: меча
метка: метку
меткий: метки метка
метла: метлой метлу метле метлы
метнуть: метнув
меч: меч
мечта: мечта
мешать: мешает
мила: мила
мимси: мимси
минерва: минерва
минервой: минервой
министерский: министерской министерских
министерство: министерства министерство министерством министерстве министерству
министр: министр министра министру
минута: минуты
мир: мира мир мире
миранда: миранда
мириам: мириам
миртл: миртл
миссис: миссис
миссия: миссий
мистер: мистером мистеру мистера мистер
митчелл: митчелл
мифический: мифические мифическими
мифологический: мифологическую
мифология: мифологии
михаил: михаил
младенческий: младенческом
младенчество: младенчестве
младший: младшего младшим младшему младший младше младшая
мнение: мнение
мнительный: мнительна
многие: многими многие многих
много: более много
многочисленный: многочисленных многочисленными многочисленного
множество: множество
мобильный: мобильная
могучий: могучего
могущественный: могущественного
можно: можно
мозг: мозга
мозоль: мозолях
мой: мои моей
молли: молли
молния: молнии
молодая: молодой
молодой: молодом молодого молод
молодость: молодости
моль: молью
мольба: мольбам
момент: момента момент
монета: монету
монстр: монстров
монтаж: монтаже
мопс: мопсом
мор: море
морально: морально
морить: моря
морт: морт
морта: морта
морте: морте
мортом: мортом
морту: морту
мотоцикл: мотоцикл мотоцикле
мочь: мог могут
мракоборец: мракоборец
мракоборца: мракоборца
мракоборцами: мракоборцами
мракоборцев: мракоборцев
мракоборцем: мракоборцем
мракоборцы: мракоборцы
мрачный: мрачный мрачных
мстить: мстить
мсье: мсье
муж: мужа мужем муж
мужской: мужской
мужчина: мужчина мужчин
мунго: мунго
мускулистый: мускулистые
мусорный: мусорными
мутный: мутная
муха: муху
мы: нами нас
мыслить: мысли
мысль: мысль
мышление: мышления
мышь: мыши
мэгги: мэгги
мэттью: мэттью
мюррей: мюррей
мягколап: мягколап
мясистый: мясистый
мяч: мяч
наблюдение: наблюдением
набор: набор
набрать: набрал
навестить: навестили
навигация: навигации навигация
навозный: навозного
навредить: навредил
навсегда: навсегда
навык: навыков навыками
навыкате: навыкате
нагайной: нагайной
нагайну: нагайну
награбить: награбленным
награда: награду
наградить: наградил
нагрубить: нагрубив
над: над
надгробный: надгробном
надежда: надеждой надежде
наделать: наделав
надменный: надменен
надоесть: надоели
надолго: надолго
надпись: надписи
назад: назад
назвать: назвала назвал назвали
наземникус: наземникус
наземникуса: наземникуса
назначать: назначает назначаемых
назначаться: назначается
назначить: назначен назначили
назойливый: назойливых
называть: называли называет называл называемые называла
наиболее: наиболее
наивность: наивности
найи: найи
найти: нашли нашла найти найден
наказ: наказ
наказание: наказаниях наказания наказаний
наказать: наказан наказала
наказывать: наказывает наказывая
накладывать: накладывает
наколдовать: наколдовал
наконец: наконец
налаживать: налаживает
наложить: наложили наложенным
намекать: намекать
намереваться: намереваясь
намерение: намерения
наметить: намечена
нанести: нанести
наносить: наносит
нападать: нападавших нападать нападает
нападение: нападении нападения нападению нападение
напасть: напал напали
написать: написана написала написать
наподобие: наподобие
напоить: напоить
наполовину: наполовину
напоминать: напоминающим напоминающая напоминал напоминают напоминающий
напр: напр
направлять: направляет
например: например
напротив: напротив
напыщенный: напыщен
нарволо: нарволо
нарочно: нарочно
нарушать: нарушали
нарушение: нарушении
нарушитель: нарушителям
нарцисс: нарциссы нарцисса
наряд: наряду
насекомое: насекомым
наслаждаться: наслаждаясь
наслать: наслал наслав
наследник: наследник
наследство: наследство
насмерть: насмерть
насмехаться: насмехается
насмешливый: насмешлив
насолить: насолить
настаивать: настаивавших
настигнуть: настиг
настойчиво: настойчиво
настоять: настоял
настоящее: настоящим настоящих настоящего настоящее настоящему
настоящий: настоящей настоящую настоящий
настроение: настроение настроения
насылать: насылает
наталия: наталия
наталя: натали
наткнуться: наткнулся
натравить: натравить
науськивать: науськивает
научиться: научился научиться
нахальный: нахален
находить: находит
находиться: находящемуся находиться находившиеся находящаяся находится находясь находилась находящийся находился
нахождение: нахождения
нацепить: нацепившая
начало: начало начале начал началом начала
начальник: начальника
начать: начали
начеку: начеку
начинать: начинают начинает начиная
начинаться: начинался
наш: наших
небо: небе
небогатый: небогатые
небольшой: небольшого небольшие
неверие: неверие
невероятно: невероятно
невероятный: невероятные невероятное
невеста: невестой
невзлюбить: невзлюбила
невидимка: невидимкой
невидимый: невидимым
невилл: невилл
невилла: невилла
невиллом: невиллом
невиновность: невиновность невиновности
невозможно: невозможно
невольно: невольно
невредимый: невредимым
невыгодно: невыгодно
невыполнимый: невыполнимое
невысокий: невысок невысокая невысокого
негласно: негласно
неделя: неделю
недоброжелатель: недоброжелателей
недобрый: недоброе
недовольный: недовольный
недовольство: недовольства недовольство
недоказанный: недоказанное
недолюбливать: недолюбливает недолюбливала
недооценка: недооценки
недостаток: недостатков недостатки
недостоверный: недостоверный
нежелательный: нежелательные
незаконный: незаконным
незаметно: незаметно
незамужний: незамужняя
незарегистрированный: незарегистрированный
неизвестно: неизвестно
неизвестный: неизвестен неизвестного неизвестным неизвестна
некогда: некогда
некоммерческий: некоммерческой
некоторые: некоторым некоторые
некоторый: некоторое
некролог: некролог
неловкий: неловким
нельзя: нельзя
нелюбовь: нелюбви
немилость: немилость
немногие: немногих
немного: немного
немногословный: немногословный
ненавидеть: ненавидел ненавидит ненавидящий
ненавистный: ненавистным
ненадолго: ненадолго
ненастоящий: ненастоящий
необоснованный: необоснованные необоснованных
необходимо: необходимо
необходимость: необходимости
необходимый: необходимых
необычный: необычное
неоднократно: неоднократно
неожиданно: неожиданно
неожиданный: неожиданный
неопр: неопр
неопрятный: неопрятное
неопытный: неопытен
неосмотрительный: неосмотрительно
неотрывно: неотрывно
неполный: неполный
непосредственно: непосредственно
непосредственный: непосредственное непосредственного
непреложный: непреложный
непристойный: непристойные
неприязненный: неприязненное
неприятность: неприятностей
неприятный: неприятный неприятных
непродуманность: непродуманности
непрожаренные: непрожаренные
непростительный: непростительные
неравнодушный: неравнодушна неравнодушен
нерв: нерв
нередко: нередко
нескандальный: нескандальный
несколько: нескольких несколько
несмотря: несмотря
несовершеннолетний: несовершеннолетнего несовершеннолетних
несогласный: несогласных
неспособность: неспособности
неспособный: неспособен
неуверенность: неуверенность неуверенности
неудачный: неудачным
неумышленный: неумышленно
неустойчивый: неустойчивый
нечисть: нечисти
низенький: низенькая
низкий: ниже
низл: низл
ника: ника
никак: никак
никакой: никаких
никнуть: ник
никогда: никогда
николас: николасом николас николаса
никто: никто никому
нимфадора: нимфадора
нимфадору: нимфадору
нимфадоры: нимфадоры
ниспадать: ниспадающие
новый: нового новым новый новую новой новые новое
нога: ног ноги ногу
нож: ножом
нора: норы нору норе
норберт: норберта
норрис: норрис
нос: нос носом
носить: носила носит
ночной: ночной
ночь: ночам ночь
ноябрь: ноября
нравиться: нравятся нравится нравиться
нуждаться: нуждающийся
ньют: ньют
нюхлеров: нюхлеров
об: об
оба: обоих
обаятельный: обаятелен обаятельную
обвинение: обвинению
обвинить: обвинил
обвинять: обвинял обвиняя
обвиняться: обвинялся
обвиснуть: обвисшие
обдумать: обдумав
обезвреживать: обезвреживает обезвреживают
обезобразить: обезображено
оберег: оберегов
оберегать: оберегает
обернуться: обернувшись
обеспечение: обеспечения
обеспечить: обеспечить
обет: обет
обидчица: обидчицу
обижать: обижали
обитание: обитания
обитатель: обитателями обитатель
обитать: обитал обитающее
облава: облаву
обладатель: обладатель
обладать: обладает обладающий обладала
область: область
облик: облик облике
обличие: обличье
обмануть: обманул
обманщик: обманщиком
обмен: обмен
обнаружение: обнаружения
обнаруживать: обнаруживают
обнаружить: обнаружили
обо: обо
обожать: обожает обожающая обожают
обозвать: обозвал
обозначать: обозначавший
обокрасть: обокрал
оборваться: оборвалась
оборона: обороне оборону
оборонять: оборонявших оборонять
обороняться: обороняться
оборотень: оборотнем оборотень оборотня оборотней
оборотный: оборотное оборотного
образ: образа образом образе
образец: образцом
образование: образовании
обрасти: оброс
обратить: обратить
обратный: обратно
обращаться: обращались
обращение: обращения
обрести: обрести
обстановка: обстановки
обстоятельство: обстоятельство
обсуждение: обсуждение
обучаться: обучался
обучение: обучения
общаться: общается
общение: общение
общество: обществе
общий: общий
объявить: объявлено
объяснять: объясняет
обычно: обычно
обычный: обычными обычные обычной обычный обычным
обязанность: обязанности
обязательно: обязательно
обязать: обязанным
овладевать: овладевает
оглушать: оглушает
оглушительный: оглушительный
оглушить: оглушив оглушена оглушил
огненный: огненный огненно
огонь: огонь огня
огород: огороде огорода
ограбление: ограбления
ограничение: ограничению
ограничить: ограничило
огромный: огромными огромным огромная огромные огромнейшей огромное
ода: од
одеваться: одевается одеваться
одежда: одежда одежду одежде
одерживать: одерживает
один: одну одной одна одном одного один одними одно одним
одинаково: одинаково
одиннадцатый: одиннадцатом
одиннадцать: одиннадцать одиннадцати
одиночество: одиночество одиночестве
однажды: однажды
однако: однако
одновременно: одновременно
однокурсник: однокурсников однокурсник
однокурсница: однокурсница
одобрение: одобрения
одобрять: одобряют
одолеть: одолеть
одри: одри
ожерелье: ожерелья ожерелье
оживлять: оживляя
ожог: ожоги
ожоговый: ожогов
озаботить: озабочен
озеро: озеро
оказаться: оказался оказавшись оказавшееся
оказывать: оказывает оказывать
оказываться: оказывается
окаменение: окаменения
оканчивать: оканчивает
окклюменции: окклюменции
околдовать: околдовать
около: около
окончание: окончании окончания
окончательно: окончательно
окончить: окончив окончил
окружать: окружающих
октябрь: октября
олден: олден
олдмен: олдмен
олень: олень оленем
оливер: оливер оливера
оливия: оливию
олимпия: олимпией
олливандер: олливандер
олливандера: олливандера
олливандером: олливандером
олливандеру: олливандеру
он: нему
она: ею
они: им ими них ними
опасность: опасность опасности
опасный: опасных опасные опасное опасны
опека: опеки опека
операция: операции операция операцией
опередить: опередив
опережать: опережает
описание: описанию описание описании
описать: описанные описан описана
описывать: описывает
описываться: описывается описывающийся
оплакивать: оплакивает
опоздание: опоздания
опоздать: опоздал
опора: опорой
оправа: оправе
оправдать: оправдан
оправдывать: оправдывала
оправиться: оправился
определение: определение
определять: определять
опровергать: опровергающих
опустеть: опустевший опустеет
опыт: опыт
опытный: опытных опытными
оранжевый: оранжевый
оранжерея: оранжереях
организация: организации организация
организовать: организует организовала
организовывать: организовывает
орден: ордену ордене ордена орден
орех: орех
оригинал: оригинала
оригинальный: оригинальный
оружие: оружие
оса: осах
осваивать: осваивали
освальд: освальд
освещать: освещать
освободить: освободить освободил
освободиться: освободился
освобождать: освобождает
освобождаться: освобождается
освобождение: освобождением освобождения
освоить: освоил
осина: осина
оскорбительный: оскорбительные
оскорблять: оскорбляет
ослеплять: ослепляет
ослушание: ослушание
основатель: основатель
основать: основанная
основное: основном основное
основной: основные основную основная
особенно: особенно
особенность: особенности
особенный: особенным
особняк: особняке особняк
особый: особым особую
оставаться: оставались оставался оставаясь
оставить: оставил оставила оставить оставившие
оставлять: оставляли оставляет
остальное: остальные остальных остальными
остаться: осталось останется остался осталась
остро: остро
остров: острове
остроконечный: остроконечной
остролист: остролист
острый: острым острый
отбор: отборе
отвага: отвагу
ответ: ответ
ответственность: ответственности ответственность
отвечать: отвечал отвечали отвечать
отдавать: отдает
отдать: отдать отдадут отданные отдан отдал
отдел: отдел отделе
отделение: отделение отделении
отдельно: отдельно
отдельный: отдельных отдельные
отец: отца отцом отец отцу
отзываться: отзывается
отзывчивый: отзывчивая
отказ: отказа отказ
отказаться: отказался отказалась
откликнуться: откликнулась
открываться: открывалась
открытие: открытия
открыть: открыл открыть открыли
откуда: откуда
отличаться: отличалось отличался отличаться
отличие: отличие
отличительный: отличительной отличительным
отличница: отличница
отлично: отлично
отличный: отличную отличный
отлучаться: отлучается
отметина: отметинами
отметить: отметила
отмечать: отмечает
отнести: отнести
относиться: относится относились относятся относился относиться
отношение: отношения отношениям отношению отношений отношениях отношение
отойти: отойти
отомстить: отомстить
оторвать: оторванный
отправить: отправив отправить отправлен отправили отправил отправила
отправиться: отправился
отправка: отправки
отправлять: отправлять
отправляться: отправлялись отправляется
отпускать: отпускать
отпустить: отпущен
отравить: отравленный
отражение: отражении
отредактировать: отредактирована
отрезать: отрезал
отрицать: отрицать отрицает
отрубание: отрубание
отряд: отряда отряд отряде отряду
отставка: отставку отставке
отсутствие: отсутствие отсутствием отсутствия
отсутствовать: отсутствовала
отталкивать: отталкивающий
оттаскивать: оттаскивает
оттенок: оттенка
оттуда: оттуда
отучиться: отучившись
отцовский: отцовское
отчасти: отчасти
отчаяние: отчаяния
отчего: отчего
отыгрываться: отыгрываясь
официально: официально
охота: охотой охоту
охотиться: охотится охотился
охотник: охотник охотником охотника
охотников: охотников
охрана: охрана охране охраной
охранять: охранять охраняющих охраняющий
оценить: оценить
очевидный: очевидную
очень: очень
очередной: очередной
очередь: очередь
очистить: очистить
очки: очки очками очков очках
очный: очную
ошибаться: ошибался
ошибка: ошибке ошибки
павлин: павлина
падать: падает падать
падение: падения
пак: пак
палата: палате
палач: палача
палец: палец пальцами пальца
палисандр: палисандр
палочка: палочку палочке палочек палочка палочками палочки палочкой
память: памяти память
пантера: пантера
папа: папа
пар: пары пару пара
парализовать: парализован
параллельно: параллельно
параметр: параметров параметры
парвати: парвати
парень: парнем парень парня
парк: парк
паркинсон: паркинсон
пародия: пародии
паря: пари
пасха: пасху
пасхальный: пасхальными
патил: патил
патриций: патриция
патронус: патронус
патронуса: патронуса
паттинсон: паттинсон
паучий: паучьего
пепел: пепла
пепельный: пепельный
первое: первым первого первое первых первом
первокурсник: первокурсников
первокурсница: первокурсница
первый: первой первую первая первый
пергамент: пергамент
перевести: перевели
перевод: переводе перевод перевода
переводчик: переводчика
перевозить: перевозить
перевозка: перевозке перевозки
переворот: переворота
перевраную: перевраную
перед: перед
передать: переданный передав передать
передача: передачи передачу
передряга: передряги
переживать: переживает переживающий переживающая
пережитое: пережитого
пережить: пережил
переиграть: переиграть
перейти: перейти
перелом: перелома
переметнуться: переметнулся
перенаправить: перенаправлено
перепад: перепадам
переписываться: переписывается переписываются
переправка: переправке
переселиться: переселился
переть: при
перечислить: перечислены
период: период
перкин: перкин
перо: перьев пером пера перо
перси: перси
персидский: персидская
персонаж: персонаж персонажам персонажа персонажами персонажей персонажи
персонал: персонал персонала
персональный: персональные
петтигрю: петтигрю
петуния: петуния петунии
петуньей: петуньей
петуньи: петуньи
петунья: петунья
печать: печати
пешком: пешком
пещера: пещеры пещере пещеру
пивз: пивз
пивза: пивза
пивзом: пивзом
пиво: пивом пива
пий: пий пия
писатель: писателем писатель
писательница: писательницы писательницей писательницу писательница
писать: писать писала писало пишет
письмо: письмо письма
питер: питером питер питера
питомец: питомцами
пить: пить
пихта: пихта
пишущий: пишущим
пл: пл
плакать: плачет
плакса: плаксы плакса
план: планы планов план плане
плат: плату
платить: платит
платок: платка
платье: платье
плащ: плащ
племянник: племянником племяннику племянника
плен: плен
пленник: пленников
плечо: плечах
плод: плоды
плоскостопие: плоскостопие
плоть: плоти
плохо: плохо
плохой: плохой
площадь: площадь площади
побег: побег побега
победа: победу победой победы
победить: победил победили
побежалый: побежал
побеждать: побеждает
поведение: поведения
повелитель: повелителю
поверить: поверить поверили
поверхность: поверхность
повидать: повидавший
повлиять: повлиявшие повлиять
повод: повод
повышать: повышали
повышенный: повышенное
повязать: повязанный
погиб: погиб
погибать: погибает
погибнуть: погибли погибшего погибшей погибла
поговорить: поговорил
подарить: подаренная подарила подарив подарили подарил
подарок: подарки подарок подарком
подача: подачи
подбора: подборе
подбородок: подбородок
подбрасывать: подбрасывает
подвал: подвале
подвергать: подвергает
подвергаться: подвергается
подвергнуть: подвергли подвергнув подвергнут
подвергнуться: подвергся подверглись
подвеска: подвесок
подвиг: подвиги
поддаваться: поддающийся
поддельный: поддельных
поддержать: поддержать
поддерживать: поддерживала поддерживал поддерживает поддерживать
поддержка: поддержке поддержка
поделить: поделила
поделиться: поделится
подземный: подземное
подкинуть: подкинул
подловить: подловить
подменить: подменив
поднимать: поднимает
подняться: поднявшейся
подобно: подобно
подозревать: подозревает подозреваемых
подозрение: подозрения подозрение
подойти: подойти
подражание: подражания
подразделение: подразделение
подробность: подробностях
подробный: подробнее
подросток: подросток
подруга: подругу подруга подруг
подружиться: подружился подружились
подсказка: подсказку
подсказывать: подсказывает
подслушать: подслушал
подслушивание: подслушивания
подслушивать: подслушивают
подсудимая: подсудимых
подсунуть: подсунули подсунул подсунуть
подтвердить: подтвердила подтвердить
подтверждать: подтверждает
подтверждаться: подтверждается
подтянуть: подтянутый
подумать: подумал
подхалим: подхалим
поединок: поединке
поезд: поезд поезде поезда
поездка: поездки
поехать: поехала
пожелать: пожелав пожелал
пожениться: поженились
пожертвовать: пожертвовав пожертвовать
пожизненный: пожизненному
пожилой: пожилой
пожиратель: пожирателями пожирателям пожирателя пожирателей пожиратель пожирателем пожиратели
пожирательницей: пожирательницей
пожурить: пожурить
позаботиться: позаботится
позаимствовать: позаимствовала
позволять: позволяет
поздний: позднее позже
поздравление: поздравлениями
познакомить: познакомил
познакомиться: познакомился
поиск: поиски поиск поисками поиску
поймать: поймал поймать
пойти: пойти пошла
пока: пока
показать: показан показать
показывать: показывала показывал показывает
покидать: покидает
покинуть: покинув покинула покинет покинувший покинуть покинул
поколебать: поколебало
покровитель: покровителя покровителе
покрывать: покрывает
покупка: покупки
покусать: покусал покусан покусавший
пол: пола пол
полагать: полагая
поле: поля
полететь: полетели
политик: политика политике
полнолуние: полнолуния полнолунием
полномочие: полномочий полномочия
полностью: полностью
полный: полное полной полного полная полным
половинка: половинки
положение: положение положения
положительный: положительный
положить: положил
полосатый: полосатой
полоумный: полоумная полоумной
полтергейст: полтергейстах полтергейст
полувеликан: полувеликан
полукровка: полукровка
полумна: полумна
полумне: полумне
полумной: полумной
полумну: полумну
полумны: полумны
полуощипанную: полуощипанную
получать: получает получал
получаться: получается
получеловек: получеловек
получить: получила получил получили получив получить
получиться: получилось
польза: пользу
пользоваться: пользуется
полюбить: полюбила
поменять: поменять
поменяться: поменялся
поместье: поместья поместье
помешать: помешало помешана
помимо: помимо
помнить: помнит
помогать: помогают помогала помогал помогали помогает помогая
помона: помона
помочь: помог помогли поможет помочь
помощник: помощника помощником
помощь: помощью помощи помощь
помфри: помфри
понадобиться: понадобилось понадобилась понадобился понадобятся
поначалу: поначалу
понимать: понимает
поносить: поношенной
понравиться: понравился
понятие: понятия
понять: поняли поняла
поп: попов
попадать: попадает
попадаться: попадается
попасть: попавших попал попасть попала попавшими
попечительский: попечительского
пополам: пополам
поппи: поппи
попросить: попросил попросив
попугай: попугай
популярность: популярности популярностью
популярный: популярных популярной популярен
попытаться: попытался попыталась
попытка: попыткой попытки попытке попыток попытку
пора: пор
порабощать: порабощает
порой: порой
порох: пороха
порпингтон: порпингтон
портал: портал
портить: портит
поручать: поручает
поручение: поручению поручение
поручить: поручили
порция: порцией порции
порядком: порядком
порядок: порядка
порядочность: порядочность
посадить: посажена посадили посажен
посвятить: посвящена
поселить: поселил
поселиться: поселился
посетитель: посетителям
посетить: посетившие посетила
посещать: посещает посещать
посещение: посещения
поскольку: поскольку
послать: послав послал послала
последний: последнее последняя последний последнего последние последних последней последним
последователь: последователи последователей
последовать: последовавшей
последствие: последствия
последующий: последующим последующих
послесловие: послесловии
послужить: послужило
посмотреть: посмотрев посмотрел
пособник: пособники
пособничал: пособничал
посол: после
посреди: посреди
поссориться: поссорилась
пост: посту поста пост
поставить: поставило поставил поставлен
постараться: постарались
постепенно: постепенно
постоянно: постоянно
постоянный: постоянная
пострадать: пострадавшую
поступить: поступил поступить
поступление: поступлением
посылать: посылает
потайной: потайной потайные
потенциальный: потенциальной
потеря: потери
потерять: потеряла потерял потерявшего потерянного
потомок: потомкам потомками
потребовать: потребовал
потрудиться: потрудился
потрясать: потрясает
потрясение: потрясением
потрясти: потрясено потрясла
поттер: поттером поттер поттера поттеров поттеру поттерам поттере
поттерианы: поттерианы
поттеровский: поттеровский
похитить: похитил
похищать: похищают
похищаться: похищается
похлеба: похлеба
похлебе: похлебе
похлебы: похлебы
поход: поход
походить: походит
походка: походка
похоже: похоже
похожий: похожая похожий похожи похожими похож
похоронить: похоронил
похороны: похороны похоронах похорон
поцелуй: поцелую
почва: почве
почему: почему
починить: починил
почта: почту
почтение: почтением
почтить: почти
пошутить: пошутить
пощада: пощады
пощадить: пощадить пощадил
поэзи: поэзи
поэтому: поэтому
появиться: появились появившемся появилась появившихся
появление: появлении появление
появляться: появляющийся появляясь появляться появляется
пояс: пояса
правда: правда правды правду
правдивый: правдивое
правильность: правильности
правильный: правильное
правительство: правительства
править: правило правила править
правка: правок правки
право: праву
правопорядок: правопорядка
правый: правой права
прадед: прадедом
практический: практически практических
пребывание: пребывания
пребывать: пребывает
превосходный: превосходно
превосходящий: превосходящей
превратить: превратит превратив превратил
превратиться: превратился
превращать: превращает
превращаться: превращаться превращается превращаясь
превращение: превращение
преданно: преданно
преданность: преданность
преданный: преданная преданный предан преданных
предатель: предатель
предательство: предательство предательстве
предать: предала предавшей предал
предварительно: предварительно
предварительный: предварительной
предвидеть: предвидела
предел: пределами
предлагать: предлагал
предложить: предложил предложить
предмет: предметы предметам предмет
предок: предков предки предках
предоставить: предоставил
предоставлять: предоставляет
предотвратить: предотвратить
предполагать: предполагал
предпочитать: предпочитая предпочитает
предраг: предраг
предрасположенность: предрасположенность
председатель: председатель
предсказание: предсказания
предсказанье: предсказаний
представитель: представителя представителям представители
представить: представлен
представиться: представились
представление: представлении
представлять: представлявший
представляться: представляется
предстоять: предстоит
предубеждение: предубеждения
предупреждать: предупреждает
предъявить: предъявить
предыстория: предыстория предыстории
прежний: прежнему
президент: президента
презирать: презирать презирал
презрительно: презрительно
преклонный: преклонных
прекрасно: прекрасно
прекрасный: прекрасный прекрасных
прекратить: прекратила прекратить прекратил
прекращаться: прекращается
премьер: премьер
преподавание: преподавание преподавания преподаванию преподавании
преподаватель: преподаватель преподавателей преподавателям преподавателя преподаватели преподавателем
преподавательский: преподавательской преподавательские
преподавать: преподавать преподавал преподававший
преподнести: преподнести
препятствие: препятствий препятствию
препятствовать: препятствует
пресекаться: пресекались
преследовать: преследовала
пресс: прессе прессы
преступление: преступлении преступление преступления
преступник: преступниками преступник
прибегать: прибегая прибегает
прибирать: прибирает
приближаться: приближающегося
приблизиться: приблизиться
прибывать: прибывает
прибыть: прибыл
привести: привело
привидение: привидениями привидение привидением
привилегия: привилегии
привлекательный: привлекательный привлекательна
привлечение: привлечение
привлечь: привлекли
приводить: приводит
приворотный: приворотным
привычка: привычка привычках
пригласить: пригласил
приглашение: приглашение приглашением
приглядывать: приглядывать
приговорить: приговорена
приготовить: приготовленную
пригрозить: пригрозила
придавать: придавая придававшие
придвигаться: придвигаясь
придерживать: придерживает
придерживаться: придерживается
придира: придира
придумать: придуманную
придумывать: придумывает
приезд: приезд
приезжать: приезжал приезжает
приз: приза
призвать: призванный
приземистый: приземистый
признавать: признавать
признание: признание
признать: признал признало признали
признаться: призналась
призрак: призрак призраков призраком призраками
призыв: призыв
прийти: пришедшего пришедших
прийтись: пришлось пришлась
приказ: приказу приказов
приказание: приказания
приказать: приказал
приказывать: приказывает
прикончить: прикончить
прилюдно: прилюдно
приманка: приманку
применение: применения
применить: применил
применять: применять применяет применял применяя
примереть: пример
примерка: примеркам
примерный: примерный
примечание: примечания
примирить: примирило
примкнуть: примкнул
принадлежать: принадлежащий принадлежавший принадлежащему принадлежал принадлежит
принести: принести
принимать: принимает принимал принимать
приносить: приносит
принц: принц
принять: принял принятых приняв принят принять приняты
приобрести: приобрела
приобретать: приобретает
приручить: прирученный
присвист: присвистом
прислать: пришли
прислуживать: прислуживать
присматривать: присматривать присматривала
присмотр: присмотром
присоединение: присоединения
присоединиться: присоединился присоединились присоединилась
присоединяться: присоединяется
приспешник: приспешники приспешник
приставить: приставил
пристроить: пристроить
приступить: приступить
присутствовать: присутствовал присутствует
присылать: присылает
притворяться: притворялся
приход: прихода
приходить: приходить приходит
приходиться: приходится
прихрамывать: прихрамывал
причина: причине причин причина причиной
приютить: приютил
приятель: приятелем приятель приятелями
приятно: приятно
про: про
пробиться: пробиться
пробка: пробок
проблема: проблем проблемой проблемы
пробор: пробор
пробраться: пробраться
провал: провала
проведение: проведения
проверить: проверенной проверить
проверка: проверки
проверять: проверяет
проверяться: проверялась
провести: провести
провидица: провидица
провиниться: провинившимся провинившегося
проводить: проводит проводил
провожать: провожая
проволочный: проволочной
проговариваться: проговаривается
проговориться: проговорился
прогонять: прогоняет
программа: программе
продавец: продавец
продвигать: продвигающий
продемонстрировать: продемонстрировав
продовольствие: продовольствием
продолжать: продолжала продолжает продолжать
продолжаться: продолжается
продолжение: продолжение
продолжить: продолжил
проект: проектах
проживать: проживающего проживает
прозвище: прозвище
прозрачный: прозрачен
проиграть: проиграла
произведенье: произведений
производить: производил производящей
производство: производство
произносить: произносить
произойти: происшедшем произошла произошло
происходить: происходит происходила происходившим
проказа: проказы
проклясть: проклятого проклятое
проклятие: проклятий проклятие
проложить: проложен
промах: промахов
пронзительный: пронзительный пронзительные
проникать: проникают
проникнуть: проникнуть проник
пропадать: пропадает
пропасть: пропавшее
проработать: проработал
прорицание: прорицаний прорицания
пророк: пророке пророка
пророчество: пророчество пророчеству пророчестве
просидеть: просидел
просить: просит просила
просматривать: просматривала
просмотр: просмотры
просто: просто
простой: простые проще
пространство: пространства
просьба: просьбе просьбой
протез: протез
против: против
противница: противницей
противоположный: противоположного
противостояние: противостояния
прототип: прототипом
протяжение: протяжении
профан: профаном
профессионал: профессионал
профессия: профессии
профессор: профессором профессора профессор профессору
проходить: проходившем проходить
прохождение: прохождением прохождении
процедура: процедуру
процент: процент
процесс: процессе процесс
прочий: прочие прочих прочее
прочить: прочили прочь прочим
прошлый: прошлые прошлое
прощать: прощал
проявить: проявил проявить
проявление: проявление
проявлять: проявляет
проявляться: проявляется
пруэттов: пруэттов
прытко: прытко
прыщ: прыщи прыщами
прядь: прядь прядями
прямая: прямыми
прямой: прям прямо
прямолинейный: прямолинейный
прятать: прятал прячет
прятаться: прячущихся
птенец: птенец
птица: птицу птица
публика: публике
публикация: публикация
публиковаться: публикуется
публичный: публично
пугало: пугал
пугать: пугать пугали
пугливый: пугливым
пускаться: пускается
пустить: пущено пущенного
пустой: пустым
путаться: путается
путеводитель: путеводитель
путешествовать: путешествовал
путина: путина
путь: пути
пуффендуй: пуффендуй
пуффендуя: пуффендуя
пухленький: пухленькая
пухлый: пухлым
пыльный: пыльно
пытать: пытали
пытаться: пытаются пытался пыталась пытавшаяся пытается пытаясь
пытка: пытку пытками пытках
пьяный: пьяное пьяная
пэддлмир: пэддлмир
пэк: пэк
пэм: пэм
пэнси: пэнси
пята: пятой
пятикратный: пятикратный
пятиметровый: пятиметровый
пятый: пятом пятый пятого
пять: пяти
пятьдесят: пятьдесят
р: р
рабастаном: рабастаном
работа: работе работы работу
работать: работал работали работает работать работала
работник: работник
рабочий: рабочем
рада: рад
ради: ради
радио: радио
раз: раза
разбирательство: разбирательство
разбираться: разбирающийся
разбить: разбили
разворачивать: разворачивает
разворачиваться: разворачивается
разгневать: разгневанных
разговаривать: разговаривать
разговор: разговоре разговор разговора
раздавать: раздавать
раздавить: раздавленная
разделить: разделить
разделиться: разделились
раздражать: раздражает
раздувать: раздувая
раздуть: раздуть
различный: различными различных
размах: размах
размашистый: размашистая
размер: размером
разноцветный: разноцветных
разный: разных разными разного
разоблачать: разоблачает
разорвать: разорвать
разоружного: разоружного
разочарование: разочарованию
разработчик: разработчики
разрез: разрез
разрешить: разрешили
разрушить: разрушить
разрыв: разрыву
разум: разум
разуметься: разумеется
разумный: разумное
разыскивать: разыскивать
райт: райт
рак: раком
ракушка: ракушка
рана: раны
ранее: ранее
ранение: ранения
раненый: раненых раненый ранен
ранить: ранила ранил ранит
ранний: раньше ранний
рано: рано
раскаяться: раскаялся
расклад: раскладе
раскрывать: раскрывает
раскрытие: раскрытии раскрытия
раскрыть: раскрыла
расписаться: расписались
расплачиваться: расплачивается
распознать: распознал
располагать: располагает
распределять: распределяющей распределяющая
рассеять: рассеянным рассеян
рассказ: рассказы рассказах
рассказать: рассказать рассказал
рассказывать: рассказывает рассказывать
расследование: расследование
рассмотреть: рассмотреть
расспрашивать: расспрашивает
расставаться: расстаются
расстаться: рассталась расстаться
расстояние: расстояние
расстраиваться: расстраивалась расстраивается
рассудительный: рассудительного
рассудок: рассудка рассудок
расталкивать: расталкивая
растение: растения
растенье: растений
расти: росли
растрогать: растроганный
расцвет: расцвета
расценить: расценена
расширение: расширение
рачительный: рачительный
реагировать: реагируя
реальный: реального реальными реальное реальной
ребенок: детей ребенка детях дети
ревматизм: ревматизмом
ревновать: ревновала
ревность: ревность
регистратор: регистратором
регулус: регулус
регулуса: регулуса
регулусе: регулусе
регулусу: регулусу
регулярно: регулярно
реддл: реддл
реддла: реддла
реддлом: реддлом
редкий: редкими
редко: редко
режим: режиму
резкий: резким резко
результат: результат результате результатов
рекламный: рекламным
религиозный: религиозные
реликвия: реликвии
репутация: репутации репутацию
реформировать: реформирует
решающий: решающем
решение: решений решение решения
решительный: решительно решительный
решить: решили решено решил
рика: рик
рикман: рикман
римус: римус
римуса: римуса
римусом: римусом
рисковый: рисковым
рита: риту рита риты
ричард: ричард
ричардсон: ричардсон
робби: робби
роберт: роберт
робкий: робко
ровесник: ровесников ровесник
ровесница: ровесница
ровный: ровные
род: род
роджер: роджер роджером
родитель: родителям родителями родителей родители
родить: рождена родила
родиться: родиться родились родился родилась
родной: родного родной родная
родовой: родовом
родольфусом: родольфусом
родословный: родословной
родственник: родственников родственниками родственникам
родственный: родственную родственные
рожать: рожает
рождаться: рождаются
рождение: рождения рождении
рождественский: рождественский
рождество: рождество
роза: розу
розмерты: розмерты
розовый: розовыми розовым розовый розовое
розыск: розыске
роксана: роксаной
роланда: роланда
ролинг: ролинг
роль: роль роли
рольфа: рольфа
роман: романов роману романе романа
рон: рону роном рона рон
рональд: рональдом
росмэн: росмэн
росмэна: росмэна
рост: рост ростом роста
рот: рот
роулинг: роулинг
роулинс: роулинс
рубеус: рубеус
ругать: ругала
руина: руинам руин
рука: руке руку рукой руками рук руки
руквуд: руквуд
руквудом: руквудом
руководство: руководством руководства
румыния: румынии
руперт: руперт
русалка: русалки
русский: русском русский
русскоязычный: русскоязычном
русый: рус
руфус: руфус
руфуса: руфуса
рыбка: рыбке рыбка
рыжеватый: рыжевато
рыжий: рыжими рыжий рыжие
рысь: рысь
рыцарь: рыцарь
рьяный: рьяно
рэдклифф: рэдклифф
рэйф: рэйф
рэнделл: рэнделл
рэнкин: рэнкин
ряд: рядом
саботировать: саботировала
сад: саду
сажать: сажает
саймон: саймон
саксаул: саксаул
саламандер: саламандер
саламандера: саламандера
саламандра: саламандры
сам: самой самом самим саму сама
самочувствие: самочувствием
самый: самую самый самая самым самых самые
сантиметр: см
сапог: сапога
саркастичный: саркастичен
саундтрек: саундтрек
сахар: сахаром
сбегать: сбегает
сбежать: сбежала сбежали сбежал сбежать
сбить: сбила сбил
сборная: сборную сборной
сбрасывать: сбрасывая
сбросить: сбросив
сбываться: сбываются сбывается
св: св
свадьба: свадьбе свадьбу
сварить: сварила
сведение: сведения
сведущий: сведущая
свежий: свежие свежем
сверкающий: сверкающий
света: свете
светловолосый: светловолосый
светлый: светлые
свидетель: свидетелем свидетеля
свидетельница: свидетельницей
свидетельство: свидетельство
свиной: свиной
свисать: свисает
свитер: свитер
свобода: свободе свободу
свободно: свободно
свободный: свободного свободной свободный свободным
свое: своих свои своему свое своего своим своими
своеобразный: своеобразный
свой: свой своей свою
связанный: связано связанные связанных связанной связан связанным связаны связанное
связаться: свяжитесь
связываться: связываясь
связь: связи связь
святой: свято святого
святочный: святочный святочном
сглаз: сглаз
сдать: сдал
сделать: сделаны сделает сделанная сделать сделал сделала сделанное сделано сделана
сделка: сделки
себя: собой
север: севере
северус: северус
северуса: северуса
северусом: северусом
северусу: северусу
седой: седую седых седыми
седрик: седрика седриком седрик седрику
седьмой: седьмом седьмой
сезон: сезона
сейф: сейф
секрет: секреты секрета
секретарить: секретарь
секретный: секретные секретное
сектор: сектор
сектумсемпра: сектумсемпра
семейный: семейной
семейство: семейству семейство семейства
семеро: семерых
семнадцатилетие: семнадцатилетие
семнадцать: семнадцать
семь: семь семи
семью: семью
семья: семья семье семьи
семьянин: семьянин
сентябрь: сентября
сербский: сербский
сердечная: сердечная
сердиться: сердится
сердце: сердцах сердце сердца
сердцевина: сердцевина
серебряный: серебряную серебряной
сериал: сериал сериала
серия: серии серию серия
серый: серая серые серыми
серьга: серьгу
сестра: сестра сестрой сестры сестре
сесть: севшую
сеть: сетью
сжигать: сжигать
сивилла: сивиллы сивиллу сивилла
сивый: сивым сивый
сидеть: сидела сидящего
сила: силу силой сил силы
силок: силки
сильнейший: сильнейший
сильный: сильным сильно сильный
симуса: симуса
симусом: симусом
синий: синие
синяк: синяки
сириус: сириуса сириус сириусу сириусе сириусом
сирота: сироте
система: системе
сказать: сказать сказанных сказав сказал
сказаться: сказались сказалось
сказка: сказки
скальпель: скальпелю
скамья: скамье
скандал: скандала скандал
скандинавский: скандинавской
скарлетт: скарлетт
скачать: скачать
сквиб: сквиб
сквозь: сквозь
скептик: скептиков
скеч: скеч
скитер: скитер
складываться: складывающиеся
склонить: склонен
склонность: склонность
склонный: склонна
скоромагия: скоромагия
скорпиус: скорпиус
скорпиуса: скорпиуса
скорый: скорее скором
скрасить: скрасить
скримджер: скримджер
скримджера: скримджера
скрывать: скрывая скрывали
скрываться: скрывался скрываться скрывается
скрытый: скрыт скрытые
скрыть: скрыть
скрыться: скрылся
скуп: скупа
слабость: слабость
слабый: слабый
слава: славу
сладость: сладости
слегка: слегка
след: следами
следить: следила следит следил следить
следовать: следует следуют
следствие: следствия следствием
следующий: следующему следующим следующих
слежка: слежки
слепить: слепленные
слив: слива сливы
сливочный: сливочного сливочным
слизень: слизней
слизерин: слизерин
слизерина: слизерина
слизерине: слизерине
слизеринцев: слизеринцев
слизеринцы: слизеринцы
слизнорт: слизнорт
слизнорта: слизнорта
слизнортом: слизнортом
слишком: слишком
словно: словно
слово: слов словам слова слово
сложный: сложные сложный
сломать: сломали сломала сломанной
слоноподобный: слоноподобная
слуга: слуги слуг слуга
служащий: служащих
служба: службе службы
служебный: служебные
служить: служили служит служить
случай: случае случаях
случайно: случайно
случайный: случайная случайной
случаться: случались
слушание: слушания слушанье слушании
слушать: слушать
смелый: смелый
смена: смену
сменить: сменил сменив
смертельный: смертельной смертельно смертельного
смертоносный: смертоносным смертоносного
смерть: смертью смерть смерти
сместить: сместить
смещение: смещения
смириться: смирилась
смит: смит
сморщенный: сморщенный
смотреть: смотрел смотреть
смотритель: смотритель
смочь: смогла смог
смуглый: смуглое
смущать: смущает
смятение: смятением
снабжать: снабжая
сначала: сначала
снегг: снегг
снегга: снегга
снеггом: снеггом
снеггу: снеггу
снежок: снежки
снейп: снейп
снейпа: снейпа
сниматься: снимался
снитч: снитч
снова: снова
снять: снять
соавторство: соавторстве
собака: собак собаку собака
собирать: собирает
собираться: собирался собирается
собрание: собрании
собрать: собраны
собраться: собравшейся собравшихся
собственноручный: собственноручно
собственность: собственность
собственный: собственной собственную собственными собственный собственного
событие: событиям события событий событиях событиями
сова: сова сов
совершать: совершает совершал
совершенно: совершенно
совершеннолетие: совершеннолетия
совершенство: совершенстве
совершить: совершили совершить
совет: совета советы
советник: советником
советница: советницей
советовать: советуя
совместительство: совместительству
согласиться: согласился
согласно: согласно
соглашаться: соглашается
содержание: содержание
сожаление: сожалению
создавать: создавая
создание: создании создание
создатель: создателя создатель
создать: создав созданные создали создать
сознание: сознание
солидный: солидный
солома: соломы
сомервилль: сомервилль
сомневаться: сомневаясь
сон: снах
сообщать: сообщает
сообщение: сообщение
сообщество: сообществе сообщество
сообщить: сообщила сообщить сообщил
соответственно: соответственно
соответствие: соответствия
соответствовать: соответствует
соперник: соперником
сопровождать: сопровождала сопровождал сопровождает
сопровождение: сопровождении
сопротивление: сопротивлении
сопротивляться: сопротивляться
соратник: соратник соратников
соревнование: соревнования
сорок: сорока
сосед: сосед
соседка: соседки
соседский: соседскими
состав: состава состав составе
составлять: составлял
состояние: состояние состоянии
состоять: состоящий состоит состоял
состояться: состоялся состоялось
сосуд: сосуд сосуда
сотрудник: сотрудники сотрудников
сотрудничество: сотрудничества
соученик: соученикам
сохатый: сохатый
сохранение: сохранения сохранением
сохранить: сохранить сохранила
сохраниться: сохранившееся
спас: спас
спасать: спасая спасает
спасаться: спасавшихся спасались
спасение: спасении
спасти: спасло спасти
спастись: спастись
сперва: сперва
специалист: специалист специалиста
специальный: специального специальный
спешить: спешит
спина: спину
спиннет: спиннет
списать: списан
список: списки списке список
спокойный: спокойным
сполл: сполл
спора: споры спор
спорт: спорта
спортивный: спортивным спортивный спортивную
способ: способов способами
способность: способностей способности способностями
способный: способна способных способное способен способного
способствовать: способствовал
споткнуться: споткнулась
справедливость: справедливость
справка: справка
справляться: справляться справляется
спрашивать: спрашивает спрашивающий
спрятать: спрятанное
спустя: спустя
спутать: спутанные
сравнивать: сравнивают
сравниваться: сравнивалось
сражаться: сражалась сражается сражаясь сражался сражавшийся сражаться
сражение: сражения сражении
сразиться: сразиться
сразу: сразу
среди: среди
средний: средних среднее
срок: сроку
срочный: срочно
српски: српски
српскохрватски: српскохрватски
ссора: ссоры
ссориться: ссорится
ссылка: ссылка ссылки
ставить: ставить ставил ставит
ставка: ставки ставку
стадо: стадо стада
сталкиваться: сталкивается
стальной: стальной
стан: стане
станислав: станислав
становиться: становятся становится становиться
старательный: старательно
стараться: старается старалась стараются
старик: старика
старинный: старинного
старое: старого старые
староста: староста старостой старостам
старость: старости
старуха: старуха
старушка: старушкой
старший: старшего старших старшую старше старшему старший старшей старшим
старшинство: старшинству
старый: старая старый
статистика: статистика
стать: стал стало стала стать ставший став стали станет
статья: статью статей статья статьях статьи
стащить: стащили
стебль: стебль
стен: стены стен
стенограмма: стенограмма
степень: степени
стервятник: стервятника
стесняться: стесняется
стивен: стивен
стиль: стиле
стирать: стирал
стонтон: стонтон
стопка: стопку
сторожить: сторожит
сторона: стороны стороне сторону
сторониться: сторонятся
сторонник: сторонник сторонников
сторонница: сторонница
страдать: страдающий
страна: страны
страница: страницы страница страницу странице
странность: странности
странный: странный
страстный: страстно
стратег: стратег
страх: страху
страшный: страшного
стрелять: стреляющими
стремиться: стремясь стремится
строгий: строгая
строгость: строгостью
строить: строя
стройный: стройный
строма: строма
студент: студентам студент студенты студентов
студентка: студенток студентка
стыдиться: стыдился
стэн: стэн
стэна: стэна
суд: суд
судить: судя
судно: суда
судьба: судьбы судьба
судья: судей судья
сумасшедший: сумасшедшая
сумасшествие: сумасшествия
суматоха: суматохи суматохе
суметь: сумел
сумма: сумма
сундук: сундука
супруг: супругов супруга супруги
сутулиться: сутулится
сухожилие: сухожилие
сухопарый: сухопарый
существенный: существенный
существо: существо существом существа существу существами
существовать: существует
сфера: сферах
сформулировать: сформулировать
схватить: схватить схваченных
схватка: схватку схватке схваток схватка
сходство: сходство
сцена: сцена сценах
счастливчик: счастливчиками
счесть: сочли
считать: считая считает считали считал считать считают
считаться: считается
съезжаться: съезжаются
съесть: съел
сыворотка: сыворотки сывороткой
сыграть: сыграла сыграл
сын: сына сын сыном сыновей сыну
сынок: сынка
сьюзи: сьюзи
сэр: сэра сэр
сюда: сюда
сюжет: сюжет сюжета сюжету
табор: табор
табун: табун
таинственный: таинственном
тайком: тайком
тайна: тайне тайну тайн
тайный: тайная тайной тайную тайны
также: также
таки: таки
такой: такой такое таким такого такая таком таких
тактика: тактик
талантливый: талантливая
тапочки: тапочках
таранить: таранит
тв: тв
творить: творит
твориться: творится
тед: теда тед
тедди: тедди
текст: текст
текущий: текущие текущая
тело: теле тела тело
телосложение: телосложения
телохранитель: телохранителем телохранителями
тем: тем
тема: тему
тематический: тематический
тен: тена
теннант: теннант
теннисный: теннисный
теоретический: теоретическом
теория: теории
теперешний: теперешних
теплый: тепло
тереть: три
терпеть: терпеть терпит
терри: терри
террор: террором террора террор
терьер: терьер
терять: терял теряет
течение: течение
тиана: тиана
тибет: тибете
тикстон: тикстон
тимоти: тимоти
тип: тип
тис: тис
тиффин: тиффин
тихий: тихий
тоби: тоби
товарищ: товарища
товарный: товарный
толк: толк
толстенький: толстенькая
толстоватый: толстоватого толстоватый
толстый: толстым толстыми толстый толстая
том: томом тома
томас: томасом томасу томас
томпсон: томпсон
тонкий: тонкая
тонкс: тонкс
топор: топора
торн: торном
торчать: торчали
тот: том тех те тот тому той та
точка: точку
точно: точно
тощать: тощая
травма: травмы травм
травологии: травологии
трагедия: трагедии
трагически: трагически
трактир: трактира трактир
транс: транс
трансгрессировть: трансгрессировть
трансгрессирует: трансгрессирует
транспортировка: транспортировки
трансфигурации: трансфигурации
трансфигурировав: трансфигурировав
требовательный: требовательная
требовать: требовал требуют
требоваться: требуется
тревор: тревор
тревора: тревора
трелони: трелони
тренировка: тренировки
третий: третий третьей третья
третье: третьем третье третьего
трещина: трещину
три: тремя
трижды: трижды
тринадцать: тринадцати
трио: трио
трое: троих
тролль: тролль тролля
трудность: трудности
трудный: трудно
труп: труп
трус: трус
трюк: трюк
туалет: туалете
туда: туда
туннель: туннель
тупик: тупика
тупой: тупого
тур: тура туре
турнир: турнир турнира турнире
тщательно: тщательно
тщательный: тщательные
тщеславный: тщеславен
тьюлис: тьюлис
тюрбан: тюрбане тюрбаном
тяжелый: тяжело
убегать: убегает
убедить: убедил убедить
убеждать: убеждает
убежище: убежище
уберечь: уберечь
убивать: убивать убивающего убивает
убийство: убийстве убийства убийство
убить: убил убили убей убить убив убит убила убившим убита
уборка: уборки
убрать: убрать
уважаемый: уважаемыми
уважать: уважал уважают
уважение: уважение уважением
уверенно: уверенно
уверить: уверенный уверена уверен
уверять: уверяя
увидеть: увидев увидеть
увлекаться: увлекается
уводить: уводит
уволить: уволил
увольнение: увольнения
увольнять: увольняет
увы: увы
уговаривать: уговаривает
уговорить: уговорил уговорить
угодно: угодно
угрожать: угрожает
угрюмоватый: угрюмоватый
удаваться: удается удавалось
удар: удар ударов
ударить: ударило
удаться: удалось удался
удача: удачи
удержаться: удержалась
удивляться: удивлялся
удобный: удобном
удовольствие: удовольствие
уезжать: уезжает
ужасно: ужасно
ужасный: ужасное ужасного
уза: узы
узел: узел
узкий: узкие
узнать: узнав узнают узнать узнал узнает узнали
узник: узник узниками узников
узость: узость
уизвитер: уизвитер
уизли: уизли
уилл: уилл
уильямс: уильямс
уимбурнских: уимбурнских
уинтербурне: уинтербурне
уйти: уйти
указ: указом
указание: указания указанием
указательный: указательного
указать: указан
указывать: указывает
украсить: украшенной
украсть: украсть украл
укрыться: укрывшихся
укусить: укусил
улететь: улетевших
улица: улице улицу улицы
улучшить: улучшило улучшить
улыбка: улыбку
ум: умом
умереть: умер умерла
уметь: умеет умел
умирать: умирает умирающую
умный: умное умная умный умнее
умолять: умоляя
умчаться: умчался
умышленный: умышленно
унаследовать: унаследовала
униженный: униженный
уничтожать: уничтожая уничтожает
уничтожаться: уничтожаются
уничтожить: уничтожить уничтожив
унылый: унылая
уолтерс: уолтерс
уонамейкер: уонамейкер
уорбек: уорбек
уорик: уорик
уотсон: уотсон
упасть: упавший
упоминаться: упоминались упоминался упоминается
упомянуть: упомянута упомянут
управление: управление
упражнение: упражнения
упростить: упростившие
упругий: упругая
урвать: урвать
уровень: уровне уровня
урок: уроке уроки уроках урок урока
ус: усы
усиленный: усиленно
условие: условий условии условия
услуга: услуги
услышать: услышать
успевать: успевает
успех: успехи
успешный: успешно
установить: установил
устраивать: устраивает
устраиваться: устраивается
устранить: устранит
устроить: устроив устроили устроил
устроиться: устроилась
уступать: уступает
уступить: уступило
утвердиться: утвердился
утверждать: утверждал
утверждение: утверждениями
утратить: утратив утраченной
ухаживать: ухаживать
ухватиться: ухватившись
ухитриться: ухитрился
ухо: ухе ушами ухо уха
уход: уходу ухода
уцелеть: уцелел
учавствовал: учавствовал
участвовать: участвует участвовали участвовал участвуя участвовала
участие: участие участии участию участия
участник: участниками участником участников
участница: участница
учащийся: учащихся
учебник: учебников
учебный: учебный учебного
ученик: учениках учеников ученики ученик ученикам учеником
ученица: ученице учениц ученицы
учить: учила учит учить
учиться: учиться учились учится учился училась
уэйлетт: уэйлетт
уязвимый: уязвим уязвимы
фабиан: фабиан фабиана
фадж: фадж
фаджа: фаджа
файнс: файнс
факт: факт факты факта
фактически: фактически
факультет: факультетов факультете факультета факультет
фаланга: фаланги
фамилия: фамилии фамилия фамилию
фантастика: фантастики
фантастический: фантастические
февраль: февраля
фейерверк: фейерверки
фелпс: фелпс
фелтон: фелтон
феникс: феникса феникс фениксы
фенрир: фенрир
фенрира: фенрира
фенриром: фенриром
феррис: феррис
фестрала: фестрала
фигг: фигг
фигурировать: фигурирует
физиономия: физиономия
физический: физические
филиус: филиус
филиусом: филиусом
философский: философский философского философскому
филч: филч
филча: филча
филчу: филчу
фильм: фильму фильм фильме фильмов фильмах фильма фильмы
финал: финала финале
финальный: финальной
финч: финч
фиолетовый: фиолетовом
фиона: фиона
фирменный: фирменную
фламелем: фламелем
флегма: флегмой
флетчер: флетчер
флетчера: флетчера
флинт: флинт флинта
флитвик: флитвик
флитвика: флитвика
флитвиком: флитвиком
флоренц: флоренц
флоренца: флоренца
флоренцем: флоренцем
фляжка: фляжки
фонд: фонд
форд: форд
фордик: фордика
форма: формой форме
форсировать: форсировать
форум: форум
фотоальбом: фотоальбомы
фотоаппарат: фотоаппаратом
фотографироваться: фотографироваться
фоукс: фоукс
фоукса: фоукса
фоуксом: фоуксом
фр: фр
фрай: фрай
французский: французской французским
франшиза: франшизы
фред: фредом фред фреда
фредди: фредди
фредерик: фредерик
фрид: фрида
фридвульфы: фридвульфы
фрэнк: фрэнк фрэнка
фрэнсис: фрэнсис
фут: фута
футовый: футов
хагрид: хагрид
хагрида: хагрида
хагридовского: хагридовского
хагридом: хагридом
хагриду: хагриду
хайндс: хайндс
ханна: ханна
ханне: ханне
ханной: ханной
хантер: хантер
хаос: хаосом
характер: характером характер характера
харди: харди
харрис: харрис
харт: харт
хвалить: хвалит
хвастливый: хвастлив
хватать: хватало
хватить: хватит
хвост: хвост хвоста
хелен: хелен
хелена: хелена
хендерсон: хендерсон
хердман: хердман
хижина: хижине хижину
хиро: хиро
хитрость: хитростью
хищный: хищную
хлам: хлама
хлопоты: хлопот
хобби: хобби
ховартсе: ховартсе
хогвартс: хогвартс
хогвартса: хогвартса
хогвартсе: хогвартсе
хогвартсом: хогвартсом
хогсмиде: хогсмиде
ход: ходы ходу ход ходе
ходить: ходила ходил ходит
хозяин: хозяин хозяином хозяину хозяине хозяев хозяина
хозяйка: хозяйки хозяйкой
холихедские: холихедские
холодное: холодные
хорек: хорька
хорнби: хорнби
хороший: лучше лучших хорошим лучший хорошее лучшим хороший получше
хорошо: хорошо
хотеть: хотели хотевшим хотел хотела
хоть: хоть
храбрый: храбрых храбрым
хранитель: хранитель хранителем
хранить: хранил
худой: худое худой хуже худым худая
худощавый: худощавая
хью: хью
хьюго: хьюго
хэллоуина: хэллоуина
хэпзибе: хэпзибе
хэпзибу: хэпзибу
цапня: цапня
царить: царившую
цвет: цвета цвет
целенаправленный: целенаправленно
целитель: целитель
целый: целые целом целый
цель: цель целью
ценить: ценят ценит
ценность: ценности
ценный: ценные ценных
цепочка: цепочке
цитировать: цитировать
чанг: чанг
чар: чары чар
чарли: чарли
чарльз: чарльз
чародей: чародей
чародейство: чародейства
час: час
частенько: частенько
частить: части
частица: частиц
частично: частично
частность: частности
часто: часто
часть: частями частях часть
чаша: чаша чаши
чашка: чашку
чаща: чаще
человек: человек людьми человека людей человеком люди людям
человечек: человечек
человеческий: человеческой человеческом
чемпион: чемпионом чемпионов чемпиона
чемпионат: чемпионат чемпионате
чепчик: чепчиках
чердак: чердаке
через: через
чернила: чернил
чернокожий: чернокожий
черта: чертой
честность: честность
честный: честный
честолюбивый: честолюбива
честь: честь
чет: чета
четвертый: четвертом
четверть: четвертью четверть
четыре: четырьмя четыре
чешуя: чешуя
чжоу: чжоу
чиновник: чиновником
численный: численно
число: число числа числе
чистокровный: чистокровные чистокровных чистокровная чистокровный
чистота: чистота чистоты
читатель: читателей
читать: читать
член: членов членом членам члены член членами
чрезвычайный: чрезвычайно
чрезмерный: чрезмерна
что: чему
чтобы: чтобы
чувство: чувством чувств
чувствовать: чувствует
чуть: чуть
чучело: чучелом
шанпайк: шанпайк
шанпайка: шанпайка
шар: шары шар
шарлатан: шарлатан
шарлотта: шарлотта
шармбатон: шармбатон
шармбатона: шармбатона
шарф: шарф
шафер: шафера
шаффер: шаффер
швыряться: швыряется
шест: шестом
шестая: шестой
шестнадцать: шестнадцать
шесть: шесть
шея: шея шеей шее
шиннер: шиннер
ширли: ширли
ширма: ширм
широкий: широким широкие широкий широк
школа: школа школу школе школы
школьный: школьный школьную школьные школьных
шляпа: шляпу шляпе шляпы шляпа шляпой
шок: шоке
шон: шон
шоу: шоу
шпионить: шпионить
шрам: шрамы шрам шрамами
штаб: штаб
штрафной: штрафных
шум: шуму шумом
шутить: шутил
шутка: шутку шутками
щека: щеке
эвакуация: эвакуации эвакуация
эванна: эванна
эванс: эванс
эдварда: эдвард
эджком: эджком
эдриан: эдриан
экз: экз
экзамен: экзамену экзамен экзамены
экспериментировать: экспериментирует
экспресс: экспресс экспрессе
экстравагантный: экстравагантное
эксцентричный: эксцентричным эксцентричная
элджи: элджи
элегантный: элегантная
элемент: элемент
элитарность: элитарность
элли: элли
элфиасом: элфиасом
эльф: эльф эльфа эльфов эльфу эльфам эльфами эльфом эльфы
эльфийка: эльфийка
эльфийки: эльфийки
эльфийку: эльфийку
эльфихи: эльфихи
эмиль: эмили
эмма: эмма
эмоциональный: эмоциональная
энди: энди
энох: энох
энтони: энтони
энциклопедия: энциклопедии
эпизод: эпизодов эпизоды
эпизодический: эпизодически
эпилог: эпилогу
эрни: эрни
этаж: этаже
этап: этапа
это: этом это этому этим
этот: этой этих эта эту
юмор: юмора
юна: юной
юнайтед: юнайтед
юноша: юноша юношу
юный: юному юная юных
ябеда: ябеда
яблоня: яблоня
явиться: явившихся
являться: являясь являлся является являлись являются
ягода: ягоды
яд: ядом
язык: язык языках языке языку
яйцо: яйца яйцо
якоб: якобы
яксли: яксли
январь: января
янгблад: янгблад
яневский: яневский
ярка: яркой
яркий: яркими
ярко: ярко
яростный: яростных
ярость: ярость
ярый: ярым ярой
ясень: ясень
ястреб: ястреба
