авторство: авторства
азкабана: азкабана
алфавит: алфавиту
альбус: альбус
англ: англ
архивировать: архивировано
барда: барда
бидля: бидля
блэк: блэк
брат: братом братья
бродяга: бродяга
български: български
версия: версия версии
вид: виде
викиданных: викиданных
викимедиа: викимедиа
википедии: википедии
википедия: википедия
вклад: вклад
включать: включая
власть: власти
внутри: внутри
возвращение: возвращение
возможный: возможная
войти: войти
волан: волан
волшебник: волшебников
волшебный: волшебной волшебные волшебный
враг: врагов
время: время
все: всех
вспомогательный: вспомогательных
вымыть: вымыть
выручать: выручай
гарри: гарри
гермиона: гермиона
героизм: героизме
год: годы года
голова: голову
гордость: гордостью
господь: господа
грейнджер: грейнджер
дамблдор: дамблдор
дамблдора: дамблдора
дар: дары
де: де
действовать: действовать действует
декабрь: декабря
день: дней
деть: день дело дела
дж: дж
джеймс: джеймс
джоан: джоан
джордж: джордж
дилогия: дилогия
дитя: дитя
длинный: длинный
добавить: добавить
док: док
дополнительный: дополнительные
доступный: доступен
дотронуться: дотронуться
драко: драко
древность: древности
друг: друзей
другой: других
дурмстранг: дурмстранг
дыра: дыру
единственный: единственное
заглавный: заглавная
заметить: заметили
замок: замка
замышлять: замышляю
занимать: занимает
запись: запись
зарегистрировать: зарегистрированный
затем: затем
заявление: заявление
зверь: звери
знак: знак
знать: знает
значительно: значительно
игра: игра игры
идиот: идиот
избранный: избранные
известно: известно
изобретение: изобретение
изумление: изумлении
инструмент: инструменты
использование: использование использования
использовать: использующие
исследователь: исследователей
история: история
источник: источников источник
каждый: каждого
камень: камень
карта: карты карте карту карта
карточный: карточная
категория: категории категория
квиддич: квиддич
квиддичу: квиддичу
кланяться: кланяется
клясться: клянусь
книга: книг книгах книги
код: код
кодекс: кодекс
коллекционный: коллекционная
комната: комната комнаты
конструктор: конструктор
конфиденциальность: конфиденциальности
короткий: короткие короткий
коснуться: коснуться
который: которая
кретин: кретин
крыса: крысы
кубок: кубок
кук: куки
лезть: лезть
лицензия: лицензии
лишение: лишениях
локация: локации
лунатик: лунатику лунатик
люпин: люпин
м: м
магия: магия магии
маглы: маглы
малфой: малфой
малфоя: малфоя
материал: материал
мая: мая
место: места
местоположение: местоположение местоположения
министерство: министерство
мир: мира мир
миссис: миссис
много: более
мобильный: мобильная
морт: морт
мочь: могут
мы: нами
навигация: навигации навигация
назойливый: назойливых
найти: найти
наконец: наконец
написание: написания
например: например
наш: наших
недостаток: недостаток недостатков
недостоверный: недостоверный
некоммерческий: некоммерческой
ненаносимой: ненаносимой
неполный: неполным неполный
непонятный: непонятно
неряха: неряхе
новый: новые новое
норрис: норрис
нос: нос
нуждаться: нуждается
нужно: нужно
об: об
обитание: обитания
обнаружить: обнаружил
обсуждение: обсуждение
огонь: огня
один: одном
опасный: опасных
описание: описание описанием
опытный: опытными
организация: организации
орден: орден
оскорблять: оскорбляют
особый: особая
ответственность: ответственности
отдельный: отдельных отдельные
отказ: отказ
открыть: открыть
отличаться: отличаться
отображать: отображает
отображаться: отображается
отредактировать: отредактирована
отряд: отряд
очередь: очереди
ошибка: ошибке
палочка: палочкой
парк: парк
пародия: пародии
пергамент: пергамент
передать: передали
перейти: перейти
переработка: переработке
персонаж: персонажи
персональный: персональные
петтигрю: петтигрю
печать: печати
питер: питер
поведение: поведения
подробный: подробнее
пожалуйста: пожалуйста
пожертвовать: пожертвовать
пожиратель: пожиратели
поздний: позже
поиск: поиск поиску
пока: пока
показывать: показывает
политик: политика политике
полтергейст: полтергейстах
полукровка: полукровка
получить: получить
помощь: помощью
портал: портал
посетитель: посетителей
последний: последний
поставщик: поставщики
постепенно: постепенно
постоянно: постоянно
постоянный: постоянная
поттер: поттер поттера поттеру поттере
почему: почему
появляться: появляется
правило: правилами
править: править
правка: правки
превратить: превратить
превращаться: превращаться
предмет: предметы
представиться: представились
представлять: представляют
предыстория: предыстория
приветствовать: приветствует
примечание: примечания
принц: принц
присоединяться: присоединяется
причина: причине причина
про: про
проблема: проблему
проверить: проверенной
проверка: проверки
проверяться: проверялась
проект: проектах
производство: производство
произнести: произнести
проклясть: проклятое
просить: просят просит просить
просмотр: просмотры
пространство: пространства
профессор: профессором профессора профессор профессору
прочий: прочее
путеводитель: путеводитель
р: р
раздел: разделе
раздеть: раздел
разработчик: разработчики
расписываться: расписывается
распределять: распределяющая
рассказ: рассказы
религиозный: религиозные
римус: римус
роман: романов
рон: роном рон
роулинг: роулинг
ру: ру
рубеус: рубеус
русский: русский
ряд: ряд рядом
сам: сама
сантиметр: см
саундтрек: саундтрек
сведение: сведения
свежий: свежие
свободный: свободной
свое: свои
свой: свой
связанный: связанные связанную
связаться: свяжитесь
северус: северус
секрет: секреты
секретный: секретные
сериал: сериал
серия: серии серию серия
сириус: сириус
система: системе
сказка: сказки
скачать: скачать
скрытый: скрытые
служебный: служебные
случай: случаях случаев
случайный: случайная
смерть: смерти
смочь: смог
сначала: сначала
снегг: снегг
снегга: снегга
снеггу: снеггу
событие: события
совать: совать
советовать: советует
содержание: содержание
создать: создали создать
сообщество: сообщество
сообщить: сообщить
соответствие: соответствии
сохатый: сохатый
сохранение: сохранением
список: список
спора: споры
справка: справка
средство: средств
ссылка: ссылка ссылки
статистика: статистика
стать: стал
статья: статью статей статья статьи
страница: страницы страница страницу странице
существо: существа
существование: существовании
сюда: сюда
сюжетный: сюжетную
тайный: тайная
также: также
такой: такой
текст: текст
текущий: текущие текущая
тематический: тематический
территория: территории
тип: типам
товарный: товарный
торжественный: торжественно
требовать: требуют
увидеть: увидеть
угодно: угодно
удаться: удалась
узкий: узкого
узник: узник
уизли: уизли
указание: указанием
указать: указан
указывать: указывают
украсть: украли
улучшить: улучшите
урод: урод
урок: уроки
условие: условий условия
утверждение: утверждениями
уточнить: уточните
участие: участие
участник: участниками
фантастический: фантастические
февраль: февраля
феникс: феникса
философский: философский
филча: филча
фильм: фильм фильмов
фонд: фонд
форум: форум
фред: фред
функционал: функционала
хагрид: хагрид
хвост: хвост
хобби: хобби
хогвартс: хогвартс
хогвартса: хогвартса
хогвартсе: хогвартсе
ход: ходы
хотеть: хотел
цитировать: цитировать
человек: человека
чемпионат: чемпионат
читать: читать
чтобы: чтобы
чужая: чужие
шаблон: шаблонами шаблона
шалость: шалость
шалун: шалунов
шармбатон: шармбатон
шляпа: шляпа
элемент: элемент
энциклопедия: энциклопедии
это: это
этот: эта эту
язык: языках
