абсолютно: абсолютно
авторство: авторства
азкабана: азкабана
аластора: аластора
алфавит: алфавиту
альбус: альбус
альбуса: альбуса
англ: англ
астрономический: астрономической
барда: барда
бартемий: бартемий
башня: башне
бидля: бидля
благодаря: благодаря
блэка: блэка
ванна: ванну
версия: версия
весь: вся
видеть: видеть
викиданных: викиданных
викимедиа: викимедиа
википедии: википедии
википедия: википедия
вклад: вклад
владелец: владельца
власть: власти
внести: внести
возвращение: возвращение
войти: войти
волан: волан
волшебный: волшебные волшебная волшебный
воспользоваться: воспользовался
время: время
вселенная: вселенная
вылазка: вылазок вылазках
вырасти: выросли
высовываться: высовывается
выяснить: выяснить
гарри: гарри
гермиона: гермиона гермионе
героизм: героизме
глаз: глаз
год: годами годы года
грейнджер: грейнджер
грозный: грозный
грюма: грюма
дабы: дабы
дамблдор: дамблдор
дамблдора: дамблдора
дар: дар даров дары
де: де
дежурство: дежурств
дезиллюминационными: дезиллюминационными
действовать: действовать
делать: делающая делает
день: дней
дж: дж
джеймс: джеймс
дилогия: дилогия
дискуссия: дискуссию
дитя: дитя
добавить: добавив
док: док
доказательство: доказательства
дополнительный: дополнительные
дорогостоящий: дорогостоящее
дорожный: дорожная
доступный: доступен
драко: драко
древность: древности
друг: друзья друзьями друзей
другой: других
дурмстранг: дурмстранг
ехать: едет
желательно: желательно
заглавный: заглавная
заговорить: заговоренная
задумать: задумал
заклинание: заклинанию
заклятие: заклятиями
замечать: замечает
запись: запись
зарегистрировать: зарегистрированный
затем: затем
заявление: заявление
зверь: звери
знак: знак
значимость: значимостью значимость значимости
игра: игра игры
идеальность: идеальность
идти: идет
избранный: избранные
инструмент: инструменты
исключить: исключите
искусственный: искусственный
искусство: искусстве
использование: использования
использовать: использовать использовали
использоваться: использовалась
исправление: исправления
истинный: истинном
история: история
источник: источники источник
истощаться: истощаются
й: й
камень: камень
карточный: карточная
категория: категории
квиддич: квиддич
квиддичу: квиддичу
книга: книгах книги книге
код: код
кодекс: кодекс
коллекционный: коллекционная
комната: комната
конец: конце
конструктор: конструктор
конфиденциальность: конфиденциальности
короткий: короткие короткий
который: которая
крауч: крауч
критерий: критерии критериям критерию
кубок: кубок
кук: куки
купе: купе
курс: курса
лицензия: лицензии
лишение: лишениях
локация: локации
магия: магия магии
маглы: маглы
малфой: малфой
малфоя: малфоя
мантия: мантией мантия мантию мантии
материал: материал
менее: менее
место: места
министерство: министерства министерство
мир: мира мир
миссис: миссис
младший: младший
много: более
мобильный: мобильная
можно: можно
морт: морт
мочь: мог могут
мутнеть: мутнеет
мы: нами
навигация: навигации навигация
надевать: надевает
наедине: наедине
назойливый: назойливых
найти: найти
например: например
насытить: насыщенная
начало: начал
наш: наших
невидимка: невидимки невидимка невидимкой невидимку невидимке
невидимый: невидимым
невозможно: невозможно
невредимый: невредим
недолгий: недолго
недостаток: недостатков недостатки
недостоверный: недостоверный
некоммерческий: некоммерческой
некоторые: некоторые
неограниченный: неограниченное
неполный: неполный
нередко: нередко
несмотря: несмотря
никакой: никакими
новый: новые
норрис: норрис
ночь: ночью
об: об
обездвижить: обездвижил
обитание: обитания
обладать: обладает
обнаружить: обнаружить
обсуждение: обсуждение обсуждения
обучение: обучения
общий: общему
обычный: обычные обычная
огонь: огня
одежда: одежда
один: одним
оказываться: оказывается
она: нее
опасный: опасных
описание: описание
организация: организации
орден: ордена орден
особенность: особенности
особый: особая
остаться: остался оставшись
ответственность: ответственности
отвод: отвода
отдел: отделе
отдельный: отдельных отдельные
отказ: отказ
отправиться: отправившись
отредактировать: отредактирована
отряд: отряд
отсутствовать: отсутствуют
очень: очень
ошибка: ошибке
парализовать: парализующему
парк: парк
пародия: пародии
первое: первого
перед: перед
перейти: перейти
перенаправить: перенаправлено
персонаж: персонажи
персональный: персональные
печать: печати
поведение: поведения
подарок: подарок
подробный: подробнее
пожалуйста: пожалуйста
пожертвовать: пожертвовать
пожиратель: пожирателей пожиратели
позволять: позволяют
поиск: поиск поиску
показать: покажите
политик: политика политике
полный: полную
полтергейст: полтергейстах
полукровка: полукровка
получить: получил получить
пользоваться: пользовался
помогать: помогала
поначалу: поначалу
портал: портал
последний: последний
посол: после
поставить: поставлена
постоянный: постоянная
поттер: поттер поттера поттере
поход: походов
править: править
правка: правки
предмет: предмета предметы
представиться: представились
предыстория: предыстория
прикрыть: прикрыл
прикрыться: прикрывшись
принц: принц
принять: принять
причем: причем
проблема: проблемы
проект: проектах
производство: производство
проклясть: проклятое
проскальзывать: проскальзывает
просмотр: просмотры
проставить: проставить
простой: простая
пространство: пространства
прочий: прочее
путеводитель: путеводитель
путешествие: путешествия
пытаться: пытается
разработчик: разработчики
ранний: раньше
расправляться: расправляется
распределять: распределяющая
рассказ: рассказы
ребята: ребята
религиозный: религиозные
речь: речь
рождество: рождество
роль: роль
роман: романов
рон: рону рон
роулинг: роулинг
рубеус: рубеус
русский: русский
сантиметр: см
саундтрек: саундтрек
сведение: сведения
свежий: свежие
свободный: свободной
свое: своего своими
свой: своей
свойство: свойством
связанный: связанные
связаться: свяжитесь
северус: северус
секретный: секретных
серебристый: серебристой
сериал: сериал
серия: серии серию серия
сильный: сильно
сириус: сириуса
система: системе
сказка: сказки
скачать: скачать
сквозь: сквозь
скрывать: скрывает
скрытый: скрытые
служебный: служебные
служить: служат
случай: случае случаях
случайный: случайная
смерть: смерти
смотреть: смотреть
снегг: снегг
снейп: снейп
сноска: сноски сносок
событие: события
содержание: содержание
сожаление: сожалению
создать: создать
сомнение: сомнение
сомнительный: сомнительной
сообщество: сообщество
сообщить: сообщить
соответствующий: соответствующую
сохранение: сохранением
спасти: спасти
список: списка список
спора: споры
справка: справка
ссылка: ссылка ссылки
староста: старост
статистика: статистика
статья: статья статье статьи
страница: страницы страница страницу странице
ступня: ступня
существо: существа
сюда: сюда
тайна: тайн
тайный: тайная
также: также
такой: такого
текст: текст
текущий: текущие
тем: тем
тематический: тематический
ткань: ткани
товарный: товарный
точный: точные
третий: третий
три: трех
тройка: тройка
удалить: удалите
удар: удар
узнать: узнает
узник: узник
уизли: уизли
указание: указания указанием
укрываться: укрывался
улучшение: улучшения
умещаться: умещалась
урок: уроки
условие: условий условия
успешный: успешно
устранить: устранены
участие: участие
фантастический: фантастические
феникс: феникса
философский: философский
фильм: фильм фильмов
фонд: фонд
форум: форум
хагрид: хагрид
хагриду: хагриду
хобби: хобби
хогвартс: хогвартс
хогвартса: хогвартса
хогвартсе: хогвартсе
хогсмид: хогсмид
хозяин: хозяина
цитировать: цитировать
чар: чары чарами
частное: частным частные
чемпионат: чемпионат чемпионате
читать: читать
член: члены
чудо: чуде
шаблон: шаблонами шаблон
шармбатон: шармбатон
шляпа: шляпа
экспресс: экспрессе
элемент: элемент
энциклопедия: энциклопедии
это: это этим
этот: этой эта
являться: являлась
язык: языках
январь: января
