автомобиль: автомобиль
авторство: авторства
азкабана: азкабана
акромантул: акромантул
алфавит: алфавиту
альбус: альбус
англ: англ
англия: англия
арагог: арагог
арагога: арагога
арахнофобией: арахнофобией
артур: артур артура
архивировать: архивировано
бал: бал балу
банк: банке
барда: барда
барьер: барьер барьеру
беглый: беглый
безобидный: безобидных
безуспешно: безуспешно
беларуская: беларуская
бидля: бидля
билиус: билиус
билл: билла
биография: биография
битва: битве
благодаря: благодаря
благополучно: благополучно
близнец: близнецов близнецами
блумсбери: блумсбери
блэк: блэк
боггарт: боггарт
боггартов: боггартов
больничный: больничное
больной: болен
больший: большими больше
бояться: боится
брат: братьев
браун: браун
български: български
быстро: быстро
быть: будучи были
важный: важную
василиск: василиском василиска
вд: вд
великобритания: великобритания
верить: верит
вернуться: вернуться вернувшись
верный: верный
версия: версия
весить: весь
веснушка: веснушками
весь: вся
взять: взял взять
видеть: видит
викиданных: викиданных
викимедиа: викимедиа
википедии: википедии
википедия: википедия
викисклад: викисклад
викискладе: викискладе
викия: викия
виктор: виктором
вклад: вклад
власть: власти
влиять: влияет
вместе: вместе
внимание: внимание
возвращение: возвращение возвращении
возраст: возраст
войти: войти
вокзал: вокзала
волан: волан
волос: волосы
волшебник: волшебников волшебник волшебникам
волшебный: волшебные волшебного волшебный
воплощение: воплощение
воспользоваться: воспользовавшись
впервые: впервые
вплоть: вплоть
впоследствии: впоследствии
враг: врагом
вратарь: вратаря
вредилки: вредилки
время: время
все: всех всего
всевозможный: всевозможные
всезнайка: всезнайка
всезнайство: всезнайством
вселенная: вселенная
вскоре: вскоре
встречать: встречает
встречаться: встречаться
всяческий: всяческие
второе: второго
второй: второй
второсортности: второсортности
входить: входит
выбираться: выбираются
выбрать: выбрал
выговаривать: выговаривает
вызов: вызова
выигрывать: выигрывает
вымыслить: вымышленные
выпивать: выпивает выпивают
выпить: выпив
выработаться: выработался
вырасти: выросшего
выходить: выходят
выяснить: выяснить
вэйн: вэйн
галлеонов: галлеонов
гарри: гарри
гермиона: гермиона гермионы гермионой гермионе гермиону
героизм: героизме
герой: героев
гигантский: гигантского гигантский
главное: главным главных
глаз: глаза
гоблин: гоблином
год: году год годы года
гойла: гойла
гойлом: гойлом
голубой: голубые
гордиться: гордится
грейнджер: грейнджер
гремучий: гремучей гремучую
гринготтс: гринготтс
гринт: гринт
гриффиндор: гриффиндор
гриффиндора: гриффиндора
гриффиндору: гриффиндору
громовещатель: громовещатель
грызун: грызуна
грязнокровка: грязнокровка
грязнокровкой: грязнокровкой
дальнейший: дальнейшем дальнейшая
дамблдор: дамблдор
дамблдора: дамблдора
дар: дары
дата: дата
два: две
двое: двое
двухлетней: двухлетней
де: де
девон: девон
девушка: девушкой
действовать: действовать действует
делать: делает
дело: делом
делюминатор: делюминатор
день: дней
деньга: деньги
деталь: детали
детство: детстве
дж: дж
джинни: джинни
джоан: джоан
джордж: джорджем
дилогия: дилогия
дитя: дитя
длинный: длинный
добрый: доброму
док: док
долгий: долгое
долетать: долетают
должность: должность
долохов: долохов
дома: дома
домашние: домашних
домашний: домашнее
дополнительный: дополнительные
доставаться: достаются
достать: достать
доступный: доступен
драко: драко
дракон: драконы
древность: древности
друг: друзья друзьями друг друзей другом друзьям друга
другой: другими других
дурмстранг: дурмстранг
дурслей: дурслей
дырявый: дырявом
египет: египет
железнодорожный: железнодорожной
жена: жена
жениться: женился
живоглот: живоглот
жизнь: жизни
жительство: жительства
забирать: забирает
забредать: забредают
завал: завал
завещать: завещает
завидовать: завидует
заглавный: заглавная
задание: задание
заклинание: заклинанием заклинание
заколдованный: заколдованными
заколдовать: заколдовать
замечать: замечает
замок: замок замка
занятие: занятий
запись: запись
запретный: запретного запретный
зарегистрировать: зарегистрированный
заступаться: заступается
затем: затем
зато: зато
заходить: заходит
зацепиться: зацепившись
защита: защиту
заявление: заявление
зверь: звери
здоровье: здоровье
зелье: зельем зелье
златопуст: златопуст
змея: змей
знак: знак
знакомый: знакомыми
знаменитый: знаменитый
значит: значит
ив: ивы иву
игра: игра игры
играть: играет
игрок: игрок
игрушечный: игрушечную
идти: идти
избранный: избранные
издеваться: издеваться
излишний: излишнюю
имя: имя
инструмент: инструменты
ирония: иронии
искать: искать
исключение: исключение
искусство: искусств
исполнение: исполнение
использование: использования
использовать: использующие
испытание: испытания
истерик: истерика
история: история историй истории
источник: источник
июль: июля
какой: какие
камень: камень камня
капитан: капитаном
карточный: карточная
касаться: касающиеся
категория: категории категория
каф: кафе
квиддич: квиддич
квиддичу: квиддичу
кингс: кингс
клык: клыком
книга: книгах книги книге
код: код
кодекс: кодекс
коллекционный: коллекционная
команда: команды команда
комната: комнате комнату комната комнаты
комплекс: комплекс
конец: конце
конкурент: конкурентом
конструктор: конструктор
конфета: конфеты
конфиденциальность: конфиденциальности
корень: корень
кормак: кормак
короста: коросты
короткий: короткие короткий
кот: кот кота
котел: котле
который: которой которого которая котором который
кошмар: кошмар
крамом: крамом
красть: крадут
крестраж: крестраж
крестражей: крестражей
крестражем: крестражем
крестражи: крестражи
кровать: кровати
кровь: крови
кросс: кросс
кругленький: кругленькой
крыса: крысы крыса
крыть: крыло
крэбба: крэбба
крэббом: крэббом
крюкохватом: крюкохватом
кубок: кубок
кувшин: кувшине
кук: куки
купе: купе
купить: купишь
курс: курсе
лаванда: лавандой лаванда
лапа: лап
лежать: лежит
лес: леса лес
летать: летающий
лето: летом
лицензия: лицензии
лицо: лицо
лишение: лишениях
лодыжка: лодыжку
локация: локации
локонс: локонс
локонса: локонса
ломаться: ломается
лондон: лондон
лопнуть: лопнула
лорд: лорда
лотерея: лотерею
лояльно: лояльно
любимец: любимец
любить: любящая любит
люпин: люпин
маг: магов маги
магазин: магазине
магия: магия магии
маглам: маглам
маглов: маглов
маглы: маглы
македонский: македонски
маклагген: маклагген
малфоем: малфоем
малфой: малфой
мальчик: мальчикам мальчик мальчики мальчиков мальчика
мантия: мантия мантии
марта: марта
материал: материал
мать: мать матери
машина: машину машина
медальон: медальон
медиафайлы: медиафайлы
медовуха: медовуху
менять: меняет
место: место места
меткий: метки
метла: метлу
меч: мечом
министерство: министерство министерстве
мир: мира мир мире
миссис: миссис
мишка: мишку
младший: младшим
многодетный: многодетные
мобильный: мобильная
можно: можно
молли: молли
монгол: монгол
морт: морт
морта: морта
мочь: могут
мракоборец: мракоборец
мракоборца: мракоборца
мракоборцев: мракоборцев
мужской: мужской
мы: нами
навигация: навигации навигация
навсегда: навсегда
над: над
надеяться: надеется
назойливый: назойливых
найти: нашли
наконец: наконец
наложить: наложенном
нападать: нападают нападает
направление: направление
направляться: направляющуюся
наследник: наследником наследнике
настоящее: настоящим
настоящий: настоящий
находить: находят
начинать: начинает
начинаться: начинается
наш: наших
небогатый: небогаты
невидимка: невидимке
невиллом: невиллом
невредимый: невредимым
недостаток: недостатков
недостоверный: недостоверный
некоммерческий: некоммерческой
некоторый: некоторое
немногие: немногих
неоправданный: неоправданны
неполный: неполный
нескладный: нескладный
несмотря: несмотря
неуверенность: неуверенность
новость: новость
новый: нового новым новый новые
нора: нору нора
норрис: норрис
нос: нос
носить: носит
ночь: ночью
нюанс: нюансы
об: об
обвинение: обвинения
обвинять: обвиняет
обзывать: обзывает
обида: обиду
обижаться: обижается
обитание: обитания
обладать: обладает
область: области
обличие: обличье
обморок: обмороке
обнаруживаться: обнаруживается
обозлиться: обозлился
оборотный: оборотное
образоваться: образуется
обратный: обратную
обращение: обращения
обсуждение: обсуждение
обсыпной: обсыпным
обучиться: обучился
общий: общий
объяснять: объясняет
огонь: огня
один: одном один
однажды: однажды
однако: однако
одновременно: одновременно
озеро: озера
оказываться: оказываются
окончание: окончании окончания
он: нему
она: ею
они: них
опасаться: опасаясь
опасный: опасных опасен
операция: операции
описание: описание
организация: организации
орден: орден
основатель: основателя
отборочный: отборочные
ответственность: ответственности
отдел: отделе
отделить: отделивший
отдельный: отдельных отдельные
отец: отец
отказ: отказ
отказаться: отказалась
открывать: открывает
отместка: отместку
отметить: отметить
относиться: относится
отношение: отношения
отправиться: отправившись отправился отправиться
отправляться: отправляются отправляется отправляясь
отравить: отравленную
отредактировать: отредактирована
отряд: отряда отряд
отчитывать: отчитывает
охрана: охраны
очень: очень
очки: очков
ошибка: ошибке
падмой: падмой
палочка: палочку палочка палочки палочкой
память: память
парень: парень
парк: парк
пародия: пародии
партия: партию
паря: паре
пассажир: пассажиров
патил: патил
патронус: патронус
паук: паука паук пауков пауками
паучок: паучков
первое: первым первого первом
первый: первый
перед: перед
перейти: перейти
переть: при
персонаж: персонаж персонажами персонажи
персональный: персональные
пес: пса
печать: печати
питомец: питомцы
платформа: платформы
плечо: плеча
плохо: плохо
плюшевый: плюшевого
победа: победы
побеждать: побеждает
поведение: поведения
подземелье: подземелье
подражать: подражая
подробный: подробнее
подружиться: подружиться
подумать: подумала
поединок: поединке
поесть: поесть
пожертвовать: пожертвовать
пожиратель: пожиратели
поздний: позже
поиск: поиски поисках поиск поиску
пойти: пойти пошла
показать: показала
пол: пол
политик: политика политике
пологий: полог
полтергейст: полтергейстах
полукровка: полукровка
получать: получает
получить: получить
помощь: помощью
поневоле: поневоле
понимать: понимает
попадать: попадая попадает попадают
попытка: попытку
пора: пор
портал: портал
последний: последнее последний последнего последней
посол: после
постоянно: постоянно
постоянный: постоянная
поступить: поступив
потащить: потащил
потеряться: потерялся
поттер: поттер поттера поттеров поттере
поттеромания: поттеромания
починить: починить
почтить: почти
поэтому: поэтому
появление: появление
появляться: появляется
правда: правда правду
править: править
правка: правки
превзойти: превзойти
превратить: превратил
превращать: превращает
превращаться: превращаясь
предмет: предметы
предприниматель: предприниматель
предпринимать: предпринимает
представиться: представились
предстоять: предстояло
предыстория: предыстория
преподаватель: преподаватель
преступник: преступнике преступник
префект: префект
прибыльный: прибыльным
приворотный: приворотным
привязать: привязан
приглашать: приглашает приглашал
приключение: приключений
приковать: приковано
примереть: пример
примечание: примечания
принадлежность: принадлежность
принимать: принимает
принц: принц
присвоить: присвоил
приходиться: приходится
проводиться: проводиться
проводник: проводником
продвижение: продвижение
продолжать: продолжать
проект: проектах
прозвище: прозвище
произведенье: произведений
производство: производство
происхождение: происхождение
пройти: пройти
проклясть: проклятое
пропадать: пропадает
пропитать: пропитанные
просвещать: просвещает
просить: просит
просмотр: просмотры
пространство: пространства
противник: противники
протяжение: протяжении
проходить: проходят проходит
прохождение: прохождения
прочий: прочее
прощение: прощения
путеводитель: путеводитель
пуффендуй: пуффендуй
пытаться: пытается пытаясь
пятый: пятый
пять: пятью
работать: работал работать
разбиваться: разбивается
разгневать: разгневанный
разговор: разговоре
раздражать: раздражает
разработчик: разработчики
ранение: ранение
раскрывать: раскрывая
распороть: распорол
распределять: распределяющая
распространять: распространяет
рассказ: рассказы
рассказать: рассказать
расставаться: расстаются
расширение: расширение
расщеплять: расщепляет
ребенок: детей дети
ребята: ребят
реддлом: реддлом
религиозный: религиозные
решать: решают решает
решаться: решается
ридикулус: ридикулус
римус: римус
род: род
родитель: родители
родиться: родилось
родные: родных
рождение: рождения
роза: роза
ролик: роликах
ролинг: ролинг
роль: роль роли
роман: романов романе романа
ромильды: ромильды
рон: рону роном рона рон
рональд: рональд
роули: роули
роулинг: роулинг
рубеус: рубеус
ругаться: ругается
рука: руками
руперт: руперт
русский: русский
рыжий: рыжие
сайт: сайте
самый: самую самая самых
сантиметр: см
саундтрек: саундтрек
свадьба: свадьбы свадьбу
сведение: сведения
свежий: свежие
сверстник: сверстником
свидетель: свидетелями
свободный: свободной
свое: своих своим своими
свой: свой своей свою
связанный: связанные
связаться: свяжитесь
святочный: святочный
священный: священные
северус: северус
седьмой: седьмой
семейство: семейства
семь: семь
семью: семью
семья: семья семье
сентябрь: сентября
сериал: сериал
серия: серии серию серия
сивый: сивого
сильный: сильно
сириус: сириус
система: системе
сказка: сказки
скачать: скачать
сквозь: сквозь
скотч: скотча
скрытый: скрытая
слава: славы
следующий: следующим
слизерина: слизерина
слизеринская: слизеринская
слизнорту: слизнорту
слизняк: слизняками
слово: слово
сломать: сломанной сломанную сломал
служба: службы
служебный: служебные
случай: случаях
случайно: случайно
случайный: случайная
смерть: смерть смерти
смех: смеху
смочь: смогли
снегг: снегг
событие: события
совершеннолетний: совершеннолетним
совет: совету
соглашаться: соглашается
содержание: содержание
создание: создание
создатель: создатель
создать: создать
сокурсница: сокурсницей
сообщать: сообщает
сообщество: сообщество
сообщить: сообщить
соответственно: соответственно
соревнование: соревновании
состязание: состязании
сохранение: сохранением
социальный: социальный
спальня: спальни
спасать: спасает спасать
специфический: специфические
списать: списать
список: список
спора: споры
спортсмен: спортсмены
способный: способная
справка: справка
справляться: справляются
спуск: спуска
срабатывать: срабатывает
среди: среди
српски: српски
српскохрватски: српскохрватски
ссориться: ссорится
ссылка: ссылка ссылки
ставить: ставит
становиться: становятся становится
станция: станции
староста: старостой
старший: старших
статистика: статистика
статус: статус
стать: стал стали
статья: статья статьи
стая: стаи
стереть: стереть
стесняться: стесняется
сторона: сторону
страдать: страдает
страница: страницы страница страницах страницу странице
стратег: стратегом
студент: студенты
студентка: студентка
ступня: ступнями
судьба: судьбы судьба
сумма: суммы
существо: существа
считать: считает
съедать: съедает
съесть: съесть
сыграть: сыграл
сюда: сюда
табу: табу
тайна: тайнах тайн
тайный: тайная тайной тайную
также: также
таки: таки
татарча: татарча
текст: текст
текущий: текущие
телохранитель: телохранителями
тем: тем
тематический: тематический
территория: территории
терьер: терьер
терять: теряет
товарищ: товарищ
товарный: товарный
том: томом
тот: том тех тому
тошнить: тошнить
тощий: тощий
трансгрессируют: трансгрессируют
трансгрессия: трансгрессии
третий: третий
три: трех
трое: трое
троица: троицы
тролль: тролля
турнир: турнир турнира турнире
убежать: убежать
убийство: убийстве
увидеть: увидев
уезжать: уезжает
узнать: узнают узнает
узник: узник
уизли: уизли
указание: указанием
уничтожать: уничтожает
упоминаться: упоминается
управление: управление
урок: уроки уроков
условие: условий условия
услышать: услышавшей
успешный: успешно
усыпать: усыпано
уходить: уходит
участвовать: участвовал участвовать
участие: участие участия
участник: участником
учащийся: учащийся
учебник: учебники
учебный: учебного
ученик: ученики ученикам
учиться: учился
факультет: факультете факультета факультет
фантастический: фантастические
февраль: февраля
феникс: феникса
фигура: фигурами
философский: философский философского
фильм: фильму фильм фильме фильмов
фонд: фонд
форма: форму
форум: форум
фред: фреда
хагрид: хагрид
хагрида: хагрида
характеристика: характеристики
хижина: хижине
хобби: хобби
хогвартс: хогвартс
хогвартса: хогвартса
хогвартсе: хогвартсе
хороший: лучшую лучшими хорошим лучший
хотеть: хочет хотел
хоть: хоть
храниться: хранился
хьюго: хьюго
целоваться: целуется
цитировать: цитировать
частить: части чащу
часто: часто
часть: частью
чат: чат
чаша: чашу чашей
чемпион: чемпионам
чемпионат: чемпионат
через: через
черный: черной
честно: честно
четверо: четверо
число: число
чистокровный: чистокровных чистокровный
чистота: чистота
читать: читать
член: членом член членами
чтобы: чтобы
чувство: чувством
чуть: чуть
шармбатон: шармбатон
шахматный: шахматном шахматную
шестая: шестой
школа: школе школы
шляпа: шляпа
экспресс: экспресса
элемент: элемент
эмоциональность: эмоциональность
энциклопедия: энциклопедии
это: этом это этим
этот: эта
юмор: юмора
являться: являющимися является являющийся
язык: язык языках языку
яксли: яксли
январь: января
