август: августа
автобус: автобусе автобус автобуса
автор: автор
авторство: авторства
адаптация: адаптацию
азад: азад
азкабан: азкабан
азкабана: азкабана
академия: академии
актриса: актриса
алан: алан
алфавит: алфавиту
альбус: альбус
альбуса: альбуса
альфонсо: альфонсо
альфред: альфред
аналогичный: аналогичной
англ: англ
английский: английский английском
анимаг: анимаг
анимагической: анимагической
анимагов: анимагов
анонимно: анонимно
аргус: аргус
артист: артиста
артур: артур
архив: архив
архивировать: архивировано
афшан: афшан
балл: баллом
барда: барда
барнатан: барнатан
башня: башню
беда: беду
безопасный: безопасным
беларуская: беларуская
бесконечность: бесконечности
библиографический: библиографических
бидля: бидля
блэк: блэк
блэка: блэка
блэке: блэке
блэку: блэку
больничный: больничное больничном
больший: большие
большой: большой
бонни: бонни
британский: британской
бродяга: бродяга
бронсон: бронсон
брэдли: брэдли
бумага: бумагу
буря: бурей
български: български
быть: будут буду были
бюджет: бюджет
ведьма: ведьма ведьм
великобритания: великобритания великобритании
вернон: вернон
вернона: вернона
вернуть: вернув
вернуться: вернуться вернувшись вернется
версия: версия версии
вещь: вещами
взять: взять
вид: виде
видеть: видят
визжать: визжащую
визуальный: визуальные
викиданных: викиданных
викимедиа: викимедиа
викиновости: викиновости
википедии: википедии
википедия: википедия
викисклад: викисклад
викискладе: викискладе
викицитатник: викицитатник
викицитатнике: викицитатнике
винсент: винсент
вклад: вклад
власть: власти
вместе: вместе
вместо: вместо
вне: вне
внешний: внешние
водитель: водитель
возвращать: возвращает
возвращаться: возвращаются возвращаясь
возвращение: возвращение
возглавить: возглавить
возможный: возможные
возрасти: возросшая
вой: вой
война: войны война
войти: войти
волан: волан
волчий: волчий
волшебник: волшебников волшебник
волшебный: волшебную волшебные волшебный
восприятие: восприятие
воссоединиться: воссоединившись
впервые: впервые
временить: времени
временной: временную
время: время
все: всех
вскоре: вскоре
второй: второй
входить: входит
выбор: выбор
выдать: выдал
выйти: выйти вышла вышел
выпить: выпить
вырубать: вырубает
высосать: высосать
выясняться: выясняется
гайетт: гайетт
гарднер: гарднер
гарри: гарри
генри: генри
гермиона: гермиона гермионой гермионе
героизм: героизме
герой: героев
гильермо: гильермо
гиппогриф: гиппогрифа
главное: главных
говорить: говорит
год: год годы года
гойл: гойл
голос: голос
гонт: гонт
горничная: горничная
гость: гости
гот: готов
гравитация: гравитация
грег: грег
грегори: грегори
грейнджер: грейнджер
гремучий: гремучей гремучая
гринт: гринт
гриффиндора: гриффиндора
гриффитс: гриффитс
группа: группе группа
гэмбон: гэмбон
гэмбону: гэмбону
гэри: гэри
дадли: дадли
дама: дамы дама
дамблдор: дамблдор
дамблдора: дамблдора
дамблдором: дамблдором
дар: дары
дата: дата
дать: дали дала
два: два двух
де: де
девон: девон
действовать: действовать
декабрь: декабря
дело: деле
дель: дель
дементора: дементора
дементоров: дементоров
дементоры: дементоры
день: дней дня
детективный: детективный
деть: день
дж: дж
джейми: джейми
джеймс: джеймс джеймсом джеймса
джени: джени
джим: джим
джимми: джимми
джинни: джинни
джоан: джоан
джон: джон джона
джордж: джордж джорджем
джошуа: джошуа
джули: джули
дивергент: дивергент
дилогия: дилогия
дина: дин
директор: директор
дистрибьютор: дистрибьютор
дитя: дитя
длинный: длинное длинной
длительность: длительность
доверие: доверия
довольный: довольно
док: док
доказательство: доказательств
долгопупс: долгопупс
должен: должен
должность: должностях
дон: дон
дополнительный: дополнительные
доставлять: доставляет
достаточно: достаточно
достаться: досталась
достижение: достижения
доступный: доступен
драко: драко
драматический: драматического
древность: древности
друг: друзьями друга
другой: другие других
дурмстранг: дурмстранг
дурслей: дурслей
дурсль: дурсль
душ: душу
дырявый: дырявый
дэвид: дэвид
дэвис: дэвис
дэдпул: дэдпул
дэниел: дэниел
дядя: дяди
европа: европы
жанр: жанры
желать: желали
железный: железный
женевьев: женевьев
женщина: женщина
заверять: заверяет
заглавный: заглавная
задержать: задержать
заклинание: заклинанию заклинания заклинание
заклятие: заклятием заклятия
закончиться: закончились
закрытый: закрыт
замедлять: замедляющие
заменить: заменить
заметить: заметив
замечать: замечает
замок: замок
занятие: занятий
запись: запись
запретить: запрещено
зарегистрировать: зарегистрированный
зарождаться: зарождающиеся
заставлять: заставляя заставляет заставляют
затем: затем
защита: защиты
заявить: заявил
заявление: заявление
зверь: звери
злобно: злобно
знак: знак
знать: знает
значение: значения
значимость: значимости
значительно: значительно
зрительский: зрительских
ив: ивы ива
игра: игра игрой игры
играть: играл
идти: идет
избранный: избранные
известный: известных
измениться: изменился
изобретение: изобретением
икс: икс
именно: именно
иметь: имеют имеет
имя: имя имени
инглби: инглби
инструмент: инструменты
инсценировать: инсценировал
исключение: исключением
исключить: исключат
искусство: искусстве искусств
исполнитель: исполнителя
исполнительный: исполнительные
использование: использование использования
использовать: используя использован использует использующие используют
истерия: истерии
истинный: истинного
история: история истории
источник: источники источника источник
иэну: иэну
июль: июля
июнь: июня
каждый: каждого
казнить: казни
казнь: казнью казнь
какой: каким
каллум: каллум
камень: камень
кандидат: кандидатов
карибский: карибского
карта: карте карту картой карта
карточный: карточная
каспиан: каспиан
каталог: каталог каталогах
категория: категории
качество: качестве
квиддич: квиддич
квиддичу: квиддичу
кинокомпания: кинокомпании
кинотеатр: кинотеатрах
кинофестиваль: кинофестивале
кличка: клички
кловис: кловис
клоувс: клоувс
клювокрыл: клювокрыл
клювокрыла: клювокрыла
клювокрыле: клювокрыле
ключевой: ключевые
книга: книги книгой книге книга
когтевраном: когтевраном
код: код
кодекс: кодекс
коламбус: коламбус
коламбуса: коламбуса
коллекционный: коллекционная
колтрейн: колтрейн
команда: команды
комментарий: комментарии
комната: комната
компенсация: компенсации
композитор: композитор
конец: конце конца
конструктор: конструктор
конфиденциальность: конфиденциальности
конфисковать: конфискуют
корнелиус: корнелиусом корнелиус
короста: короста
короткий: короткие короткий
костюм: костюмам
котел: котел
который: которой которую которого которые которых которая который
край: краю
краткий: кратко
крестный: крестный
крис: крис криса
кристи: кристи
кристофер: кристофер
критик: критиков
критика: критику
критиковать: критиковал
кроме: кроме
крыло: крыле
крыса: крыса
крыть: крыло
крэбб: крэбб
крэйг: крэйг
кто: кому
куарон: куарон
куарона: куарона
кубок: кубок
кук: куки
купе: купе
кусать: кусает
кыргызча: кыргызча
кэтлин: кэтлин
лазарет: лазарете
ларусса: ларусса
лекарство: лекарство
ленни: ленни
лето: лето
линия: линии линий линию
лицензия: лицензии
лицо: лиц
личность: личности
лишение: лишениях
лишь: лишь
локация: локации
лондон: лондоне
лорд: лорда лорд
лунатик: лунатик
льюис: льюис
любить: любимая
любовь: любовь
любой: любые
люпин: люпин люпином люпина
люциуса: люциуса
магический: магическими
магия: магия магии
маглы: маглы
мадам: мадам
майкл: майкл майклу
макгонагалл: макгонагалл
макдогалл: макдогалл
македонский: македонски
маккеллен: маккеллен
маккеллену: маккеллену
маленький: маленькая
малфой: малфой
малфоя: малфоя
мама: маму
мардж: мардж
марк: марк
материал: материал
матрица: матрица
матч: матча матчей
маховик: маховик
мая: мая
медиафайлы: медиафайлы
мексиканец: мексиканец
меллинг: меллинг
менее: менее
мертвец: мертвеца
место: места
местонахождение: местонахождение
местоположение: местоположение
месть: месть
метла: метлу метлы
миллион: млн
мина: мин
минерва: минерва
минервой: минервой
министерство: министерство
министр: министр
мир: мира мир
миссис: миссис
многие: многие
много: более много
мобильный: мобильная
можно: можно
мой: моей
молли: молли
молния: молния
молодая: молодая
момент: момента момент моменты
монгол: монгол
монстр: монстрах
морить: моря
морт: морт
морта: морта
морту: морту
мотив: мотивам
мочь: мог могут
мощный: мощное
мститель: мстители
музыка: музыкой музыку музыка
мы: нами
мэгги: мэгги
мэттью: мэттью
мюррей: мюррей
наблюдать: наблюдать наблюдает
навигация: навигации навигация
награда: награды
над: над
надежда: надежды
надуться: надуться
назад: назад
назначить: назначен
назойливый: назойливых
называть: называемого
наказать: наказан
наложить: наложенные
намекать: намекает
намереваться: намереваясь
намерен: намерен
нападать: нападают
нападение: нападению
напасть: напасть напали
наперекосяк: наперекосяк
написать: написал
направляться: направляется
например: например
нарнии: нарнии
научиться: научиться
находить: находит
начало: начало начале
начаться: начались
начинаться: начинается
наш: наших
невидимый: невидимая невидимой
невилл: невилл
невиновность: невиновности
неделя: недель
недовольный: недоволен
недостоверный: недостоверный
независимость: независимости
незаметно: незаметно
незначимый: незначимых
некоммерческий: некоммерческой
некоторые: некоторые
неопр: неопр
неполный: неполный
несколько: нескольких несколько
неслучайный: неслучайны
несовершеннолетний: несовершеннолетних
несчастный: несчастный несчастное
новый: новый новые новых
нора: нору
норрис: норрис
ночной: ночной
ночь: ночи
об: об
оба: обоих
обвинить: обвинил
обезоруживать: обезоруживающее
обитание: обитания
облик: облик
обморок: обморок
обнаруживать: обнаруживает обнаруживают
обнимать: обнимает
оборотень: оборотнем оборотень оборотнях
образ: образом образ
обратный: обратно
обращение: обращения
обстоятельство: обстоятельства
обсуждение: обсуждение
обусловить: обусловила
обучить: обучить
общий: общего
объявлять: объявляет
объясняться: объясняется
огонь: огня
один: один одно
однако: однако
одновременно: одновременно
ожидать: ожидая
оказываться: оказывается
октябрь: октября октябре
олдмен: олдмен
оливер: оливер
они: них
онлайн: онлайн
опасный: опасных
оператор: оператор
описание: описание
оправдать: оправдать
опытный: опытными
организация: организации
орден: орден
оригинальный: оригинальной
освободить: освободить
освобождать: освобождают
оскорблять: оскорбляет
основа: основе
основной: основные основной основная
оставить: оставлен
остальное: остальные
остановить: остановить
остаться: остались
осудить: осужденный
ответ: ответом
ответственность: ответственности
отвлекать: отвлекает
отгонять: отгонять отгоняет
отдаленный: отдаленный
отдельный: отдельных отдельные
отец: отца отец
отзыв: отзывов
отказ: отказ
отказаться: отказался
отличаться: отличаться
отличие: отличия
отношение: отношения отношение
отогнать: отогнать
отодвинуть: отодвинули
отразить: отражены
отредактировать: отредактирована
отрезать: отрезал
отряд: отряд
отсутствие: отсутствие
отсутствовать: отсутствует отсутствуют
официальный: официальный
охранник: охранники
оценка: оценку
очень: очень
ошибка: ошибке
падение: падение
падма: падма
пайк: пайк
палач: палач
палец: палец
палочка: палочку
парвати: парвати
парк: парк
паркинсон: паркинсон
пародия: пародии
патил: патил
патронуса: патронуса
патрулировать: патрулировать
первое: первых первые
первый: первый
перед: перед
переживание: переживаниям
переживать: переживают
перезагрузка: перезагрузка
перейти: перейти
перемещаться: перемещаются
перепугать: перепуганная
перераспределить: перераспределены
переть: при
перси: перси
персонаж: персонаж персонажи персонажей
персонал: персонал
персональный: персональные
пес: пес
петтигрю: петтигрю
петунья: петунья
печать: печати
пират: пираты
питер: питер питера
план: план
побег: побега побег
поведение: поведения
погоня: погоня
подача: подачи
подвергнуться: подвергся
подземный: подземному
подножие: подножия
подписать: подписать
подразумеваться: подразумевается
подробный: подробной подробнее
поезд: поезд
пожертвовать: пожертвовать
пожиратель: пожиратели
позволять: позволяет
поздний: позже
поиск: поиск поиску
поймать: пойман
пока: пока
полет: полет
политик: политика политике
полнолуние: полнолуние
полнометражный: полнометражных
полностью: полностью
полный: полное полной полный полная
полтергейст: полтергейстах
полукровка: полукровка
получать: получает
получить: получить
помощь: помощью
понимать: понимает
понравиться: понравился
попадать: попадают
попасть: попавших попасть
попытка: попытке
пора: пор
портал: портал
портрет: портрет портрете
портретирование: портретирование
посетить: посетить
посещение: посещения
последний: последний
посол: после
постановщик: постановщик
постоянный: постоянная
посылать: посылает
поттер: поттером поттер поттера поттеров поттере
поцелуй: поцелую
появляться: появляется
править: править
правка: правки
правосудие: правосудия
практический: практически
превращаться: превращаться превращается
предать: предал
предлагать: предлагали
предмет: предметы
предоставить: предоставлен
представиться: представились
предупреждать: предупреждает
предыдущий: предыдущий
предыстория: предыстория предыстории
премия: премия
премьер: премьера
преподаватель: преподаватель преподавателем
преподавательский: преподавательской
преступление: преступлениях
преступник: преступника
прибывать: прибывает
приводить: приводит
приговаривать: приговаривают
приговорить: приговорен
приготовить: приготовленное
приз: приз
призрачный: призрачные
прийти: пришедшая
приключение: приключениям
приключенческий: приключенческий
применять: применяет
примечание: примечания
принадлежать: принадлежат
принц: принц
принцесса: принцесса
присутствие: присутствии
приходить: приходит
пробираться: пробирается
проверить: проверенной проверить
проверка: проверки
проверяться: проверялась
проводить: проводит
провоцировать: провоцирует
прогонять: прогоняет
продюсер: продюсеры
проект: проектах
произвести: произвести
производство: производство
произойти: произошедшее
проклясть: проклятое
проникать: проникает
проникнуть: проник
пропустить: пропущены
прорицание: прорицания
пророчествовать: пророчествует
просмотр: просмотры
просто: просто
пространство: пространства
профессор: профессором профессора профессор
процесс: процесс
прочий: прочее
прошлый: прошлые прошлом
проявляться: проявляется
прямой: прямо
психологический: психологическое
публикация: публикации
пускаться: пускается
путеводитель: путеводитель
путешествие: путешествия путешествиях
пытаться: пытается
пэм: пэм
пэнси: пэнси
работа: работе работы работу
радость: радостью
развитие: развитие
разгневать: разгневанный
разный: разных
разоблачить: разоблаченный разоблачить
разработчик: разработчики
разрушать: разрушает
разыскивать: разыскивающие
райт: райт
ранее: ранее
ранить: ранит
раскрывать: раскрывают
раскрытие: раскрытие
распределять: распределяющая
рассказ: рассказы
рассказывать: рассказывает
расширение: расширение
реальный: реальном
результат: результате
рейтинг: рейтинг
религиозный: религиозные
релиз: релиз
ресурс: ресурсы
рецензия: рецензий
решимость: решимости
рикман: рикман
римус: римус
римуса: римуса
ричард: ричарда ричард
робби: робби
роберт: роберт
роджер: роджер
родитель: родителей
родственный: родственных
рождение: рождения
рождество: рождество
розмерта: розмерта
роль: роль ролях роли
рома: рома
роман: романов романа
романтический: романтические
рон: роном рона рон
росомаха: росомаха
роулинг: роулинг
рубеус: рубеус
руперт: руперт
русский: русский
рыцарь: рыцарь
рэдклифф: рэдклифф
рэнкин: рэнкин
сайт: сайте сайт сайты
сам: самой самом
сантиметр: см
саундтрек: саундтрек
сбегать: сбегает
сбежать: сбежал сбежать
сбор: сборы
сведение: сведения
свежий: свежие
света: света
свидетель: свидетелем
свободный: свободной
свое: своих своими
свой: своей свою
связанный: связанные
связаться: свяжитесь
связь: связи связь
северус: северус
сегачьян: сегачьян
сентябрь: сентября
серезин: серезин
сериал: сериал
серия: серии серию серия
серьезный: серьезно
сестра: сестра
сивилла: сивилла
симпатия: симпатий
симус: симус
сириус: сириуса сириус сириусе
система: системе
ситар: ситара
ситхов: ситхов
сказка: сказки
скачать: скачать
скрываться: скрываются скрываясь
скрытый: скрытые
слабый: слабую
следовать: следуют
следующий: следующий следующих
слизерином: слизерином
словарь: словари
сложность: сложность
сложный: сложное
служебный: служебные
случай: случаях случай
случайно: случайно
случайный: случайная
смертный: смертной
смерть: смерть смерти
смит: смит
снаружи: снаружи
сначала: сначала
снегг: снегг
снеггом: снеггом
снять: снял
сняться: снялась
собака: собаку
собираться: собирался
собственный: собственную собственных
событие: события
совет: совету
совпадение: совпадения
содержание: содержание
создатель: создателей
создать: создать
сознание: сознание
сократить: сокращена
сообщество: сообщество
сообщить: сообщить
сопровождать: сопровождаемого
состав: состав
сохатый: сохатый
сохранение: сохранением
спасать: спасает
спасти: спасла
специальный: специально
список: список
сполл: сполл
спора: споры
способность: способностях
способный: способный
справка: справка
сражаться: сражается
среди: среди
средний: средним
српски: српски
српскохрватски: српскохрватски
ссылка: ссылка ссылками ссылки
становиться: становится
становление: становлению
старик: старик
старое: старого
статистика: статистика
стать: стал стало
статья: статья статьи
стив: стив
стивен: стивен
сторона: сторона
сторонник: сторонник
страна: страны
страница: страницы страница страницу странице
страсть: страсти
студент: студенты
стэн: стэн
стюарт: стюарт
сундук: сундук
существо: существа существами
существовать: существуют
схватить: схвачен
сцена: сцене
сценарий: сценария
сценарист: сценарист
счесть: сочтет сочли
сша: сша
сыграть: сыграть
сюда: сюда
сюжет: сюжет сюжета сюжете
сюжетный: сюжетной сюжетных
таваре: таваре
таинственность: таинственности
тайный: тайная
также: также
такой: таким таком такие
таня: таня
татарча: татарча
твой: твою
текст: текст
текущий: текущие текущая
тем: тем
тематический: тематический тематические
темим: темим
темный: темных темный
тереть: три
термин: термина
терять: теряет
тим: тим
тимоти: тимоти
титр: титрах
товарный: товарный
томас: томас
томпсон: томпсон
торо: торо
тот: том тех тот той
трактирщик: трактирщик
транс: транс
транспорт: транспорт
трансформироваться: трансформироваться
требовать: требуют
трелони: трелони
третий: третий
третье: третьем
триквелы: триквелы
тринадцатый: тринадцатый
трио: трио
троица: троицу
трюк: трюк
тсантса: тсантса
тьюлис: тьюлис
тюремный: тюремные
тюрьма: тюрьмы
тянуть: тянет
уайсберг: уайсберг
убегать: убегает
убеждать: убеждает
убить: убью убил убить
убрать: убраны
увольняться: увольняется
угода: угоду
удаваться: удается
уделить: уделено
узнать: узнав узнает
узник: узник
уизли: уизли
уильямс: уильямс уильямса
указание: указанием
указать: указан
улетать: улетает
улететь: улететь
уолтерс: уолтерс
уорик: уорик
уотсон: уотсон
упасть: упасть
упоминание: упоминания
упоминаться: упоминаются упоминается
упрекать: упрекали
урок: уроки урок урока
условие: условий условия
успеть: успел
утаскивать: утаскивает
уход: уходу
участвовать: участвовал
участие: участие
участник: участниками
учебный: учебного
ученик: ученики
уэбб: уэбб
уэйлетт: уэйлетт
фадж: фадж
фаджа: фаджа
фаджем: фаджем
факт: факт
фантастический: фантастические
февраль: февраля
фелпс: фелпс
фелтон: фелтон
феникс: феникса
феррис: феррис
фигура: фигурой фигура
фиделиус: фиделиус
филиус: филиус
философский: философский
филч: филч
фильм: фильм фильме фильмов фильмах фильма фильмы
финал: финал
финниган: финниган
фиона: фиона
флитвик: флитвик
флитвика: флитвика
фонарик: фонарик
фонд: фонд
форд: форд
форма: формой
форсаж: форсаж
форум: форум
фред: фредом фред
фредди: фредди
френч: френч
фэнтези: фэнтези
фэнтезийный: фэнтезийный
хагрид: хагрид
хагрида: хагрида
харди: харди
харрис: харриса харрис
хвост: хвост
хейман: хейман
хеллбоем: хеллбоем
хердман: хердман
хижина: хижину хижины
хобби: хобби
хогвартс: хогвартс
хогвартса: хогвартса
хогвартсе: хогвартсе
хогсмид: хогсмид
ход: ходу
холмс: холмс
хороший: лучшими
хроник: хроники
художник: художник
цитата: цитаты
цитировать: цитировать
чанг: чанг
чар: чары
час: часа
часть: часть
чей: чьей
человек: человек человека люди
человеческий: человеческое человеческий
чемпионат: чемпионат чемпионата
через: через
черный: черный
чжоу: чжоу
число: числе
читать: читать
чтобы: чтобы
чудо: чудо
шанпайк: шанпайк
шанс: шанс
шармбатон: шармбатон
шах: шах
шерлок: шерлок
школа: школу школы
школьный: школьным
шляпа: шляпа
шмитц: шмитц
шоу: шоу
эбби: эбби
экранизация: экранизация
экспозиция: экспозиции
экстренный: экстренный
экшн: экшн
элемент: элемент
эмма: эмма
эмоциональный: эмоциональным
энох: энох
энциклопедия: энциклопедии
эпизод: эпизод
эрни: эрни
это: этом это
этот: этой эта эту
эффект: эффекты эффекта
являться: является
явно: явно
язык: язык языках языке
январь: января
