абсолютно: абсолютно
автор: автор
авторитет: авторитет
авторство: авторства
азад: азад
азкабан: азкабан
азкабана: азкабана
айзекс: айзекс
акт: актом
активно: активно
актриса: актриса
алан: алан
аластор: аластор
алек: алек
алфавит: алфавиту
альбус: альбус
альбуса: альбуса
альбусом: альбусом
альфред: альфред
амбридж: амбридж
амелия: амелия
англ: англ
английский: английский английское английском
англия: англии
антонин: антонин
арабелла: арабелла арабеллы
арбен: арбен
аргус: аргус
артефакт: артефактов
артур: артур
архив: архив
архивировать: архивировано
атаковать: атаковали
афшан: афшан
базироваться: базируется
байрактарай: байрактарай
барда: барда
баррон: баррон
беда: беды
бежать: бегут бежать
бейтсон: бейтсон
беларуская: беларуская
беллатриса: беллатриса
беллатрису: беллатрису
беллатрисы: беллатрисы
бесполезный: бесполезным
библиографический: библиографических
бидля: бидля
блэк: блэк
блэка: блэка
блэков: блэков
боль: боли боль
больница: больнице
больший: большее большая
большинство: большинство
большой: большой
бонни: бонни
бонэм: бонэм
борьба: борьбы борьбе
боунс: боунс
брат: брата
брендан: брендан
бриджитт: бриджитт
брук: брук
бруствер: бруствер
брэдли: брэдли
буква: букве
български: български
быть: были
бюджет: бюджет
важный: важные
валлийский: валлийском
вальда: вальда
ваш: ваши
ведьма: ведьмах
великан: великанам
великобритания: великобритания великобритании
вера: вера
верить: верят верить верит
вернон: вернон
верный: верным
версия: версия версии
вечер: вечером
вещь: вещи вещь
взросления: взросления
взять: возьмут
вид: вид
видение: видение
видеть: видеть видит видел
видеться: видится
визенгамота: визенгамота
викиданных: викиданных
викимедиа: викимедиа
викиновости: викиновости
википедии: википедии
википедия: википедия
викисклад: викисклад
викискладе: викискладе
вильгельмина: вильгельмина
вино: вину
винсент: винсент
вклад: вклад
власть: власти
влияние: влияние
вместе: вместе
внешний: внешние
возвращаться: возвращается
возвращение: возвращение возвращении
возглавлять: возглавляют
воздействие: воздействием
войти: войти
вокзал: вокзале
волан: волан
волшебник: волшебника волшебников волшебники
волшебный: волшебные волшебного волшебный волшебному
волшебство: волшебства
вольность: вольности
воспользоваться: воспользоваться
воспоминание: воспоминаниях
восстановить: восстановлен
впервые: впервые
время: временем время
все: всему всех
всеять: всей
вставать: встают
встречать: встречают
встречаться: встречается встречаются встречаться
входить: входят входили
выбирать: выбираем
выгонять: выгоняет
вызволять: вызволяет
вызывать: вызывает
вылетать: вылетают
выпускной: выпускные
вырезать: вырезаны
выручать: выручай
выследить: выследить
выходить: выходит
выясняться: выясняется
вэнс: вэнс
газета: газете
гарри: гарри
генеральный: генерального
гермиона: гермиона гермионы гермионой
героизм: героизме
главное: главных
главный: главную главной
глаз: глаз
глен: глен
гленфиннане: гленфиннане
глисон: глисон
гнев: гневом
говорить: говорит
говориться: говорится
говорят: говорят
год: году лета лет год годы года
гойл: гойл
голденберг: голденберг
голденберга: голденберга
голос: голос
гость: гости
готовиться: готовится
граббли: граббли
графство: графство
грегори: грегори
грейнджер: грейнджер
гриммо: гриммо
грин: грин
гринт: гринт
гринта: гринта
гриффиндора: гриффиндора
гриффитс: гриффитс
грозный: грозный
громить: громят
группа: группой
грюм: грюм
гэмбон: гэмбон
гэри: гэри
давление: давлением
дадли: дадли
дальнейший: дальнейшем
дамблдор: дамблдор
дамблдора: дамблдора
дамблдором: дамблдором
дар: дары
дарита: дарит
дата: дата
двоюродный: двоюродного
де: де
девон: девон
действие: действия действие действию
действовать: действовать
декабрь: декабря
декорация: декораций
делать: делая
дело: делу
дементоры: дементоры
день: дней
держаться: держатся
деталь: детали
деть: день
деятельность: деятельность
дж: дж
джарвис: джарвис
джейми: джейми
джеймс: джеймс
джейсон: джейсон
джеральдин: джеральдин
джинни: джинни
джоан: джоан
джон: джон
джордж: джордж
джошуа: джошуа
джули: джули
дилогия: дилогия
дина: дин
директор: директором директор директора
дистрибьютор: дистрибьютор
дитя: дитя
длительность: длительность
добавление: добавления
добби: добби
добиваться: добивается
добираться: добираются
довести: доведены
дож: дож
док: док
долгопупс: долгопупс
долгопупса: долгопупса
должен: должно
должность: должности
долиш: долиш
доллар: долларов
долорес: долорес
долохов: долохов
дом: дом
дома: дома
домовой: домовой домовым
домыть: домой
дополнительный: дополнительные
допрашивать: допрашивает
дорогой: дороги
доставлять: доставляют
достигать: достигают
доступный: доступен
драко: драко
драма: драма
древность: древности
друг: друзья друзей друзьям
другой: другим другими другие других
дружба: дружба
дружина: дружиной дружину
дурмстранг: дурмстранг
дурслей: дурслей
дурсль: дурсль
дух: духу дух
дуэль: дуэли
дэвид: дэвида дэвид дэвиду
дэвис: дэвис
дэниел: дэниелу дэниел
е: е
едва: едва
ежедневный: ежедневный
жажда: жаждой
жанр: жанры
ждать: ждал
желание: желание
жестокий: жестокое
журналистка: журналистка
заглавный: заглавная
заговор: заговоре
задача: задача задачу
заклинание: заклинания заклинаниям заклинание
заключаться: заключалась
заключение: заключения
заклятие: заклятий заклятием
зало: зале
заманить: заманив
заменить: заменить
занятие: занятия занятий
занять: занять занял
запись: запись
запретить: запрещено
запретный: запретный
зарегистрировать: зарегистрированный
затем: затем
захватить: захваченной
защита: защиты защите защиту
защитный: защитной
заявление: заявление
зверь: звери
знак: знак
знать: знает
значение: значения значение
значительно: значительно
значительный: значительных
зрение: зрения
игра: игра игры
идея: идеи идею
идзяк: идзяк
избавляться: избавлялись
избранный: избранные
издевательство: издевательства
изменение: изменения
изображение: изображением
имельда: имельда
иметь: имел имеют имевший иметь имеет
инициатива: инициативу
инспектировать: инспектирует
инспектор: инспектора
инспекционный: инспекционную инспекционной
инструмент: инструменты
ирландия: ирландии
ирландский: ирландском
исключение: исключении исключение
искусство: искусстве искусств
исполнить: исполнила
использование: использование использовании использования
использовать: использовала использующие
испытание: испытаниями
истец: истец
история: историю история истории
источник: источник
исчезнуть: исчез
июль: июля
июнь: июня
йейтс: йейтс
йейтса: йейтса
йейтсу: йейтсу
казнить: казни
какой: каким
камень: камень
камин: камины камин
канада: канаде
каникулы: каникулы каникул
картер: картер
карточный: карточная
картрайт: картрайт
кассовый: кассовых
каталог: каталог каталогах
категорически: категорически
категория: категории
квиддич: квиддич
квиддича: квиддича
квиддичу: квиддичу
кентавр: кентаврам
кикимер: кикимер
кикимера: кикимера
кингс: кингс
кингсли: кингсли
кино: кино
кинокомпания: кинокомпании
киностудия: киностудии
кинотеатр: кинотеатрах
класс: класс
ключ: ключ
книга: книги книгой книге
код: код
кодекс: кодекс
коллекционный: коллекционная
колония: колонии
колтрейн: колтрейн
команда: команде
коммерчески: коммерчески
комната: комнате комнату комната комнаты
компания: компании
композитор: композитор
конструктор: конструктор
контроль: контроль
конфиденциальность: конфиденциальности
концепция: концепцию
корнелиус: корнелиус корнелиуса
короткий: короткие короткий
который: которой которую которого которые которых которая который
крайний: крайней
критик: критиков
критика: критика
кроме: кроме
кросс: кросс
круциатус: круциатус
крэбб: крэбб
крэйг: крэйг
кто: кого
кубок: кубок кубке
куда: куда
кузен: кузеном кузена
кук: куки
курс: курс
кыргызча: кыргызча
кэти: кэти
кэтрин: кэтрин
лавгуд: лавгуд
легенда: легенда
лекция: лекций
лес: лес
лесничий: лесничий
лестрейндж: лестрейндж
летие: летия
летний: летние
летучий: летучего летучий
лили: лили
линч: линч
лиф: лиф
лицензия: лицензии
лицо: лицу лицом
личной: личному
лишение: лишениях
лишь: лишь
ловить: ловят
ловушка: ловушкой
локация: локации
лондон: лондоне
лорд: лорд
льюис: льюис
льюнг: льюнг
любовь: любовь
любой: любые любой
люпин: люпин
люциус: люциус
люциусу: люциусу
магический: магического
магия: магия магии
магла: магла
маглы: маглы
майкл: майкл
макгонагалл: макгонагалл
македонский: македонски
маленький: малейшего мало
малолетний: малолетних
малфой: малфой
малфою: малфою
малфоя: малфоя
мальчик: мальчика
мариэтта: мариэтта
марк: марк
марта: марта
массовый: массовый
материал: материал
мать: мать
медальон: медальон
медиафайлы: медиафайлы
меллинг: меллинг
место: место места
месть: мести
месяц: месяц
миллар: миллар
миллион: миллиона млн
мина: мин
минерва: минерва
министерство: министерства министерством министерство министерстве министерству
министр: министр министра
мир: мира мир
миранда: миранда
миссис: миссис
мистер: мистером мистера
многие: многие
мобильный: мобильная
мой: моя
молли: молли
молодая: молодая
момент: момент
монгол: монгол
морт: морт
морта: морта
мортом: мортом
мотив: мотивам
мочь: могут
мощь: мощь
мракоборцы: мракоборцы
мунго: мунго
мучить: мучит
мы: нами
мэгги: мэгги
мэттью: мэттью
мюррей: мюррей
мятеж: мятеж
наблюдение: наблюдением
навигация: навигации навигация
над: над
назначать: назначает
назначаться: назначается
назначение: назначении
назойливый: назойливых
называть: называющей называть
намного: намного
нападать: нападают нападает
нападение: нападения
написать: написала
наслать: наслать
настаивать: настаивают
настояние: настоянию
наталия: наталия
находить: находит
начать: начали
начинаться: начинается
наш: наших
небольшой: небольшой
невилл: невилл
невилла: невилла
недавний: недавней
недостаток: недостатками
недостоверный: недостоверный
недоступный: недоступная
независимость: независимости
незаконный: незаконном
неизвестный: неизвестным
некоммерческий: некоммерческой
некоторые: некоторые
некоторый: некоторое
нельзя: нельзя
немного: немного
ненавидеть: ненавидит
необходимость: необходимости
необходимый: необходимы
неожиданно: неожиданно
неопр: неопр
неполный: неполный
непростительный: непростительных
нерабочий: нерабочими
несовершеннолетний: несовершеннолетним
нетерпение: нетерпением
никогда: никогда
николас: николас
нимфадора: нимфадора
новый: новым новые новых
нога: ног
норрис: норрис
ночь: ночью
нужно: нужно
об: об
обитание: обитания
обитать: обитают
обнаруживать: обнаруживает обнаруживают
образ: образом
обратный: обратном
обращение: обращения
обрести: обрело
обсуждение: обсуждение
обучать: обучает
обучение: обучения
общество: общества
объяснить: объяснил
объяснять: объясняют объясняет
обязанность: обязанностей
огонь: огня
ограничить: ограниченный
огромный: огромное
одержимый: одержимый
один: одной одного одно одним
однажды: однажды
однако: однако
однокурсник: однокурсника
одобрить: одобренный
озеро: озера
оказываться: оказывается
окклюменции: окклюменции
окружать: окружают
окружение: окружение
олдмен: олдмен
оливер: оливер
она: ею
они: ими им них ними
онлайн: онлайн
опасаться: опасаясь
опасный: опасных
оператор: оператор
описание: описание
описать: описал
оправдание: оправдания
опытный: опытными
организация: организации
орден: ордена орден
оружие: оружие
оскорблять: оскорбляет
основа: основе
основать: основан
основное: основном
основной: основных основные основную
оставаться: оставаться
остальное: остальные остальных остальными
ответственность: ответственности ответственность
ответственный: ответственная
отдать: отдать отдал
отдельный: отдельных отдельные
отец: отец
отзыв: отзывы
отказ: отказ
открываться: открывается
отличаться: отличаться
отличие: отличия
отложить: отложить
отметить: отметила
отправить: отправить
отправиться: отправиться
отправлять: отправлял
отправляться: отправляются
отредактировать: отредактирована
отрицать: отрицают
отряд: отряда отрядом отряд отряду
отставка: отставку
отстранить: отстранена
отсутствие: отсутствие
отсутствовать: отсутствует
официально: официально
официальный: официальный официального официальные
оценка: оценку оценкой
очень: очень
очередной: очередного
очередь: очередь
ошибка: ошибке
падма: падма
параллельно: параллельно
парвати: парвати
парк: парк
пародия: пародии
патил: патил
патронуса: патронуса
пейзаж: пейзажи
пентиквелы: пентиквелы
переводить: переводит
переговоры: переговоры
перед: перед
передать: переданы
переживание: переживания
перейти: перейти
перенести: перенесено
перерыть: перерыв
пересказать: пересказать
переставать: перестают
переход: переход
перси: перси
персонаж: персонаж персонажам персонажа персонажи
персонал: персоналом персонал
персональный: персональные
петунья: петунья
печать: печати
письмо: письмо
питер: питер
плакат: плакаты
площадь: площадь
побег: побег
поведение: поведения
погода: погода
поддержка: поддержку
подействовать: подействовало
подземный: подземный
поднимать: поднимают
подобие: подобие
подозревать: подозревает
подорвать: подорвать
подробный: подробнее
подросток: подростком
подруга: подруга
подтвердить: подтверждено
поединок: поединок
пожертвовать: пожертвовать
пожизненный: пожизненного
пожиратель: пожиратели
поиск: поиск поиску
пока: пока
показать: показать показанный
политик: политика политике
полнометражный: полнометражных
полный: полную полном полный
положение: положения
положительный: положительные
полтергейст: полтергейстах
полукровка: полукровка
полумна: полумна
полумну: полумну
получаться: получается
получить: получил получить
полюбить: полюбила
помимо: помимо
помощь: помощью
понимать: понимают понимаете понимает
понравиться: понравиться
понять: понял
попросить: попросил
порох: пороха порох
портал: портал
портиться: портится
поручать: поручает
последний: последний последнего последнему
посол: после
поставить: поставленной
постановщик: постановщик
постараться: постарались
постоянный: постоянная
поступить: поступил
поттер: поттер поттере
поцеловаться: поцеловались
почтить: почти
почувствовать: почувствовать
поэтому: поэтому
появляться: появляются появляется
правда: правды правду
править: править
правка: правки
правый: право
практик: практике
превратить: превратив
превращение: превращения
предать: предала
предмет: предметы
преднамеренно: преднамеренно
представиться: представились
представление: представления
предшествовать: предшествующие
предыдущий: предыдущий
предыстория: предыстория
прекратиться: прекратились
премьер: премьера
преподавательница: преподавательницу
преподавать: преподавать
преследовать: преследует
преступление: преступления
преступник: преступников
приближение: приближения
призвать: призвана
приключение: приключения
приключенческий: приключенческий
прикончить: прикончить
прилегать: прилегающей
применение: применение
применить: применить
примечание: примечания
принц: принц
присутствие: присутствии
приходить: приходит
приходиться: приходится
причина: причины
причинить: причинить
про: про
пробовать: пробуя
проверить: проверенной
проверка: проверки
проверяться: проверялась
провинция: провинциях
проводить: проводить проводит
продавец: продавцы
продолжать: продолжает
продюсер: продюсерам продюсеры
проект: проектах
производство: производство
происходить: происходили
прокат: прокат
проклясть: проклятое
проникать: проникает
проникновение: проникновения
пропустить: пропущена пропущены
прорваться: прорваться
прорицание: прорицаний
пророк: пророк
пророчество: пророчество пророчестве пророчеств
просмотр: просмотры
просто: просто
простой: проще
пространство: пространства
противостоять: противостоять
профессор: профессором профессора профессор профессору
проходить: проходил проходя
процесс: процессе
прочий: прочее
путеводитель: путеводитель
путь: путь пути
пытать: пытает
пытка: пытки
пятый: пятый пятого
работник: работники
рабочий: рабочих
равный: равно
разбегаться: разбегаются
развязка: развязки
различаться: различаются
разработчик: разработчики
разум: разума
разучивать: разучивают
разъяснение: разъяснениям
райт: райт
рамка: рамкам
раскрывать: раскрывает
распределять: распределяющая
распространять: распространяет
рассказ: рассказы
рассказывать: рассказывает
расстроить: расстроили
расширение: расширение
реабилитировать: реабилитированы
регулярно: регулярно
реддл: реддл
результат: результате
рейтинг: рейтинг
рекламный: рекламные
религиозный: религиозные
релиз: релиз
ресурс: ресурсы
рецензия: рецензий
решать: решают
решаться: решается
рикман: рикман
римус: римус
рита: рита
ричард: ричард
ричардсон: ричардсон
робби: робби
роберт: роберт
родитель: родителями родители
родовой: родовой
рождественский: рождественских
рождество: рождеством
роль: роль ролях роли
роман: романов романа
рон: роном рона рон
роулинг: роулинг
роулинс: роулинс
рубеус: рубеус
рука: руки
руководство: руководством
руперт: руперта руперт
русский: русский
рушиться: рушится
рэдклифф: рэдклифф
рэдклиффу: рэдклиффу
рэйф: рэйф
сайан: сайан
сайт: сайте сайт сайты
сам: самой
самооборона: самообороны
самый: самых
сантиметр: см
саундтрек: саундтрек
сбежать: сбежавших
сбивать: сбивает
сбор: сборы
сведение: сведения
свежий: свежие
свидетельница: свидетельницей
свободный: свободной
свое: своих свои своего своим своими
свой: свой свою
связанный: связанные
связаться: свяжитесь
связь: связью
святой: святого
сдавать: сдают сдавать
сдача: сдачи
сделать: сделают
северный: северной
северус: северус
седьмой: седьмой
секретный: секретное
семейный: семейные
семья: семья семьи
сентябрь: сентября
середина: середине
сериал: сериал
серия: серии серию серия
сивилла: сивиллу сивилла
сила: силу сил силы
сильный: сильное
симус: симус
сириус: сириуса сириус сириусом
система: системе
сказать: сказала
сказка: сказки
скандинавия: скандинавии
скачать: скачать
сквиба: сквиба
скитер: скитер
скрытый: скрытые
славомир: славомир
следить: следить
следующий: следующий
словарь: словари
слово: словам
сложный: сложных
служебный: служебные
слух: слухи
случай: случае случаях
случайный: случайная
слушание: слушания слушание
слушать: слушает
смертный: смертной
смерть: смерти
смит: смит
смочь: смогли
снег: снега
снегг: снегг
снегга: снегга
снеггу: снеггу
снежный: снежные
сниматься: снимались
сниться: снится
снять: снят сняты
собираться: собирается
собственный: собственный
событие: события событий
сова: сов
совершаться: совершается
содержание: содержание
создание: создание
создатель: создатели
создать: создать
сознание: сознание сознания
сокращаться: сокращается
сокращение: сокращение сокращению
сомервилль: сомервилль
сообщаться: сообщается
сообщество: сообщество сообществу
сообщить: сообщить сообщил
соответствие: соответствия
соответствовать: соответствует
соседка: соседки
состав: составе
состояться: состоялась
сохранение: сохранением
спас: спас
спасать: спасает
спасти: спасти
список: список
спора: споры
спортивный: спортивной
способ: способа способами
способный: способны
справка: справка
сражение: сражению сражение
среди: среди
средний: средней
српски: српски
српскохрватски: српскохрватски
срывать: срывают
ссора: ссоре
ссылка: ссылка ссылками ссылки
становиться: становится
староста: старостами
статистика: статистика
статус: статусу
стать: стало
статья: статью статья статье статьи
стен: стена
стонтон: стонтон
сторона: сторону
сторонник: сторонники
страна: страны
страница: страницы страница страницу странице
стремиться: стремясь
строительство: строительства
студент: студенты студентов студентами
стюарт: стюарт
судья: судьи
сумасшествие: сумасшествия
суметь: сумел
сумма: сумму
существо: существа
существовать: существуют
схожий: схожий
сцена: сцена сцен сцены
сценарий: сценария сценарий
сценарист: сценарист
сша: сша
сыворотка: сыворотки сыворотку
сюда: сюда
сюжет: сюжет
сюзи: сюзи
тайна: тайну
тайный: тайная тайно тайны
также: также
такой: такой такими
тарзан: тарзан
тварь: твари
текст: текст
текущий: текущие текущая
телевидение: телевидение
тем: тем
тематический: тематический тематические
тен: тена
термин: термина
терпеть: терпят
территория: территории территориях
тимоти: тимоти
тичборн: тичборн
товарный: товарный
томас: томас
томпсон: томпсон
тонкс: тонкс
тот: том та
точка: точки
трансгрессировать: трансгрессировать
трансгрессирует: трансгрессирует
требование: требованию
требовать: требовало требует требуют
трелони: трелони
туда: туда
тщательно: тщательно
тьюлис: тьюлис
тюрьма: тюрьмы
убивать: убивает
убийство: убийство
убийца: убийцу
уговаривать: уговаривая
угрожать: угрожающих
угроза: угрозой
узнать: узнают узнала
узник: узник
уизли: уизли
уильямс: уильямс
указание: указанием
указать: указан
улица: улицу
унижать: унижает
уолтерс: уолтерс
уорик: уорик
уотсон: уотсон
упоминаться: упоминается
урок: уроки
условие: условий условия
успевать: успевает
успешный: успешным
устраивать: устраивают
устроиться: устроилась
уходить: уходит
участие: участие участием
участник: участниками
ученик: учеников ученики
учитель: учителей
уэйлетт: уэйлетт
фадж: фадж
фаджа: фаджа
файнс: файнс
факт: факт
фантастический: фантастические
февраль: февраля
фейерверк: фейерверк
фелпс: фелпс
фелтон: фелтон
феникс: феникса
фестралах: фестралах
фиаско: фиаско
фигг: фигг
филиус: филиус
философский: философский
филч: филч
фильм: фильм фильме фильмов фильма фильмы фильмом
финниган: финниган
фиона: фиона
флитвик: флитвик
фонд: фонд
форум: форум
фотография: фотографию
фред: фред
фэнтези: фэнтези
фэнтезийный: фэнтезийный
х: х
хагрид: хагрид
хантер: хантер
харди: харди
харрис: харрис
хватать: хватают
хейман: хейман
хелена: хелена
хердман: хердман
хертфордшир: хертфордшир
хобби: хобби
хогвартс: хогвартс
хогвартса: хогвартса
хогвартсе: хогвартсе
хопкинс: хопкинс
хороший: наилучшего
хотеть: хочет
художник: художник
хупер: хупер
цель: цели
ценить: ценил
цитировать: цитировать
чанг: чанг
чародейство: чародейства
часть: часть
человек: людьми человека людям
чемпионат: чемпионат
через: через
чжоу: чжоу
чин: чины
чистый: чисто
читать: читать
член: членов члены членами
чоудхури: чоудхури
чтобы: чтобы
чужой: чужого
шантажировать: шантажирует
шармбатон: шармбатон
шефали: шефали
шикарный: шикарное
шиннер: шиннер
школа: школе школы
школьный: школьные
шляпа: шляпа
шотландия: шотландии
шоу: шоу
эванна: эванна
эджком: эджком
эдриан: эдриан
эйтив: эйтив
экзамен: экзамен экзамены
экранизация: экранизации
элемент: элемент
элфиас: элфиас
эльф: эльфом
эмма: эмма эмме
эммелин: эммелин
эмоциональный: эмоциональные
энох: энох
энциклопедия: энциклопедии
эппл: эппл
это: это этим
этот: этой эта
юг: юге
юность: юности
юный: юные юного
являться: является
язык: язык языках языке
январь: января
