августус: августус
автобус: автобуса
авторитетный: авторитетные
авторство: авторства
агентство: агентства
административный: административном административные
адрес: адрес
азартный: азартным
азкабан: азкабан
азкабана: азкабана
аквариум: аквариум
алохомора: алохомора
альбус: альбус
альбуса: альбуса
альбусом: альбусом
альбусу: альбусу
амбридж: амбридж
амелия: амелии
амфитеатр: амфитеатра
аналитик: аналитики
аналог: аналогом аналог
англ: англ
англия: англии
аннулирование: аннулирования
апрель: апреля
арест: ареста
арийский: арийской
арк: арка арки
артемисия: артемисия
артефакт: артефактов
артур: артуром артура артур
архивировать: архивировано
архивный: архивная
аспект: аспектами
атриум: атриума атриум
багнолд: багнолд
барда: барда
бартемий: бартемий
бартемиуса: бартемиуса
барти: барти
бартон: бартон
бассейн: бассейна
безвозвратно: безвозвратно
безлюдный: безлюдной
беларуская: беларуская
бенджамин: бенджамин
берт: берте
бесконечный: бесконечными бесконечно
бесполезный: бесполезной
бесцеремонный: бесцеремонно
бидля: бидля
битва: битва битвы
благодаря: благодаря
блеск: блеска
блэк: блэк
блэком: блэком
бой: бой
болгарский: болгарского
больница: больницу больнице
больший: большая
большинство: большинства
бонаккордом: бонаккордом
борьба: борьбы борьбой борьбе
боуд: боуд
боунс: боунс
братство: братства
брать: брала
бригада: бригада бригады
британский: британский британского британским
британско: британско
бродерик: бродерик
бросить: брошенные
бруствер: бруствера бруствер
будка: будки будка будку
буква: буквам
бумага: бумаге
бумажный: бумажных
български: български
быть: будут бывший бывшего были
бэгмен: бэгмен
бюро: бюро
бюрократизировать: бюрократизированного
важный: важную важным важные
вверх: вверх
ведьма: ведьмы
великобритания: великобритания
великолепный: великолепные
вервольфов: вервольфов
верить: верить
вернуться: вернуться
вероятный: вероятную
версия: версия версии
верховный: верховного верховный
вести: ведущие ведут
весы: весы
весь: вся
весьма: весьма
вживую: вживую
взрослый: взрослых
взрыв: взрывом
взяток: взятку
взять: возьмут
вид: видов виде
видеть: видит видели видят
видно: видно
визенгамот: визенгамот
визенгамота: визенгамота
визенгамоте: визенгамоте
викиданных: викиданных
викимедиа: викимедиа
википедии: википедии
википедия: википедия
викисклад: викисклад
викискладе: викискладе
викия: викия
вклад: вклад
включать: включает включая
властный: властной
власть: власти властей властью власть
влияние: влияние влиянию
влиятельный: влиятельных
вниз: вниз
вничью: вничью
внутри: внутри
вовлечь: вовлечена
вовремя: вовремя
вовсе: вовсе
водитель: водителей
возвращаться: возвращается
возвращение: возвращение
возвысить: возвышенных
возглавить: возглавил
возглавлять: возглавляет возглавлял
возглавляться: возглавляется
воздух: воздухе
возле: возле
возможно: возможно
возможность: возможности возможность
возродиться: возродился
возрождение: возрождение
войти: вошли войти
волан: волан
волнение: волнения
волшебник: волшебника волшебников волшебник волшебнику волшебники волшебниками волшебникам
волшебница: волшебницы
волшебный: волшебные волшебных волшебного волшебная волшебный волшебным
волшебство: волшебства волшебством
вопрос: вопросы вопросах вопросами
ворот: ворота воротами
воскрешение: воскрешения
воспитывать: воспитывает
воспользоваться: воспользоваться
воспоминание: воспоминания воспоминаниях
восприимчивый: восприимчивыми
восстановить: восстановлены восстановлен
впервые: впервые
вполне: вполне
впоследствии: впоследствии
враг: враги
вращаться: вращающимися вращаться
вред: вред вреда
вредитель: вредителями
временить: времени
временно: временно
время: времена время
все: всех всего всем всеми
всевозможный: всевозможных
вселенная: вселенная
вследствие: вследствие
вслух: вслух
вспомогательный: вспомогательный вспомогательного
встроить: встроено
второй: второй
вход: вход
входить: входят входит
выбор: выбора
выбрать: выбрано
выглядеть: выглядел выглядит
выгравировать: выгравирована
выдаваться: выдаются выдающегося выдавались
выдать: выдать выдан
выделить: выделить
вызвать: вызванные
выйти: вышел
вымыслить: вымышленные вымышленном
вынесение: вынесении
выносить: выносят
вынудить: вынужден
выполнять: выполняющий
выработка: выработкой выработке
высокий: высокая высоким выше
высокопоставленный: высокопоставленные высокопоставленным
вышестоящий: вышестоящего
выявление: выявления выявлением выявление
выясняться: выясняется
гавейн: гавейн
газета: газеты
газопровод: газопровода
гарри: гарри
генеральный: генерального
германий: германии
гермиона: гермиона гермионы
героизм: героизме
гибель: гибели
глава: главе главы глава
главное: главным главных главное
главный: главный
главый: главой
глаз: глаза
гласить: гласит
глубокий: глубже
гоблин: гоблина гоблины гоблинами
говорить: говорит говорил
год: году лет год годами годы года
голосование: голосования
гонение: гонение гонения
гость: гостей гость
государство: государства государствах государств
готовый: готово готовых
гп: гп
грейнджер: грейнджер
гроган: гроган
грогана: грогана
группа: группа группы
давать: давали
даваться: даются
дадли: дадли
далее: далее
далекий: далека
дамблдор: дамблдор
дамблдора: дамблдора
дамблдором: дамблдором
дамблдору: дамблдору
дамболдором: дамболдором
дар: дары
дата: дата
дать: данный данные данное данного дать
два: два двумя
двадцать: двадцати
дверь: дверь дверью двери
двое: двоих
де: де
девиз: девиз
действовать: действующие действовать действующего
декабрь: декабря
декрет: декрет декрета
дело: делу деле делам
дементоров: дементоров
демократический: демократических
демонстрировать: демонстрировала
день: дней дне
департамент: департаменте
держать: держат
деспотический: деспотических
десять: десять
деталь: детали
детская: детская
деть: день дел дело
деятельность: деятельности деятельность
дж: дж
джоркинс: джоркинс
дилогия: дилогия
директор: директору
дисциплинарный: дисциплинарным
дитя: дитя
длинный: длинное длинный длинного
добавить: добавив
добби: добби
док: док
доказывать: доказывает
долгий: долго
должен: должна должен
должность: должности должность
доложить: доложил
долорес: долорес
дом: дом домами домах
дома: дома
домовик: домовик
домовой: домового домовых
доноситься: доносящийся
дополнительный: дополнительные
доска: доску
достаток: достатке
достоверно: достоверно
доступный: доступен
дотронуться: дотронулся
драко: драко
дракон: драконов
древний: древняя
древность: древности
друг: друг другом
другой: другой другие других другого
дурмстранг: дурмстранг
дух: духов
еврейский: еврейский
ежедневный: ежедневный
желать: желая
жестокий: жестокой
жетон: жетоны
живой: жив
жизнь: жизнь
забвение: забвение забвения
забросить: заброшенных
забыть: забыть
зависимый: зависимыми
загадка: загадок
загадочный: загадочная
заглавный: заглавная
заглянуть: заглянув
загробный: загробную
заданный: заданный
задача: задачей
задержать: задержан
заживать: заживают
зайти: зайти
заклинание: заклинания заклинаний заклинание
заключение: заключению
заклятие: заклятий заклятием
заколдованный: заколдованных
заколдовать: заколдовал
закон: законы законов закону закона
законодательный: законодательного законодательной
законодательство: законодательства
закончиться: закончившийся
закрывать: закрывал
закрываться: закрываются
закрытый: закрыта закрыт
зал: залы
зало: зал зала
заманить: заманить
заменить: заменили
заместитель: заместителей заместитель
заметить: замеченного
заметный: заметное
замминистра: замминистра
замысел: замысел
занавес: занавесом занавеса
занимать: занимал занимает занимала занимаемая занимаемый
заниматься: занимается занимающееся занимаются занимающихся
занятие: занятия
занять: занявший занять занял
запереть: запертая
записка: записок
записывать: записывает
запись: запись записи
запрещать: запрещает
зарегистрировать: зарегистрированный
заседание: заседания
засекретить: засекречена
заставлять: заставляя
затем: затем
затронуть: затронуть
защита: защиту
защитить: защищены
защититься: защититься
защитный: защитных
заявление: заявление
зверь: зверей звери
здание: зданий
златопуст: златопуст
знак: знак
знать: знал знают
значительно: значительно
значок: значок
золото: золото
золотой: золотыми золотого золотые
игнорировать: игнорировать
игра: игра игр играм игры
играть: играют
игрок: игроков
избранный: избранной избранные
известно: известно
известный: известных известные известный известная известен
изменение: изменения изменение
изменить: изменить
изображать: изображающих
изобретение: изобретений
изучение: изучением
изъятие: изъятие
именно: именно
иметь: иметь имеет
империуса: империуса
имя: имя
иначе: иначе
иной: иной
иностранный: иностранных иностранные
инстанция: инстанция
инструмент: инструменты
интерес: интереса интересам
информация: информация
информировать: информирует
инцидент: инциденте
ирландский: ирландской
исключение: исключением
исключительно: исключительно
искриться: искрящийся
исполнение: исполнение
исполнительный: исполнительной
исполняться: исполняется
использование: использование использования использованием
использовать: использовать
использоваться: используется использовались
исправить: исправлены
испытательный: испытательный
история: история
источник: источников источники источниками источник
исходный: исходное
исцарапать: исцарапан
исчезать: исчезают
июль: июля
июнь: июня
кабинет: кабинете кабинеты
кадр: кадр
каждый: каждому каждая
кажется: кажется
какой: какая какие какую
каменный: каменной
камень: камень камни
камин: каминами каминов камины камина
кандидатура: кандидатуру
карточный: карточная
карьер: карьеру
касаться: касается касалось
катастрофа: катастроф
катберт: катберт
категория: категории
квартира: квартира
квиддич: квиддич
квиддича: квиддича
квиддичу: квиддичу
кентавр: кентавра кентаврами кентавры
кингсли: кингсли
клавиш: клавиши
классификация: классификации
клуб: клуб
книга: книг книгах книги книге книга
код: код
кодекс: кодекс
колдовство: колдовство колдовства
колдунья: колдуньями колдуньи колдуньям колдуньей
коллекционный: коллекционная
колыхаться: колышущимся
команда: команды
комитет: комитет
комментарий: комментарий
комната: комнате комнат комната комнаты
компетенция: компетенции
компонент: компонентов
конец: конце
конкретный: конкретная
конструктор: конструктор
консультационный: консультационное
контакт: контактов
контролировать: контролировать контролировал
контроль: контролю контроля
конфедерация: конфедерация конфедерацию конфедерации
конфиденциальность: конфиденциальности
конфискация: конфискации
конфисковать: конфискована
копия: копия
коридор: коридора
корнелиус: корнелиус
королевство: королевства
короткий: короткие короткий
коррупция: коррупцией коррупция
который: которым которое которыми которой которого которые которых которая котором который
крауч: крауч
крауча: крауча
критика: критику критика
кроме: кроме
крохотный: крохотном
круг: кругу
круглый: круглого круглая
кто: кем кому
кубок: кубок
кук: куки
курс: курса
ладить: ладят
лата: лат
лафкин: лафкин
левитация: левитации
летать: летать
летний: летней
летучий: летучего
либо: либо
лига: лиги
лидер: лидер
ликвидация: ликвидации
ликвидировать: ликвидировать
лифт: лифтами
лифтовый: лифтов
лицензирование: лицензированию
лицензия: лицензии
лич: лич
лично: лично
личной: личных
лишение: лишениях
лишиться: лишился
лишь: лишь
локация: локации
локонс: локонс
лондон: лондоне лондон
лорд: лорда лорде лорд лордов лорды
любовь: любви любовь
любой: любой
людо: людо
люциус: люциус
маг: магов маги магами
магический: магического магической магические магических магическим магическими магическое
магия: магия магию магии
магл: магл
маглами: маглами
маглов: маглов
магловский: магловский
магловским: магловским
магловского: магловского
маглы: маглы
мадам: мадам
макнейр: макнейр
маленький: мало поменьше
малфой: малфой
марволо: марволо
мардж: мардж
марионетка: марионетку
мариэтта: мариэтты
марта: марта
материал: материал
мафальда: мафальда
маховик: маховики
мая: мая
медиафайлы: медиафайлы
международный: международный международного международная международных международной международное
менее: менее
мера: меры
мероприятие: мероприятий
место: место места
местоположение: местоположение
месторасположение: месторасположение
месяц: месяцев месяца
миллисент: миллисент
миллисента: миллисента
минимум: минимум
министерство: министерства министерство министерством министерстве
министр: министр министры министров министра министру министром
мир: мира мир мире
миссис: миссис
мистер: мистера мистер
младший: младший
мнение: мнения
многие: многие
много: более много
многочисленный: многочисленные
множество: множеством множество множества
мобильный: мобильная
модификация: модификация модификации
можно: можно
мозг: мозг
мозги: мозгами мозгов
мокридж: мокридж
молодой: моложе
момент: момента
монетка: монетки
монумент: монумента
морт: морт
морта: морта
морте: морте
мортом: мортом
морту: морту
мочь: можете могли могут
мощный: мощным
мракоборцев: мракоборцев
мракоборцы: мракоборцы
мунго: мунго
мы: нами
мысль: мыслями мыслей
набрать: набрать
навигация: навигации навигация
над: над
надзор: надзор
надпись: надпись
назад: назад
название: названия
названый: названы
наземникуса: наземникуса
назначать: назначать
назначить: назначен
назойливый: назойливых
называть: называют
называться: называется
наказание: наказания наказание
налаживание: налаживание
налево: налево
наличие: наличию
наложить: наложенного
намного: намного
наоборот: наоборот
нападение: нападения
направляться: направляющихся
направо: направо
например: например
народ: народ народы
нарушение: нарушении нарушений нарушения нарушением
нарушитель: нарушителю
наряд: наряду
настолько: настолько
настоящее: настоящее
насчитывать: насчитывал
находиться: находящихся находится находятся находился
нацистский: нацистский
начало: начало начале начал начала
начальник: начальник
начальство: начальства
начать: начали начать
начаться: началось начался
начинать: начинают
наш: наших
небольшой: небольшим
невыборный: невыборный
невыгодный: невыгодных
невыразимцами: невыразимцами
невыразимцем: невыразимцем
недавно: недавно
недалекий: недалеко
недетский: недетских
недостоверный: недостоверный
нежели: нежели
независимый: независимым
незаинтересованный: незаинтересованным
незаконный: незаконным
незнание: незнание
неизвестно: неизвестно
неизвестный: неизвестен неизвестным неизвестна
некий: некую
некоммерческий: некоммерческой
некоторые: некоторых некоторые
некоторый: некоторое
нельзя: нельзя
немалый: немало
немногие: немногие
немного: немного
необычно: необычно
неоднократно: неоднократно
неопр: неопр
неопровержимый: неопровержимых
неподходящий: неподходящее
неполный: неполный
непоправимый: непоправимо
неправомерный: неправомерным
неправомочный: неправомочного
непреднамеренный: непреднамеренно
нерабочий: нерабочая
несколько: нескольких несколько
несмотря: несмотря
несовершеннолетний: несовершеннолетним несовершеннолетних несовершеннолетними
неуместный: неуместное
нечаянный: нечаянного
нижний: нижнем
низкий: низшие ниже
никакой: никаких
нобби: нобби
новость: новости
новый: новые новому новое
нож: ножом
номер: номер
норрис: норрис
носитель: носителю
ночной: ночной
ноябрь: ноября
нужно: нужно
нужный: нужные нужного нужный
об: об
обветшать: обветшавшими
обвинение: обвинение
оберег: оберегов
обеспечение: обеспечения
обеспечивать: обеспечивая
обитание: обитания
обладать: обладаешь обладает обладающий обладают
обожание: обожанием
образ: образом
образование: образование
образовать: образуя
обратный: обратном обратно
обращение: обращения
обсуждение: обсуждение
общественный: общественные
общий: общие общая общего
объединение: объединение
объединить: объединить
объявление: объявлений
объяснение: объяснения
объясненье: объяснений
объяснить: объяснил
обычно: обычно
обязанность: обязанности обязанностью обязанностей
обязательный: обязательном
огонь: огня
ограничение: ограничении
ограничиваться: ограничивается
огромный: огромным огромное
один: одной одном одного один одно одним
однако: однако
одновременно: одновременно
одобряться: одобряется
ожить: ожили
означать: означает
оказаться: оказалось оказался
оклеить: оклеены
окно: окнами окнах окон
около: около
окончание: окончания
окончательный: окончательного
омут: омут
они: им них ними
оно: оно
оон: оон
опасный: опасных
описание: описание описании
описать: описан описана
описываться: описывается
оправдание: оправданий
определять: определяет
опуститься: опустится
опытный: опытными
орган: органы орган органа органов
организация: организации организация
орден: ордена орден
оригинал: оригинала оригиналом
освободиться: освободился
основание: основании основания
основать: основана
основной: основных основной
основываться: основываются
особый: особая особого
остальное: остальные остальных остальными
осуществить: осуществила
осуществляться: осуществляется
ответственность: ответственности
отвечать: отвечают отвечает
отдел: отдел отделом отдела отделе отделов отделами
отдельный: отдельный отдельных отдельные
отказ: отказ
отказаться: отказался
отказываться: отказывался
открыться: откроется
отлакировать: отлакированным
отличаться: отличаться
относиться: относятся
отпереть: отпереть
отпирать: отпирающим
отправить: отправил
отправиться: отправиться
отправка: отправки
отпускать: отпускают
отражение: отражением
отредактировать: отредактировать отредактирована
отряд: отряд отряде
отсрочивать: отсрочивая
отсутствие: отсутствие
отсутствовать: отсутствует
отчаянно: отчаянно
офис: офис
офисный: офисных
официальный: официальный официального
охрана: охраной охраны
охранник: охранник
очевидно: очевидно
очевидный: очевидный
очень: очень
очередь: очередь
ошибка: ошибке
падение: падения
палата: палате
палач: палач
палочка: палочка палочки
память: памяти память
пара: парой
парить: парят
парк: парк
паркетный: паркетным
парламент: парламента
пародия: пародии
патент: патентов
патронуса: патронуса
первое: первым первого первое
первый: первой первый
перевес: перевесом
перевод: переводе
перевозка: перевозку
перед: перед
передаваться: передаются
перейти: перейти перешло
перемещаться: перемещаться
перенести: перенесли
перерыв: перерывами
переть: при
период: период периоды
периодический: периодически
перкинсом: перкинсом
перси: перси
персонаж: персонажами персонажи персонажей
персонал: персонала персонал
персональный: персональные
петтигрю: петтигрю
петуньи: петуньи
печать: печать печати
пий: пий пия
письмо: письмо письме
питать: питающий
питер: питер
плавать: плавающими
плакат: плакатов
планет: планеты планет
платформа: платформе
плевать: плюй
плохо: плохо
плохой: плохие
побочный: побочные
поведение: поведения
повлиять: повлиять
погиб: погиб
погода: погода
подверженный: подвержена
подвластный: подвластных
поддельный: поддельных
поддержание: поддержание поддержанием
поддерживать: поддерживает
подключаться: подключаться
подмочить: подмочил
поднять: поднял
подобие: подобие
подобный: подобная
подобострастный: подобострастный
подразделение: подразделения подразделений подразделение
подробный: подробнее
подслушать: подслушал
подчас: подчас
подчинение: подчинения подчинение
подчиняться: подчиняющихся
пожаловать: пожалуй
пожертвовать: пожертвовать
пожиратель: пожирателями пожирателям пожирателей пожиратель пожирателем пожиратели
позволить: позволено
позволять: позволяет позволяющих позволяющие
поздний: позже
поиск: поиск поиску
пока: пока
показать: показан
покрыть: покрытая
пол: полом пол
полагать: полагая полагают
политик: политики политика политике
политический: политическому политический политические
полиция: полиции
полностью: полностью
полный: полное полным
положить: положено
полок: полки полках
полтергейст: полтергейстах
полукровка: полукровок полукровка
получать: получает
получение: получении
получить: получил получивший получить
пользоваться: пользоваться
помещение: помещение
помимо: помимо
помощник: помощником
помощь: помощью помощи
помфри: помфри
понятие: понятию
понять: понять
попасть: попал попасть
популярный: популярного
популяция: популяций
порох: пороха
портал: портал
портальный: портальное
портрет: портрет
порядок: порядка
посетитель: посетителей посетителя посетители посетитель
посещать: посещает посещал
посещение: посещении
послать: послана
последний: последняя последний последних последнем последней
последователь: последователей
последствие: последствий последствия
пособничество: пособничестве
посол: после
посреди: посреди
посредство: посредством
пост: посты пост
постановление: постановление
постепенно: постепенно
постоянный: постоянная
пострадать: пострадал
поступать: поступает
потолок: потолке потолком
поттер: поттером поттер поттера поттеру поттере
поттеромания: поттеромания
похожий: похожего
поэтому: поэтому
появиться: появились появившийся
появление: появление
появляться: появляются
правительство: правительств
править: правило править правил
правка: правки
правопорядок: правопорядка
правосудие: правосудия
правота: правоту
правый: права правом право
практик: практика
практический: практически
превосходство: превосходство
превращаться: превращался
предварительно: предварительно
предлагать: предлагали
предложение: предложений
предмет: предметов предметы предметам
предположение: предположению
предположительно: предположительно
предположить: предположить
предпочитать: предпочитая предпочитают
предпринимать: предпринимает
предпринять: предприняты
председатель: председатель
предсказание: предсказанием предсказание
представиться: представиться представились
представлять: представляя представляющая представляет представляли
представляться: представляется
предубеждение: предубеждениях
предупредительный: предупредительное
предупреждение: предупреждением
предыдущий: предыдущих
предыстория: предыстория
преемственность: преемственности
президент: президентом президент президента
премьер: премьер
преследовать: преследует
пресс: прессы
престижный: престижным
преступление: преступление преступления
преступник: преступников
прибавка: прибавки
прибор: прибора
прибытие: прибытия прибытии
прибыть: прибывшие
привести: привести
привлечение: привлечение
приводиться: приводится
приговаривать: приговаривали
приговор: приговора приговоры
призвать: призванным
признать: признать
применение: применения применением применении
применить: применил применила
применять: применяет
применяться: применялось
примечание: примечания
принадлежать: принадлежавшие
приниженно: приниженно
принц: принц
принцип: принципов принципы
принятие: принятие
принять: принять
природа: природы
присутствие: присутствии
присутствовать: присутствовать присутствовали
притесняться: притеснялись
приход: приходом
проблема: проблему проблем проблемах
пробраться: пробраться
проведение: проведения
проверить: проверенной проверит
проверка: проверки
проверять: проверяема
проверяться: проверяется проверялась
провести: проведены
проект: проектах
произвести: произвести
производиться: производиться
производство: производство
произнести: произнести
произноситься: произносится
происходить: происходили происходящие
происхождение: происхождения
происшествие: происшествий происшествиям
пройти: пройти
проклясть: проклятое
промежуток: промежуток
проработать: проработав
пророк: пророк
пророчество: пророчество пророчества пророчеств
просмотр: просмотры
пространство: пространства
против: против
противоречить: противоречит
противостояние: противостояние
протяжение: протяжении
профессор: профессор профессору
проходить: проходят
прохождение: прохождения
процесс: процессы процесс
прочий: прочее
прочить: прочили
прошлый: прошлом прошлое
проявление: проявления
проявлять: проявляют
прут: прута
прямоугольный: прямоугольная прямоугольное
пудинг: пудингу
путеводитель: путеводитель
путь: пути
пыльный: пыльные
пытаться: пытаются пытался
пьер: пьером
пята: пятой
пятый: пятого
работа: работой работа работу
работать: работал работали работает работающих работать
раз: разу раза
разбиваться: разбивается
разбирательство: разбирательства
разбираться: разбирается разбиралось
разбить: разбиты разбито
разбиться: разбилось
разгадка: разгадкой
раздавать: раздавал
раздел: разделами разделе
разделение: разделение
раздуть: раздул
различный: различными различные различных
размагичиванию: размагичиванию
разница: разницей
разнообразный: разнообразные
разработчик: разработчики
разрешаться: разрешалось
разрушить: разрушен
разум: разум
разумный: разумном разумными
район: районах
рана: раны
ранг: рангу
ранее: ранее
ранение: ранения
раса: расе
расизм: расизма
раскрываться: раскрывается
раскрыть: раскрыть
расположить: расположенный расположена расположен расположены расположено
распределение: распределения
распределять: распределяющая
распространение: распространение
рассказ: рассказы
рассказывать: рассказывая
расследование: расследование
рассматривать: рассматривали рассматривать
рассматриваться: рассматриваться рассматриваются
рассмотреть: рассмотреть
раствор: раствором
расщеп: расщеп
реальность: реальности
реальный: реального реальных
ребенок: детей
регистрация: регистрация регистрации
регламентировать: регламентирует
регулирование: регулирование регулирования
реддл: реддл
реддлу: реддлу
режим: режима режим
результат: результате
рейдовый: рейдов
рекомендация: рекомендации
религиозный: религиозные
репутация: репутацию
решать: решают решаемых
решение: решении
решить: решили решил
рисковать: рискуя
робардс: робардс
родитель: родителям
рождение: рождения
розыск: розыску
роль: роль роли
роман: романов романа романах
рон: рону рон
роулинг: роулинг
рубеус: рубеус
рука: рук руки
руквуд: руквуд
руководитель: руководителя
руководить: руководящие руководящих руководящий
русский: русский
руфус: руфус
руфуса: руфуса
руфусом: руфусом
рыцарь: рыцарь
ряд: рядом рядами
сажать: сажали
сайт: сайте
сам: самого самом самих сами самое само
самый: самый самая самым
сантиметр: см
саундтрек: саундтрек
сбивать: сбивая
сбыться: сбудется
сведение: сведения
свежий: свежие
свидетель: свидетелями
свободный: свободной
свое: своих свои своего своим
своеобразный: своеобразной
свой: своей свою
свойство: свойствам
связанный: связанные связанных связанному связанными связаны
связаться: свяжитесь
связываться: связывались
связь: связи связям связь
святой: святого
сделать: сделанные сделала сделано сделана
себя: собой
северус: северус
седьмой: седьмой
секретарить: секретаря
секретность: секретности
сектор: сектора сектор сектором
семейство: семейств
сериал: сериал
серия: серии серию серия
сеть: сеть сети
сивилла: сивилла
сидеть: сидящие сидящих
сила: силой сила сил силы силе
сильный: сильно
символ: символы
синий: синем
сиреневый: сиреневой
сириус: сириус сириусом
система: системе системы
ситуация: ситуациях ситуация ситуации
сказка: сказки
скачать: скачать
скорый: скорее
скримджер: скримджер
скримджера: скримджера
скримджером: скримджером
скрывать: скрывать
скрытие: скрытие
скрытый: скрытые
скрыть: скрыть
скульптура: скульптурой
следующий: следующих следующие
слово: словам
сломать: сломана
служащий: служащие
служба: службы
служебный: служебных служебные
служить: служить
случай: случае случаях случаев случаи
случайно: случайно
случайный: случайная случайным случайного
слушание: слушаниях слушанием слушания слушание
слышать: слышать
сменить: сменил
смерть: смерть смерти
сместить: сместили
смотреть: смотрите смотрят
смочь: смог
смывание: смывания
снегг: снегг
снизу: снизу
снимать: снимать
сниматься: снимается
сниться: снилась
сноска: сносок
снять: снят снять
собираться: собиралась собираются
соблюдение: соблюдения
собор: соборе
собрание: собранием собраниях
собрать: собрать
собственный: собственное
событие: события событий событиях
сова: совы
совершение: совершение
совершить: совершив
совет: совет
содержание: содержание
содружество: содружества содружество
создание: созданий
создать: создана созданное создан созданным создать
сокровище: сокровищ
солнечный: солнечной
сообщаться: сообщается
сообщение: сообщение
сообщество: сообщество сообщества сообществом
сообщить: сообщить
соответствующий: соответствующие соответствующая
состав: состав составом
состояние: состояние
состоять: состоит
сосуд: сосуд
сотня: сотни
сотрудник: сотрудники сотрудникам сотрудников сотрудниками
сотрудничество: сотрудничества сотрудничеству
сохранение: сохранением
социальный: социального
спас: спас
спасительный: спасительной
специальный: специального специальный специальные специально
список: список
спора: споры
спорт: спорта
спортивный: спортивных
способ: способами
способность: способности
справка: справка
спэвин: спэвин
сражаться: сражался сражаться
сражение: сражения
сразу: сразу
среди: среди
средство: средств
српски: српски
српскохрватски: српскохрватски
ссылка: ссылка ссылками ссылки ссылок
ставиться: ставились
стажировка: стажировки
сталкиваться: сталкивается
стамп: стамп
стампа: стампа
стандарт: стандартов
становиться: становится
старший: старшего старший
статистика: статистика
статут: статут статута
статуя: статуей статуями статуя статуи
стать: стал ставших стали
статья: статью статья статьи
стеклянный: стеклянные
стеллаж: стеллажей
стен: стены стенами
степень: степень степени степенью
стереть: стереть
стирателей: стирателей
стиратели: стиратели
стирателями: стирателями
стол: стол
сторонник: сторонники
страна: страна стран
страница: страницы страница страницу странице
страсть: страсть
стремиться: стремятся
структура: структуре структура
студент: студентами
ступенька: ступеньки
суд: суд
судебный: судебная судебные судебной судебного
судить: судили
судно: суда
существенный: существенное
существо: существ существа существами
существовать: существует
сфера: сфера сферы
сфинкс: сфинкса
сходить: сходят
схожий: схож
считать: считая
сын: сын сыном
сюда: сюда
сюжет: сюжете
табличка: табличка
тайна: тайну тайн
тайный: тайная
также: также
такой: такой такое таким такая таком таких такие
талант: таланта
текст: текст
текущий: текущие текущая
телефонный: телефонная
тело: тел
тем: тем
тематический: тематический
тереть: три
техник: техника
тип: типам
товарный: товарный
толстоватый: толстоватого толстоватый
торговый: торговых
тот: том тех те тот тому той
точный: точное точный точная
трансгрессионый: трансгрессионый
трансгрессировать: трансгрессировать
трансгрессия: трансгрессии
транспорт: транспорта транспортом
транспортный: транспортных
требовать: требует требуют
трелони: трелони
третий: третьей
трещина: трещинами
трое: трое
трон: тронах
туалет: туалеты
туда: туда
турнир: турнир турнира
тусклый: тускло
тюремный: тюремному
тюрьма: тюрьму тюрьмы
убедительный: убедительно
убивать: убивали
убийство: убийства
убить: убил убить убит
уведомление: уведомления
уверять: уверяя
увидеть: увиденные увидеть
уволить: уволить
удаленный: удалена удалены
удаться: удалось удался
удивляться: удивлялся
ужасный: ужасная
узнать: узнав
узник: узник
уизли: уизли
указание: указанием
указать: указан указать
украсить: украшенный
улика: улик
улица: улице улицу
ум: ума
уметь: умеющих
уничтожение: уничтожению
уничтожить: уничтожена
уолден: уолден
упасть: упав
упоминать: упоминает
упоминаться: упоминалась упоминался упоминается
упомянуть: упомянутые упомянула
упорный: упорно
управление: управления управление управлении управлением
управлять: управляет
ураган: ураганов
уровень: уровень уровней уровня уровням
урок: уроки
условие: условий условия
услышать: услышать
успеть: успели
успешный: успешно
уставить: уставленное
устанавливать: устанавливает
установить: установленными
установка: установку
установление: установление
устранение: устранение
устраняться: устраняется
утерять: утеряно
участие: участие
участник: участниками
фадж: фадж
факт: факт
фантастический: фантастические
фашизм: фашизма
фашистский: фашистский
феникс: феникса
филиал: филиал
философский: философский
фильм: фильму фильм фильме фильмов фильма
финальный: финальной
флетчера: флетчера
фонд: фонд
фонтан: фонтана фонтан
форум: форум
фраза: фраза
функционирование: функционирования
функция: функцию
фэрис: фэрис
хагрид: хагрид
характер: характеру
характерный: характерно
хватать: хватает
хобби: хобби
хогвартс: хогвартс
хогвартса: хогвартса
хогвартсе: хогвартсе
хозяйство: хозяйства
холл: холл
холокост: холокост
хотеть: хотят
хранитель: хранитель
хранить: хранит
храниться: хранится хранятся хранилась
хрустальный: хрустальный
целовать: целую
целый: целей целом
цель: цель целью цели
центр: центре центр
циркулировать: циркулирует
цитировать: цитировать
чародей: чародея чародей
частить: части
частность: частности
часто: часто
часы: часы
чат: чат
человек: человек люди
человечек: человечек
человеческий: человеческий
чемпионат: чемпионат чемпионате
через: через
чин: чинам
чиновник: чиновников чиновники
чистокровный: чистокровные чистокровных
читать: читать
член: членов члены членами
чрезвычайный: чрезвычайных
чтобы: чтобы
чудесный: чудесная
шаблон: шаблона
шармбатон: шармбатон
шестая: шестой
шестнадцать: шестнадцать
школа: школа школы
шляпа: шляпа
шпион: шпион
штаб: штаб
штат: штат
шутка: шутки
эджком: эджком
эквивалент: эквивалента
экранизация: экранизации
элемент: элемент
эльф: эльфа эльф эльфов
энциклопедия: энциклопедии
этаж: этаже
это: этом это этим
этот: этой этих эта эту
эффект: эффекты
явиться: явиться
являться: являться является являющимися являются
язык: язык языках
яксли: яксли
яма: ямы
ясный: ясна
