автор: автор
авторитетный: авторитетные
авторство: авторства
азкабана: азкабана
алфавит: алфавиту
альбус: альбус
альбуса: альбуса
альбусом: альбусом
англ: англ
английский: английский английского английском
артефакт: артефактов
атака: атаку
б: б
барда: барда
беда: бед
бежать: бегущая
беларуская: беларуская
белизна: белизна
белла: белл
беллатриссе: беллатриссе
библиографический: библиографических
бидля: бидля
блэк: блэк
блэка: блэка
больший: больших
бороться: борется
бояться: боясь боится
брат: братья
браун: браун
британский: британский
бросаться: бросается
буйствовать: буйствовать
буквальный: буквально
български: български
бэрк: бэрк
бэркс: бэркс
важный: важном важными важное
вакансия: вакансия
вариант: вариант
везучесть: везучесть
великобритания: великобритании
вендетта: вендетты
версия: версия версии
вещь: вещи
взять: взять
вид: виде
викиданных: викиданных
викимедиа: викимедиа
википедии: википедии
википедия: википедия
викисклад: викисклад
викискладе: викискладе
вино: вину
вклад: вклад
владелец: владельца
власть: власти
вместе: вместе
внезапно: внезапно
внешний: внешние
вовсе: вовсе
воды: воды
возвращаться: возвращаться возвращаясь
возвращение: возвращение
возможно: возможно
возможный: возможных
война: войне война
войти: войти
волан: волан
волшебник: волшебников волшебнике
волшебный: волшебные волшебный
ворот: воротах
воспоминание: воспоминание воспоминания
вратарь: вратаря
время: временем время
все: всем
встреча: встречу встречи
встречать: встречает
встречаться: встречается
второй: вторая
входить: входят
выигрывать: выигрывает
выйти: вышло вышла
вынудить: вынужден
выпить: выпить
выполнить: выполнить
выходить: выходя
выяснить: выяснить
выяснять: выясняет
гарри: гарри
гермиона: гермиона гермионой
героизм: героизме
герой: героев
главное: главного
глаз: глазах
год: году год годы года
гораций: гораций горацием
горбина: горбин
гостиная: гостиной
грейнджер: грейнджер
гриммо: гриммо
гриффиндор: гриффиндор
грозить: грозит
дамблдор: дамблдор
дамблдора: дамблдора
дамблдором: дамблдором
дамблдору: дамблдору
дар: дары
дата: дата
два: двумя
де: де
действие: действия
действовать: действовать
декабрь: декабря
делать: делает
день: дней
деть: день дело дела
дж: дж
джинни: джинни
джоан: джоан
джордж: джордж
дикий: дико
дилогия: дилогия
директор: директору директора
дитя: дитя
дневник: дневник
добиваться: добивается
доверие: доверие
довершить: довершить
договариваться: договаривается
док: док
доказательство: доказательств
должен: должна
должность: должность
доложить: доложить
дом: дом домам
домовик: домовиком
дополнительный: дополнительные
достать: достать
достаться: доставшаяся
доступный: доступен
драко: драко
древность: древности
друг: друг другу
другой: другой другие других
дурмстранг: дурмстранг
дурной: дурная
дурслей: дурслей
духом: духом
душ: душу души
дуэль: дуэль
жанр: жанр
желательно: желательно
желать: желает
жестокость: жестокости
живой: живых
завязываться: завязывается
загадка: загадкой
загадочный: загадочного загадочном
заглавный: заглавная
задание: задание
задумать: задумал
заклинание: заклинанием заклинаний
заключить: заключить
заклятие: заклятий заклятиями
замечать: замечает
запись: запись
запрос: запрос
зарегистрировать: зарегистрированный
заставить: заставив
заставлять: заставляет
защита: защиты
защитить: защитить
защитный: защитных
заявление: заявление
зверь: звери
зелье: зелье зелья
зельеварение: зельеварение
зельеварении: зельеварении
зельеварению: зельеварению
зельеварения: зельеварения
зельеваром: зельеваром
зло: зла
злодей: злодея
змея: змея
знак: знак
знать: знать знают
значение: значения
значительно: значительно
зов: зов
зомби: зомби
игра: игра игры
играть: играет играющая
избранный: избранные
издание: издания издание
издат: издат
издательство: издательство
изменить: изменив
изобретатель: изобретателем
изъять: изъяв
икабог: икабог
именно: именно
иметь: имеет
имя: имени
инструмент: инструменты
инферналами: инферналами
инферналы: инферналы
исключить: исключите
искусство: искусств
использование: использования
исправить: исправить
исправление: исправления
испытать: испытал
истерящим: истерящим
история: историю история
источник: источников источники источник
июль: июля
какой: какая какое
камень: камень
кандиды: кандиды
картина: картина
карточный: карточная
каталог: каталогах
категория: категории
квиддич: квиддич
квиддичу: квиддичу
кикимером: кикимером
клуб: клуб
ключ: ключ
клятва: клятву
книга: книги книге книга
когтевран: когтевран
код: код
кодекс: кодекс
колдунья: колдунья
коллекционный: коллекционная
кольцо: кольцо
команда: команде
комната: комната
конструктор: конструктор
конфиденциальность: конфиденциальности
корморане: корморане
короткий: короткие короткий
который: которое которой которые который
крайне: крайне
крестраж: крестраж
крестражах: крестражах
крестражей: крестражей
крестражи: крестражи
кровь: кровь
кубок: кубок
куда: куда
кук: куки
кукушка: кукушки
купе: купе
курс: курсе
кусок: кусок
куча: кучу
кыргызча: кыргызча
кэти: кэти
кэтлин: кэтлин
лаборатория: лаборатория
лаванда: лавандой лаванды
лестрейндж: лестрейндж
лето: летом
литературный: литературные литературное
лицензия: лицензии
лишение: лишениях
ловить: ловит
локация: локации
ломать: ломает
лорд: лорда
м: м
маг: магов
магазин: магазине магазина
магический: магического магические магическом
магия: магия магии
магл: магл
маглы: маглы
македонский: македонски
малфоем: малфоем
малфой: малфой
малфоя: малфоя
мантия: мантии
материал: материал
матч: матча матче
мать: мать
медальон: медальон
медиафайлы: медиафайлы
медовуха: медовухой
место: место места
министерство: министерство
министр: министр министра
минувший: минувшим
мир: мира мир мире
миссис: миссис
много: более
мобильный: мобильная
могила: могила
можно: можно
молодой: молодому
момент: момент
монгол: монгол
моральный: морального
морт: морт
морта: морта
морте: морте
мортом: мортом
морту: морту
мотивация: мотивацию
мочь: могут
мраксов: мраксов
мука: муки
мы: нами
набор: наборы
навигация: навигации навигация
навсегда: навсегда
нагайна: нагайна
над: над
назойливый: назойливых
наиболее: наиболее
найти: найти
наколдовать: наколдовав
нанести: нанести
нападать: нападают нападающие
нападение: нападения
наперекор: наперекор
написать: написанное
направляться: направляется
нарволо: нарволо
нарцисс: нарцисса
насылать: насылает
натворить: натворил
находить: находит
начало: начале
начаться: началась
начинать: начинают
наш: наших
невидимка: невидимки
недостаток: недостатков недостатки
недостоверный: недостоверный
независимый: независимые
некий: некое некоего
некогда: некогда
некоммерческий: некоммерческой
некорректный: некорректные
некоторые: некоторых
некто: некто
ненавидеть: ненавидевший
ненавистный: ненавистный
необычайный: необычайной
неожиданный: неожиданные
неполный: неполный
неприятный: неприятного
несколько: несколько
нимфадора: нимфадора
новый: нового новым новые
норрис: норрис
нос: нос
нужно: нужно
об: об
обездвиженный: обездвиженному
обездвиживает: обездвиживает
обезоруживать: обезоруживает
обет: обет
обитание: обитания
обложка: обложка
обнаруживать: обнаруживают
обнаружить: обнаружил
обратный: обратное
обращаться: обращается
обсуждение: обсуждение
обучение: обучения обучение
общество: обществе
объяснить: объяснив
огонь: огонь огня
один: один одно
однако: однако
однокашник: однокашников
ожерелье: ожерелья
озеро: озера
оказаться: оказалось
оказываться: оказывается
октябрь: октября
он: нему
онлайн: онлайн
опасный: опасных опасные
описание: описание
описываться: описывается
опустошить: опустошив
опытный: опытными
организация: организации
организовать: организует
орден: ордена орден
оригинал: оригинала
оставлять: оставлял
остаться: осталось остаться
осуществить: осуществить
отбить: отбить
ответственность: ответственности
отговаривать: отговаривает
отдельный: отдельных отдельные
отец: отец
отказ: отказ
открываться: открывается
отличаться: отличаться
отношение: отношения отношений
отправляться: отправляются отправляется
отравляться: отравляется
отражать: отражает
отредактировать: отредактирована
отряд: отряд
отстранять: отстраняет
отступить: отступить
отчаянно: отчаянно
оформить: оформить
оформление: оформлении
очень: очень
ошибка: ошибке ошибку
падать: падает
парализовать: парализует
парень: парень
парк: парк
пародия: пародии
пенелопа: пенелопы
первое: первого
первый: первой
перед: перед
передать: передать
перейти: перейти
перенаправляться: перенаправляется
переть: при
персонаж: персонажи
персонал: персонал
персональный: персональные
печать: печати
пещера: пещеру
пить: пить
план: планы плане
планировать: планировав
площадь: площади
победа: победе
побеждать: побеждает
поведение: поведения
повышать: повышающее
погибать: погибает
погибнуть: погибшему
подделать: подделал
подписать: подписана
подробный: подробнее
подросток: подростке
подслушать: подслушал
подтверждать: подтверждающие
подумывать: подумывает
пожалуйста: пожалуйста
пожертвовать: пожертвовать
пожиратель: пожирателями пожиратели
позиция: позиции
поиск: поиск поиску
поить: поить
пойти: пойти
пока: пока
показать: показать
покидать: покидает
покойный: покойного
покончить: покончить
покров: покровом
политик: политика политике
полтергейст: полтергейстах
полукровка: полукровкой полукровки полукровка
получаться: получается
получить: получить
пометка: пометки пометкам пометок пометками
помешать: помешал
помочь: помочь
помощь: помощи помощь
понимать: понимает
попадать: попадает
портал: портал
поручение: поручение
последний: последний последним
посол: после
посреди: посреди
постепенно: постепенно
постоянный: постоянная
построить: построить
поттер: поттер поттера поттеру поттере
поцеловаться: поцеловавшись
появление: появлении
правда: правду
правило: правилам
править: править
правка: правка правки
превращать: превращает
предмет: предметы
предназначить: предназначенной
предполагать: предполагает предполагаемым
представиться: представились
предупреждать: предупреждает
предыдущий: предыдущее
предыстория: предыстория
прежний: прежнего
презрительный: презрительного
прекрасно: прекрасно
премьер: премьер
преподаватель: преподавателя
преподавать: преподавать
прибыть: прибыли
признать: признать
признаться: признавшись признаются
прийти: пришедший
принц: принца принц принцем
приспешник: приспешники
приходить: приходит
причастный: причастен
причина: причины
причинять: причиняющее
проблема: проблемы проблемами
пробовать: пробует
проболтаться: проболтался
проверить: проверенной проверить
проверка: проверки
проверяться: проверялась
продавать: продавать
продавец: продавцом
продолжать: продолжая продолжать
продолжаться: продолжаются
проект: проектах
произведение: произведения произведение
производство: производство
происходить: происходят происходящих
происшествие: происшествий
проклясть: проклятое
проникать: проникает
пророчество: пророчество
просмотр: просмотры
пространство: пространства
просьба: просьбой
противный: противном
профессор: профессора профессор
прочий: прочее
публикация: публикации
путеводитель: путеводитель
путь: пути
пуффендуй: пуффендуй
пытаться: пытается пытаясь
р: р
работать: работает
ради: ради
разнос: разнос
разозлить: разозлить
разработчик: разработчики
разругаться: разругаться
разрывать: разрывает
разъезжаться: разъезжаются
ранить: ранит
раскаяться: раскаялся
распределять: распределяющая
рассказ: рассказы
рассказывать: рассказывает
расследование: расследование
расти: растут
ревновать: ревнует
реддл: реддл
реддлу: реддлу
результат: результате
религиозный: религиозные
реликвия: реликвия
ресурс: ресурсы
решать: решает
решающий: решающий решающего
решить: решивший
родитель: родителям
рождественский: рождественский
роман: романов романы
рон: роном рона рон
росмэн: росмэн
роулинг: роулинг
рубеус: рубеус
рука: руке руки
русский: русское русский
руфуса: руфуса
ручной: ручная
сайт: сайты
салазара: салазара
сам: самим
самый: самым
сантиметр: см
саундтрек: саундтрек
сбегать: сбегают
сведение: сведения
свежий: свежие
свободный: свободной
свое: свои своего
своеобразный: своеобразными
свой: свой своей свою
связанный: связанные
связаться: свяжитесь
северус: северус
северуса: северуса
секстумсемпра: секстумсемпра
семья: семьи
сердце: сердце
серебряный: серебряного
сериал: сериал
серия: серии серию серия
сивилла: сивиллы
сила: силой силами силы
сириус: сириуса
система: системе
сказка: сказки
скачать: скачать
скорбеть: скорбит
скримджера: скримджера
скрывать: скрывал
скрываться: скрывался
скрытый: скрытые
следить: следит следя
следовать: следуя
следующий: следующий следующее
слизень: слизней
слизерина: слизерина
слизнорт: слизнорт
слизнортом: слизнортом
словарь: словари
служба: службе
служебный: служебные
случай: случае случаях
случайно: случайно
случайный: случайная
случиться: случившимся
смертельный: смертельная
смерть: смерть смерти
снегг: снегг
снегга: снегга
снитч: снитч
сноска: сносок
собственность: собственность
собственный: собственного
событие: события событиях
совершить: совершить
совпадение: совпадению
согласно: согласно
содержание: содержание
создание: создания
создать: создать
сообщать: сообщает
сообщество: сообщество
сообщить: сообщить
сохранение: сохранением
спасать: спасает
список: списка список
спора: споры
способный: способен
справиться: справится
справка: справка
спрятать: спрятан
среди: среди
српски: српски
српскохрватски: српскохрватски
ссылка: ссылка ссылки ссылок
становиться: становятся
статистика: статистика
статья: статью статья статьи
стилистический: стилистическим стилистически
страйке: страйке
страница: страницы страница страницу странице
страшный: страшную
существо: существа
существовать: существуют
считать: считать
сын: сына
сюда: сюда
сюжет: сюжет
тайный: тайная
также: также
текст: текст
текущий: текущие текущая
тело: тела
тем: тем
тематический: тематический тематические
термин: термина
территория: территории
террор: терроре
тип: тип
тобиас: тобиас
товарный: товарный
тонкс: тонкс
тот: том тот тому
требовать: требует требовал
трелони: трелони
трудный: трудно
туалет: туалете
туда: туда
тщательно: тщательно
тщеславный: тщеславным
убивать: убивая
убийство: убийство
убить: убить
увечье: увечье
удалить: удалите
удар: удар
удача: удачи
ужасно: ужасно
ужасный: ужасные
узник: узник
уизли: уизли
указание: указанием
украсть: украл
улучшение: улучшения
унаследовать: унаследовал
уничтожить: уничтожил уничтожен
урод: урода
урок: уроки
условие: условий условия
успевать: успевает
успех: успехи успехов
устраивать: устраивает
устранить: устранены
утверждать: утверждая утверждал
участие: участие
участник: участниками
учебник: учебник учебника учебнике
учебный: учебного
ученик: учениками ученики ученика
фальшивка: фальшивка
фантастика: фантастики
фантастический: фантастические
февраль: февраля
феликс: феликс
фелицис: фелицис
феникс: феникса
философский: философский
фильм: фильм фильмов
фонд: фонд
форум: форум
фред: фред
фэнтези: фэнтези
хагрид: хагрид
хобби: хобби
хогвартс: хогвартс
хогвартса: хогвартса
хогвартсе: хогвартсе
ход: ходу ходе
хозяин: хозяином
хоронить: хоронят
хороший: лучшие
хотеть: хочет
цикл: цикл
цитировать: цитировать
частное: частные
чаша: чаша чашу чаши
человек: человека
чемпионат: чемпионат
чернильный: чернильно
число: числе
читать: читать
чрезвычайный: чрезвычайных
чтобы: чтобы
чувство: чувствах
чудовище: чудовище
чуть: чуть
шаблон: шаблонами шаблон
шаг: шаг
шармбатон: шармбатон
швыряться: швыряясь
шелкопряд: шелкопряд
шестая: шестая шестой
широкий: широкая
шишка: шишками
школа: школа школу школе школы
шляпа: шляпа
шпионить: шпионя
эйлин: эйлин
экранизация: экранизация
элемент: элемент
энциклопедия: энциклопедии
это: это этому этим
этот: этой эта
язык: язык языках языка языке
