абевега: абевега
аблаутная: аблаутная
август: август августа
авель: авель
авт: авт
автор: автором
автореф: автореф
авторский: авторские
авторство: авторства
агенцтва: агенцтва
агрессивный: агрессивно агрессивными
адамов: адамовой
азбука: азбука
академический: академический
академия: академии академия
активизироваться: активизируются
активность: активность
актуальный: актуальные
алатырь: алатырь
александр: александра александр
алексеевский: алексеевский
алексей: алексея
аленький: аленький
алконост: алконост
алтайский: алтайской
алфавит: алфавиту
альманах: альманах
амбарник: амбарник
амирит: амирит
ан: ан
анализ: анализ
аналог: аналогом
анатолия: анатолий анатолия
ангел: ангелы
англ: англ
анджей: анджея
анекдот: анекдоту
анекдотический: анекдотическим
антон: антонов
антропогонические: антропогонические
антропология: антропологии
антропоморфизм: антропоморфизма
апостол: апостол
апрель: апреля
аргумент: аргумент аргументы
артыкул: артыкул
арх: арх
архангел: архангел
архангельский: архангельская
архетипическое: архетипическое
архивировать: архивированная архивировано
архивный: архивная
асилки: асилки
аспект: аспектах аспект аспекты
аста: аст
астрель: астрель
астропринт: астропринт
атмосферный: атмосферные
афанасьев: афанасьева
афанасьевский: афанасьевский
ахметгалиев: ахметгалиева
б: б
баба: баба
бабай: бабай
бабка: бабка бабки
балет: балет балета
балка: балку
балтийский: балтийского
балто: балто
банник: банник
банный: банный
баня: бане
баранниковские: баранниковские
барковский: барковская
барнаул: барнаул
башмачок: башмачки
баюн: баюн
бдпу: бдпу
бегать: бегают бегать бегает
беда: беду беде
безвредный: безвредны
безобразный: безобразная безобразных безобразную безобразной
беларускага: беларускага
беларускае: беларускае
беларускай: беларускай
беларуская: беларуская
беларусь: беларусь
беловодье: беловодье
белозерский: белозерском
белорус: белорусами белорусов белорусы
белоруссия: белоруссии
белорусский: белорусская белорусской белорусский
белый: бел белого белой
бендил: бендил
берегиня: берегиня
беременность: беременности
бес: бесы бесах бес
бесовский: бесовские бесовское
беспорядок: беспорядка
беспричинный: беспричинными беспричинный
бессмертный: бессмертном бессмертный
бестиарий: бестиарий
бесформенный: бесформенным
бесчинство: бесчинства
библиотека: библиотека
бигдай: бигдай
билибин: билибин
битый: битые
бить: била
блестеть: блестящие
близкие: близкие
близкий: близкой
блуд: блуд
блуждать: блуждать блуждающие
бог: бога богов бог богом боги
богинка: богинка
богиня: богини
богородица: богородицы богородица
божественность: божественность
божественный: божественный
божество: божества божеством
божий: божьих
божич: божич
болг: болг
болезный: болезней
болезнь: болезни
болотник: болотник
болотница: болотница
болотницей: болотницей
болотное: болотные болотными болотным
болотный: болотной болотный болотная
болото: болото
больший: большей больше
большинство: большинстве большинства
большой: большой
боровит: боровит
борьба: борьбы
бояться: боятся боится боялись
бранный: бранным
брать: брали
бренд: бренда
брендировании: брендировании
брест: брест
брестский: брестский
брокгауза: брокгауза
брус: бруса
брянск: брянск
брянский: брянского
будущее: будущим
бук: бука
бутылка: бутылке бутылки
буян: буян
български: български
бывальщина: бывальщины бывальщин
бывать: бывает
бык: быка
быличек: быличек
быличка: быличка
быличке: быличке
былички: былички
быль: былях
быстро: быстро
быстрый: быстрых
бысть: бысть
бытование: бытования
быть: будешь будем были
важный: важное
вайсброта: вайсброта
вампир: вампир
ванда: ванда
вариант: вариантов
варить: варит
василий: василия
василиса: василиса
василиск: василиск
ваш: ваша
вв: вв
ввыспрь: ввыспрь
ведовской: ведовским
ведогонь: ведогонь
ведун: ведуна ведун
ведьма: ведьмами ведьма ведьмой
ведьмак: ведьмаке ведьмак
везде: везде
век: века веков веке век
велес: велес
великан: великан
великий: великий
великорусский: великорусского
великъ: великъ
велми: велми
вельтмана: вельтмана
вепс: вепсов
вепсский: вепсском
вера: веры
верблюжий: верблюжью
веретено: веретено
верлиока: верлиока
верный: верны
верование: верований верованиях верования
вероятно: вероятно
вероятный: вероятную
версия: версия версии версий
вертеться: вертелся
верхневолжья: верхневолжья
вести: вести
вестник: вестник
весть: вестей
весь: вся
ветер: ветром ветер ветры
веточка: веточек
вечер: вечера
вечорка: вечорка
вештица: вештица
вещественный: вещественных
вещица: вещицы
вещь: вещи
взаимный: взаимным
взаимоотношение: взаимоотношения
взгляд: взгляда
взрослый: взрослых взрослым
взывать: взывает
взять: возьмите
вид: видом виду вид виде
видеть: видеть видели видь
видимость: видимости
видимый: видимому
видный: видную
визионер: визионер
вика: вики
викиданных: викиданных
викимедиа: викимедиа
викиновости: викиновости
википедии: википедии
википедия: википедия
викисклад: викисклад
викискладе: викискладе
викисловаре: викисловаре
викисловарь: викисловарь
викитека: викитека
викитеке: викитеке
викитеку: викитеку
вильворг: вильворг
вильгельм: вильгельма
вильно: вильна
вино: вино
виноградов: виноградова
винокуров: винокурова
витебский: витебской витебская
вить: вила
вихрь: вихрь
вклад: вклад
владимир: владимира владимиров
власов: власова власовой
влияние: влиянием
вместе: вместе
внезаапу: внезаапу
внезапно: внезапно
внешний: внешний
внимание: внимание
вносить: вносить
вод: вода воду воде
вода: водой
воды: воды
водяной: водяной
воздействие: воздействием воздействию воздействия
воздусь: воздусь
воздух: воздуху
воззрение: воззрения
возможно: возможно
возникать: возникавших
возникновение: возникновению
возникнуть: возникшего
вой: воем
войти: вошли войти
волколак: волколак
вологда: вологда
вологодский: вологодского вологодская вологодской
волос: волосы волос волосами
волот: волот
волхв: волхв
волшебный: волшебной волшебные
волшебство: волшебство
вольф: вольфа
вопиетъ: вопиетъ
вопить: вопить
воплощение: воплощения
вопрос: вопросы
воронеж: воронеж
воронежский: воронежской воронежского воронежский
ворот: ворот
воскресенье: воскресенье
воспринимать: воспринимать
восприниматься: воспринималось воспринимались воспринимаются
воспроизводиться: воспроизводится
восточнославянский: восточнославянская восточнославянского восточнославянских
восточный: восточная восточных восточной
восходить: восходят
впоследствии: впоследствии
впрочем: впрочем
вражий: вражий
вред: вред вреда
вредить: вредила
временить: времени
время: время
времянех: времянех
времяни: времяни
вс: вс
все: всему всех всего
всероссийский: всероссийской всероссийских
всеять: всей
вскоре: вскоре
вследствие: вследствие
вставляться: вставлялись
встретиться: встретился
встреча: встреча
вступ: вступ
вступительный: вступительная
всюду: всюду
всякий: всякого всякие всякими
второй: вторая
вход: входа
входить: входит
выглядеть: выглядит
выгнать: выгнала
выгребать: выгребал
выделение: выделения
выживать: выживает выживающие
выжить: выживет выжить выжила
вызвать: вызвать
вызывать: вызывающая вызывающим
выкидыш: выкидыши
выкинуть: выкинуть
вылетать: вылетают
вынудить: вынудить
вып: вып
выпасть: выпавшего
выпучить: выпученные
вырывание: вырывание
вырывать: вырывают
выстригать: выстригают
выстричь: выстричь
выступать: выступает выступать выступая
вытеснение: вытеснение
выткать: выткет
выть: воют выть
выходить: выходи выходит
вышарить: вышарить
выщипывание: выщипывание
вязать: вязать
вятка: вятка
вятский: вятская вятской
вяч: вяч
г: г
газета: газета
галицкий: галицкого
гамаюн: гамаюн
гармония: гармония
гаудеамус: гаудеамус
гера: герою герой
герасим: герасима
германа: герман
герой: героем героев герои
гжись: гжись
гипотеза: гипотезе
гипотетический: гипотетически
гиппиус: гиппиуса гиппиус
гл: гл
глава: глав
главное: главному
глаз: глаз глаза
глас: глас
глаша: глаша
глебов: глебова
глинка: глинка
глиняный: глиняного
глубокий: глубокую
гнатюк: гнатюк
гном: гном
говор: говорах
говорить: говорили
говориться: говорится
говоров: говоров
год: гг году годов лет год годы года
година: година
голбец: голбце
голик: голике
голова: головою голова головой
головин: головин
головной: головном головной
голос: голосом голосами
голый: голой
гомель: гомель
гомельскай: гомельскай
гора: горах гора
горб: горб
горбатость: горбатость
горбатый: горбатой
горлышко: горлышком горлышко
город: город города
городской: городского городская
горох: горох
гороховый: гороховые
горшок: горшки горшок
горыныч: горыныч
горюнина: горюнина
государственный: государственной государственный государственного
готовить: готовить
град: града
грачевника: грачевника
греметь: гремит
грубый: грубые
группа: группы
губерния: губернии губерния губерниях
губить: губит губил
гуманитарный: гуманитарные
гумно: гумне
гура: гура
гуренко: гуренко
гусь: гусь
д: д
дабог: дабог
давать: давать
давных: давных
дажьбог: дажьбог
далее: далее
даль: даль
дальнейший: дальнейшем
даритель: дарителя
дата: дата
дать: данном данный дав данное
дверь: двери
двоедушники: двоедушники
двойник: двойника
двор: дворе
дворовая: дворовой
дева: дева
девать: девана
девочка: девочка девочку девочкой
девушка: девушки девушек девушками девушку девушка
дед: дед
дейнекин: дейнекина
действие: действия действие
действовать: действовать действующее
декабрь: декабря
делать: делали делает делал делать делала
дело: делами деле
дементьев: дементьева
демон: демонов
демонологемы: демонологемы
демонологический: демонологические демонологический
демонология: демонологии демонология
демьян: демьян
денница: денница
день: дня
деревня: деревня
дерево: дерева дерево
державный: державного
держать: держа
детская: детской
деть: день дело
дзелавой: дзелавой
дзивиш: дзивиш
диалектный: диалектная диалектных диалектное
диалог: диалог
диво: дива
дидилия: дидилия
дикий: дикая
диковинный: диковинным
дискурс: дискурсе
диссертация: диссертация
длиннокосая: длиннокосая
длиннокосую: длиннокосую
длинный: длинными длинную
дневной: дневном
дно: дна
добавить: добавлена
добела: добела
добрый: добрые
доводить: доводящую доводя
довольный: довольно
договор: договор
договориться: договориться
догола: догола
додола: додола
долгий: долгое
должен: должно должна
долина: долина
доля: доля
дом: дом дому доме домах
дома: дома
домашние: домашних домашние домашним
домашний: домашнем домашнего домашнему домашней домашний
доминировать: доминирует
домовиха: домовиха
домовничать: домовничал
домовой: домового домовой домовые домовому домовым
домовый: домовая
домосед: домоседов
домочадец: домочадцев
доп: доп
дополнительный: дополнительные
допрядать: допрядает
дорогой: дорогой дороги
досаждаема: досаждаема
досаждать: досаждают досаждает
доступный: доступен
досчитать: досчитать
дотронуться: дотронулась
дочка: дочки
др: др
драма: драме
древнегреческий: древнегреческих
древнерусский: древнерусской
древние: древних древними
древний: древней древнего древнейшее древний древняя
древность: древность древности
дрекавац: дрекавац
другой: другое другим другой другую другими другие других
думать: думали
дурной: дурного дурным дурные
дух: духов духа духе дух духи духами
духовная: духовная духовные
духовность: духовность
духом: духом
душ: душ
душеполезный: душеполезной
душить: душат душащий
дынин: дынин
дыра: дырой
дырка: дырки
дырочка: дырочкой
е: е
еда: еду
единица: единицах
единственный: единственное единственным
единство: единства
ежегодник: ежегодник
езда: езду
екатеринбург: екатеринбург
елена: елена
ермолин: ермолин
ерничинка: ерничинка
есенин: есенина
естественный: естественной
ефрона: ефрона
ея: ея
жалкий: жалкий
жанр: жанре жанр жанра
жар: жар
жарить: жарит
желать: желающей
железный: железную
жена: жены жена
женска: женска
женский: женского женский женском женские женских
женщина: женщина женщин женщину женщинам
жертвоприношение: жертвоприношений
живе: живе
живительный: живительного
живить: живя
живой: живым жива живого живая
животное: животного животных животными
жизнь: жизни
жилища: жилище
жилой: жилых
житель: жителей
житие: житий жития
жить: жили живущее живущий живущая живущими живут
жрец: жрецы
журнал: журнал
забайкалье: забайкалье
заболотить: заболоченная
забытье: забытьи
завидовать: завидуют
завладеть: завладевшие
заглавный: заглавная
загнутый: загнутое
заговор: заговорами заговоры
заданный: заданные
задобрить: задобрить
задрать: задерут
заикание: заиканием
зайде: зайде
закалывать: закалывали
закладывать: закладывали
закладываться: закладывался
заключать: заключает
закончить: закончить закончит
закопать: закопанная
закрепиться: закрепившимся
залить: зальют
заложные: заложные
заманивать: заманивающая
заниматься: занимается занимаются
занять: занять
заонежье: заонежье
запечельная: запечельная
запечный: запечная
записать: записаны
записка: записки
запись: запись
запретить: запрещено
зарегистрировать: зарегистрировано зарегистрированный
зарубежный: зарубежная
заставлять: заставляют заставляющая
застенчивый: застенчива
затем: затем
зато: зато
зафиксировать: зафиксированы
зачарованность: зачарованность
зачастую: зачастую
защита: защиты
защитить: защитить
защититься: защититься
защищать: защищающий
заявление: заявление
заяц: зайца
звать: зовут
звериный: звериному
звук: звуками звуки звуком звуков
звукоподражание: звукоподражания
здухач: здухач
зеленин: зеленин
земледельческий: земледельческий
зеркало: зеркале
зигзаг: зигзаги
зиновьев: зиновьев
злата: златой
зло: злом
зловредный: зловредный
злой: злых злые злой злым
злыдень: злыдни
змея: змей змея
знак: знак
знамеровская: знамеровская
знать: знающий
знахарь: знахаря
значение: значения
значить: значило
зовомая: зовомая
зола: золу
золото: золота
золотой: золотые
зооморфный: зооморфный
зримый: зримый
иван: ивана иванов иван
ивановский: ивановские
иверень: иверень
игорь: игоря
игоша: игоша
игра: игр игры
игральный: игральную
играть: играют играет
играющий: играющего
игровой: игровая
идеология: идеологии
идолопоклоннический: идолопоклоннических
идохом: идохом
идти: идущим
иже: иже
ижорский: ижорский
изба: избы избе
избавление: избавления
избранный: избранных избранные
известие: известия
известный: известны
извиваться: извивалась
изгибать: изгибать
изгнание: изгнание
изгнать: изгнать
изготавливать: изготавливали
изд: изд
издавать: издавать
издание: издание
издательство: издательство
изображаться: изображаются
изображение: изображением изображении
изучение: изучения
икать: икать
иллюстрация: иллюстрация
илья: илья
именно: именно
иметь: имеющих имеет
иметься: имеются
имущий: имущи
имя: именем имя имени
индоевроп: индоевроп
индрик: индрик
иногда: иногда
иной: ином
инок: иноке
институт: института институт
инструмент: инструменты
интенсификатор: интенсификатора
ирий: ирий
искривлять: искривлять
искусство: искусств искусство
исполнять: исполняет
использование: использование использования
использовать: использующие
использоваться: используется
исследование: исследование исследований исследования
исследовательский: исследовательского
исток: истоки
историко: историко
исторический: историческое историческом
история: история историям истории
источник: источниках источник
исходный: исходного
итал: итал
июль: июля
июнь: июня
й: й
йеша: йеша
кабак: кабаках кабаке
кадниковский: кадниковском
каждый: каждом каждый
кажется: кажется
каин: каин
календарь: календарь
калин: калинов
калужский: калужская калужской
камень: камень
кандидат: кандидата
капица: капица капицы
караконджул: караконджул
карлик: карликов
карна: карна
карта: карту карта
касаткин: касаткин
касторский: касторский
категория: категории
качество: качества качестве
качица: качица
кашуб: кашуб
керосин: керосин
кивать: кивать
кидаться: кидаются
киев: киев
киевский: киевской
кий: кий
кик: кика кик
кикимора: кикимор кикимора кикиморами кикиморы кикиморой кикимору кикиморе
кикиморская: кикиморская
кикимра: кикимра
кинематограф: кинематографа
кинуть: кинуть
кирилова: кирилова
киров: киров
кирпич: кирпичами
кирпичный: кирпичной
китеж: китеж
кладенец: кладенец
кладка: кладке
класс: класс
классик: классик классика
класть: клали
кликушество: кликушество
клишина: клишина
клобук: клобук
клюкина: клюкина
книгопродавец: книгопродавца
книжка: книжка
книжник: книжника
книжность: книжности
книжный: книжные
князь: князя князь
ко: ко
коайе: коайе
коваль: коваль
код: код
кодекс: кодекс
кожа: кожей
кожеватова: кожеватова
козий: козьи
козловый: козлова
коклюшка: коклюшками
колдовать: колдовать
колдовство: колдовства
колдун: колдунами колдуном колдуны
колодец: колодец
колония: колониями
коляда: коляда
коми: коми
комический: комический
комма: комм
комментарий: комментарии комментарий
комната: комнату комнаты
комплекс: комплекс комплекса
композитор: композиторов
компьютерный: компьютерных
конкурс: конкурса
константин: константинович константин
контекст: контекст контексте
конференция: конференция конференций конференции
конфиденциальность: конфиденциальности
копия: копия
копошиться: копошиться
коргоруши: коргоруши
корень: корня корнем корень
коринфский: коринфский
коробушка: коробушка
коровий: коровья коровье
коровка: коровок
короткий: короткие короткими короткий
корчагин: корчагин
коряжина: коряжины коряжиной
косоглазие: косоглазием
косой: коса
кострома: костромы кострома
костромской: костромской костромская
кострубонька: кострубонька
костюм: костюма
кот: кот
который: которым которое которыми которой которую которого которые которых которая котором который
кошка: кошками кошек кошка кошки
кошмар: кошмар
кощей: кощей кощее
край: края
краска: краской
красный: красные красной
крест: кресты крест
крестик: крестики
крестить: крестили
крестная: крестная
крестьянин: крестьянина крестьян
крещение: крещения крещение
кривизна: кривизной
крик: крик крика
криничная: криничная
кринка: кринки
кричать: кричать крича
кричащий: кричаще
кровь: кровью
кродо: кродо
крок: крок
кроме: кроме
кропотливый: кропотливых
кросскультурное: кросскультурное
крошечный: крошечное
крошка: крошки
круг: круг
круглый: круглый
кружево: кружева
крыков: крыков
крыльцо: крыльцо
кто: кого кому
кубанский: кубанской
кубань: кубани
кувшин: кувшина
куда: куда
кудахтать: кудахтать
кудель: кудель
кудрявцев: кудрявцева
кужлю: кужлю
кузнецкий: кузнецкий
кузнецов: кузнецова
кузьма: кузьма
кук: кук кука куки
кукарекать: кукарекать
кукла: кукол куклу кукла куклы
куковать: куковать
куколка: куколку
кукумарами: кукумарами
культ: культом
культура: культуре культуры культура
культя: культя
кумач: кумача
купала: купала
кура: кур куры курам
курган: курган
куриный: куриным куриного куриный
курица: курица
курский: курский курская
курятник: курятнике
кутузе: кутузе
кык: кык
кыкать: кыкать
кюхельбекер: кюхельбекера
л: л
лавка: лавку лавке
ладан: ладаном
ладо: лада
лазутчик: лазутчиков
ламя: ламя
лапа: лапы
лапоть: лапоть
ларин: ларина
латыш: латыш
левкиевская: левкиевская
легенда: легенды
легия: легия
легко: легко
лежать: лежащим
лекан: лекан
лексика: лексики
леля: леля лель
ленивый: ленивых ленивыми
лень: лень
лес: лесу
лесков: лескова
лесной: лесное лесных лесные лесной лесная лесным
лесовик: лесовик
летие: летию
летний: летнее
летучий: летучих
леха: лех
лечебник: лечебнике
лечь: легли
лешачиха: лешачихой лешачиха
леший: леший
либо: либо
либроком: либроком
либуше: либуше
лингвистика: лингвистика
лингвистический: лингвистический лингвистические
лингвокультурном: лингвокультурном
липецк: липецк
лита: лит
литература: литературой литературы литература литературе
литературный: литературных литературный литературного
лихой: лихо
лихорадка: лихорадка лихорадкой
лицензия: лицензии
лицо: лицо
лишь: лишь
ложноскорпионов: ложноскорпионов
локализация: локализации
локальный: локальных
локус: локус
ломать: ломают
лоскут: лоскутья
лохмотья: лохмотьях лохмотья
лошадь: лошадях лошадей
луковица: луковицами
лукоморье: лукоморье
лучина: лучину
лучинка: лучинок
лыбедь: лыбедь
лыко: лыке
лысая: лысая
любимица: любимицу
любить: любимом любимыми любит
любова: любова
любовь: любви
людка: людки
людмила: людмила
люлька: люлькой
ляд: лядов
лядова: лядова
м: м
мавка: мавка
магический: магическая магический
мадлевская: мадлевская
макаров: макарова
македонский: македонски
маклай: маклая
максим: максимов
макулы: макулы
маленький: маленькая мала маленьких маленькой маленькую мало маленьким
малороссийский: малороссийских
малютка: малютка малюток
мамуна: мамуна
манасеиной: манасеиной
манилка: манилка
манить: манить
мановение: мановение
мара: марой мара мар
маре: маре
маремьяна: маремьяной
мариамна: мариамны
мария: мария
марк: марк
маркелов: маркелова
маркин: маркин
марта: марта март
мартин: мартин
маруха: маруха
мары: мары
марья: марья
масленица: масленицу масленица
масса: масс
массовый: массовом
матвеев: матвеева
материал: материал материале материалы
материнский: материнской
матица: матицу
мать: мать
матэрыялах: матэрыялах
махать: махать
маца: мац
мая: мая
маять: маять
мебель: мебель
медведчикам: медведчикам
медведь: медведя медведь
медиа: медиа
медиафайлы: медиафайлы
межд: межд
международный: международным международного международной
мейзерська: мейзерська
мел: мелом
мелкий: мелкие мелких
меняла: менял
менять: меняющее
мерещиться: мерещится
местный: местных
место: место местах места месте
месть: мести
метить: метит
мечта: мечтам мечты
мечтание: мечтание
мечтанье: мечтаний
мешать: мешают
мидгард: мидгард
миклухо: миклухо
министерство: министерства
минск: минск
мир: мира миру мир
мировосприятие: мировосприятие
мировосприятия: мировосприятия
мистический: мистический
митава: митава
митрошки: митрошки
миф: мифа миф мифы
мифический: мифические
мифо: мифо
мифологема: мифологема
мифологический: мифологический мифологическом мифологические мифологических мифологического мифологическим
мифология: мифологии мифология
мифонимы: мифонимы
михаил: михаил
михеев: михеева
младенец: младенца младенцы младенцем
мнение: мнению
мниться: мнится
многие: многие
много: более много
мобильный: мобильная
мовы: мовы
могила: могиле могила
могильный: могильный
моделировать: моделирующие
модель: модель
модерн: модерна
можжевельник: можжевельник
можно: можно
мой: мою
мойра: мойр
мокоша: мокоша
мокоши: мокоши
мокошь: мокошь
молебен: молебна
молитва: молитвой
молодая: молодых
молоть: молоть
монастырь: монастыря
мор: моры мора
моревна: моревна
моровой: моровом
мороз: морозов мороз
морока: морок
морочить: морочить
морской: морская морской
моряна: моряна
москва: москву москве москва москвы
мост: мост
мотив: мотивов мотивам мотивы
мох: мхом
мохнатый: мохнатого мохнатые
мочка: мочки
мочь: мог могли могут могло могла
мужик: мужика
мужской: мужскими
мужчина: мужчины
музыка: музыке музыка
музыкальный: музыкальной музыкальный
мультипликация: мультипликации
мультфильм: мультфильмов мультфильме
мусий: мусий
мусолить: мусолит
мусор: мусор
мы: нами нам нас
мышь: мышей мышь
н: н
наблюдаться: наблюдаются
наваждение: наваждение
наваливаться: наваливаются
навевать: навевал
навести: навести
навигация: навигации навигация
навсегда: навсегда
навука: навука
навукова: навукова
навыкате: навыкате
навь: навь
наговор: наговором
нагой: нагая
над: над
наездник: наездников
название: названия названием названий
названый: назван
называние: называния
называть: называемый называли называемого
называться: назывался
наиболее: наиболее
наименование: наименования
найти: найти
наказание: наказание
накаливание: накаливании
накануне: накануне
накинуть: накинуть
наличие: наличие
намъ: намъ
нана: нан
наоборот: наоборот
наотмашь: наотмашь
нападать: нападающие
написание: написания
наподобие: наподобие
напоминать: напоминающий
направо: направо
например: например
напустить: напустили
нарастать: нарастает
нарис: нарис
народ: народов народ народа народе
народный: народная народном народным народной народные народных народное
народныя: народныя
народознавства: народознавства
наружу: наружу
нарядить: наряженный
население: населения
насест: насест
наслать: насланной насланная наслать
наследник: наследника
насмехаться: насмехались
насмеяться: насмеявшись
настой: настоем
настолько: настолько
настоящее: настоящему
насылать: насылал
насыпь: насыпь
наталья: натальи
наука: наука наук науке науки
науч: науч
научный: научный научных научной научно
находиться: находится находились
нац: нац
начало: начало начале начала
начать: начатую
начертание: начертание
начинать: начинала начинало начинает
наш: наших нашего
нашею: нашею
неблагодарный: неблагодарного
неблагополучный: неблагополучно
небо: неба
небылица: небылицам небылицах
неведомый: неведомая неведомых
невзрачный: невзрачного
невзрослеющая: невзрослеющая
невидимка: невидимкой
невидимый: невидимы невидимым невидимо невидимой невидимыми
негативный: негативные
недавно: недавно
недельный: недельного
неделя: неделю неделя
недоброжелатель: недоброжелателем
недобрый: недобрый
недовольный: недовольными недовольные
недоносок: недоноски
недостаток: недостатком
недостроенный: недостроенный
недоступный: недоступная
нежинский: нежинский
незаконченный: незаконченным
незаметно: незаметно
нездешний: нездешней
неизвестно: неизвестно
некачественный: некачественно
некий: некий некоем
некоммерческий: некоммерческой
некорректный: некорректный
некоторые: некоторыми некоторым некоторых некоторые
некрылова: некрылова
нелепый: нелепый
нелюдимый: нелюдимых
немалый: немало
немой: нем
немолодой: немолодая
немота: немотой
ненастный: ненастную
ненормальный: ненормальный
необъяснимый: необъяснимо
необыкновенный: необыкновенной
неопр: неопр
неопрятный: неопрятный неопрятная
неотпетого: неотпетого
неподвижный: неподвижный неподвижным
неподпоясанность: неподпоясанность
неполадка: неполадок
непонятный: непонятное
непослушный: непослушную
непостоянный: непостоянна
неправильный: неправильной
неприятность: неприятности
неприятный: неприятными
непроходимый: непроходимых
нерабочий: нерабочими
нерадивость: нерадивость нерадивости
нередко: нередко
неровный: неровные
неряшливый: неряшливую неряшливой неряшливая неряшливый
несколько: несколько
несмотря: несмотря
неугодный: неугодном
неугомонный: неугомонны
неформат: неформат
нечаев: нечаева
нечистики: нечистики
нечистый: нечистая нечистый нечистого нечистую нечистой нечисто нечистые
нечисть: нечисти
нечто: нечто
нечуй: нечуй
нижегородский: нижегородской нижегородская
низенький: низенькую
ний: ний
никакой: никаких
никитин: никитина никитин
никифор: никифора
никифоровский: никифоровский
никодим: никодима
николай: николая николай
нитка: нитки
нить: нить нити
ниц: ниц
нищая: нищих
новак: новак
новгородский: новгородская новгородской
новичкова: новичкова
новогодний: новогодних
новосибирск: новосибирск
новый: нового новая новый новые
нога: ногами ног ноги ногу
нож: ножом
ножик: ножик
ножницы: ножницы
нормальный: нормальной
ночница: ночницей ночница
ночное: ночным
ночной: ночная
ночь: ночам ночь ночи ночью
ноябрь: ноября
нравственный: нравственный
нужно: нужно
ныне: ныне
об: об
обаче: обаче
обвинение: обвинению
обвинять: обвиняли
обезличивание: обезличивание
оберегать: оберегает
обидеть: обидел
обидима: обидима
обитать: обитают обитающий
обкладник: обкладник
обладать: обладающих обладают
область: областях область области
облик: облик
обличие: обличия обличье
обман: обманы обман
обманщик: обманщиков
обманывать: обманывать
обменять: обменянных
обметать: обметал
обогатитель: обогатитель
обозрение: обозрение
оборотень: оборотнем оборотень
образ: образов образа образами образом образы образ образе
образование: образования
обратный: обратно
обращение: обращением обращения
обрубка: обрубок
обряд: обряда обрядов
обсуждение: обсуждение
обувь: обувью
обусловить: обусловлен
обучение: обучение
обшарить: обшарить
общаться: общаться
общение: общения
общественный: общественные
общество: общество
общий: общие общ общего
объект: объект
объявить: объявлен
объявлять: объявлял
объяснить: объяснить
объяснять: объясняли
обыкновенный: обыкновенно
обычай: обычаев
обычно: обычно
обязательный: обязательным
овинник: овинник
овца: овец
огибошна: огибошна
огненный: огненная огненный огненного
огонь: огонь огни
огромный: огромных
огу: огу
одеваться: одевались
одежда: одежду
одесса: одесса
одетый: одетой
один: одну одной одном одних один
однако: однако
одноглазый: одноглазый одноглазым
одолень: одолень
оживать: оживала оживает оживал
озорной: озорное
оказываться: оказываются
окно: окна
около: около
окропление: окропление
октябрь: октября
олицетворение: олицетворениями олицетворением
олицетворять: олицетворяя
олонецкий: олонецкая
омывать: омывали
она: нею ею
они: им ими них ними
оно: оно
опасение: опасением
описание: описания описание описаниям
описывать: описывали
описываться: описывается описывалась описываться описывался
оплата: оплатой
оплетение: оплетение
опора: опорой
опыт: опыт
организация: организации
орест: ореста
оригинальный: оригинальный
оркестр: оркестра
оркестровый: оркестровые
орловский: орловский
освоение: освоении
освящение: освящения
осмотреть: осмотреть
основа: основе
основное: основном основное
особенно: особенно
особенность: особенности
особый: особым особая особыми
осоргин: осоргина
оспариваться: оспаривается
оставаться: оставаясь
оставить: оставленные
оставлять: оставляли оставляет
оставляться: оставлялись
остальное: остальные
остальной: остальной остальная
остроносый: остроносая
отв: отв
отвергнуть: отвергнутая
ответственность: ответственности
ответственный: ответственный
отвечать: отвечать
отголосок: отголосок
отдаваться: отдавались
отдельный: отдельного отдельных
отец: отец
отечественный: отечественной
отечество: отечеству
отказ: отказ
откуда: откуда
отличие: отличие
отломить: отломленный
отмечать: отмечает
отношение: отношения
отогнать: отогнав
отождествлять: отождествляемая отождествлять
отождествляться: отождествляться
отправлять: отправляет
отражение: отражение
отредактировать: отредактирована
отрицательный: отрицательного
отсюда: отсюда
отцеживать: отцеживает
охота: охота
очаг: очагу
очень: очень
очерк: очерк
очию: очию
ошибка: ошибке
ошибоч: ошибоч
ошибъ: ошибъ
п: п
па: па
павел: павел
павер: павер
падший: падшие
пакостить: пакости
пакостный: пакостная
палитра: палитры
палка: палкой палку
палочка: палочка
памятник: памятниках
память: памятью
паничкин: паничкин
пантелеимон: пантелеимон
пантеон: пантеоне
папоротник: папоротника
парадигма: парадигма
параскева: параскева
парень: парня
паритет: паритет
паршиков: паршиков
патриот: патриот
паук: пауков
паукообразный: паукообразными
пашков: пашков
педагогический: педагогический педагогических
пение: пением
пеперуда: пеперуда
первичность: первичности
первое: первое первом
первоначально: первоначально
первый: первой первая первый
перебирать: перебирать
перебираться: перебираясь
переваливаться: переваливаясь
переверзева: переверзева
перевод: переводах
переворачивать: переворачивают
перед: перед
переделывать: переделывать
передний: переднем передней
перейти: перейти
переклад: перекладу
перекрестить: перекрестить
перемывать: перемывает
переносчик: переносчиков
перепарывать: перепарывать
переплетение: переплетение
пересказ: пересказ
перетц: перетц
переть: при пер
переходный: переходное
перечислить: перечислены
период: период
пермский: пермских пермская пермского
пермь: пермь перми
перо: перья перьев перьями перо
персонаж: персонаж персонажа персонажами персонажем персонажей персонажи
персональный: персональные
персонифицировать: персонифицированных
перун: перун
перхта: перхта
песнь: песни
песня: песню
петербург: петербург петербурга петербургу петербурге
петербургский: петербургский петербургском
петров: петрова
петровск: петровском
петрозаводский: петрозаводского
петь: поют
печать: печати
печерский: печерского
печка: печке печку печкой
печник: печниками
печь: печь печи печью
пиво: пиво
пигин: пигин
пизамар: пизамар
пировать: пирует
пирог: пирог
писатель: писатель
писк: писком
письменность: письменности
питомец: питомец
плакать: плакать
плакун: плакун
планетники: планетники
пласт: пластов
платочек: платочком
плач: плачем
плести: плести
плотник: плотниками
плохой: плохой
плут: плутов
плыть: плывущей
плясать: плясать
пляска: пляски
плясовой: плясовой
поведение: поведением поведение поведения
повелитель: повелитель
поверье: поверий поверьям поверье поверья поверьях
повествование: повествование
повествоваться: повествуется
повестить: повести
повесть: повестях
поветрие: поветрии
повойник: повойнике
повредить: повредить
погибать: погибает
погода: погода погоду
погубить: погубила погубить
подага: подага
подарок: подарков
подвесить: подвешенными
подвешивать: подвешивали
подвеять: подвей
подгот: подгот
подготовка: подготовка
подкинуть: подкинутую
подколодный: подколодная
подложить: подложив
подобно: подобно
подобный: подобные
подобрать: подобранные
подойти: подойти
подпечек: подпечка
подполье: подполья подполье
подпрыгивать: подпрыгивают подпрыгивала
подражать: подражающем
подробный: подробнее
подсадить: подсаженные
подсчитывать: подсчитывают
подумать: подумал
подушка: подушки
подызбице: подызбице
подыматься: подымается
поедание: поедание
пожар: пожаром пожара
пожертвовать: пожертвовать
позвизд: позвизд
позднева: позднева
поздний: позднее
позимье: позимье
поиск: поисках поиск поиску
поймать: поймает поймать
пойти: пошли
пока: пока
показание: показаний
показать: показана показаны
показывать: показывает
покидать: покидает
покинуть: покинуть покинутого
покойник: покойника покойники
покровительство: покровительством
покровительствовать: покровительствующий
покрыть: покрыта покрытая
пол: полы поле пола пол
полагать: полагали
полати: полати
поле: полях поля
полевик: полевик
полезный: полезного полезный
поленница: поленницу
ползание: ползанием
политик: политика
политический: политическая политическом
политология: политология
полнозначный: полнозначных
полночь: полночь
полный: полным
положить: положив положить
полтергейст: полтергейста
полудница: полудница
полудницей: полудницей
полуночница: полуночница полуночницей
получить: получить
полымя: полымем
помимо: помимо
помогать: помогают помогающего помогает помогающий
помочь: помочь
помощь: помощью помощи
помрачение: помрачениях
пониматься: пониматься
поносить: поношенный
понятие: понятия
поп: попа
попадаться: попадающийся
популярный: популярной
попытаться: попытались попытаться
попытка: попытка
пора: пору
поразить: поразившем
поревит: поревит
поренут: поренут
порог: пороге
портить: порчу
порча: порча
посадить: посаженных посаженные
посвятить: посвящена
посвящаться: посвящались
поселиться: поселился поселившимся
поскольку: поскольку
последний: последняя последний
последовать: последовать
последующий: последующая
пословица: пословице пословиц
посол: после
посолонь: посолонь
пост: посте
постель: постель
постоянно: постоянно
постоянный: постоянная
пострел: постреле
построить: построили
постройка: постройках
посуда: посуда посуду
потеря: потеря
потолочный: потолочную
потомство: потомства
похитить: похитившей похищенных
похищать: похищающая
почитание: почитания
почтить: почти
пошехонский: пошехонского
поэма: поэма
поэтический: поэтические
поэтому: поэтому
появиться: появившуюся появиться
появление: появлении появление появления
появляться: появляются
пояс: пояса
правда: правда
править: править
правка: правка правки
правый: права правом право
праздничный: праздничное праздничных
праздновать: празднуемый
практический: практически практическая
праславянский: праславянскому
праца: праца
превратиться: превратится
превращаться: превращался
преданный: преданный
предвещать: предвещает
предел: пределы
предзнаменование: предзнаменования предзнаменованием
предисл: предисл
предлагаться: предлагалось предлагается
предмет: предмет предметами
предок: предков
предполагаться: предполагается
предположение: предположения предположение
предромантизма: предромантизма
представать: представать
представиться: представились
представление: представление представлениям представлениях представления представлении
представленье: представлений
представлять: представляли представлял представлять
представляться: представлялась
предшественница: предшественницей
прежде: прежде
преимущественный: преимущественно
прекратить: прекратить
прекращение: прекращением
премудрый: премудрая
преобладать: преобладающей
преромантизму: преромантизму
прецедентный: прецедентных
привезти: привезти
привести: привели
привидение: привидение привидением
приводить: приводящей
привязываться: привязывалась
пригреть: пригретые
приезжая: приезжих
признак: признаками признак признаки признаком
призрак: призрак
приказ: приказа
приключение: приключения
прилежный: прилежно прилежных
прилож: прилож
пример: примере
примечание: примечания
принадлежать: принадлежавший принадлежат
принадлежность: принадлежности
принести: принести
принимать: принимали принимая
приносить: приносящий
принцип: принципов принципы
припегала: припегала
приписывание: приписывание
приписывать: приписывал приписывают приписываемых
природа: природу природе
природный: природной
приурочить: приурочено
приходить: приходили
приходиться: приходилось
причерноморье: причерноморья
причина: причиной
причинять: причиняют
причислять: причисляли
причитать: причитать
причуда: причуды
приятный: приятный
про: про
пробка: пробок
проблема: проблемы
проблеми: проблеми
прове: прове
проведение: проведение
проверить: проверенная
прогнать: прогнать прогнал
прогресс: прогресс
проделка: проделки
проект: проект проектах проекта
произведение: произведения произведениях
произведенье: произведений
производить: производят производили
происходить: происходит происходящую
происхождение: происхождения происхождение
происшествие: происшествиям
проказа: проказы
проказничать: проказничать
проклясть: проклятого проклятых
проклятие: проклятий
пророк: пророк
пророческий: пророческую
просмотр: просмотры
просто: просто
простовласы: простовласы
простоволосость: простоволосость
простоволосый: простоволосый
простонародный: простонародных
просторечный: просторечная
пространство: пространстве пространства
простыня: простыни
просьба: просьбе
против: против
противостоять: противостоит
проточина: проточиной
протяжение: протяжении
проф: проф
прочий: прочие прочего
прочный: прочно
прошлый: прошлым
проявлять: проявляющий
прус: прус
прут: прутьями
прыкметы: прыкметы
пря: прях
прядение: прядении прядением прядение
прядь: прядь
пряжа: пряжей пряжу
прялка: прялкой прялку
прясть: прясть прядут прядущий прядущего
прятаться: пряталась
пряха: пряха
псевдобылички: псевдобылички
псих: псих
псл: псл
псоглавцы: псоглавцы
птица: птицу птицах птица птицы
птичий: птичий
пугало: пугало
пугать: пугали пугающая пугают
пустодомка: пустодомка
пустой: пустом пустых
пустота: пустоты
пусту: пусту
путать: путают путает
путемъ: путемъ
путь: пути
пуховый: пухова
пушкино: пушкина
пушкинский: пушкинский
пущаго: пущаго
пущий: пущий
пыльный: пыльных
пытка: пытки
пятница: пятница пятницам
р: р
ра: ра
работа: работе работы работа работу работ работах
рабочий: рабочих рабочий
равноапостольный: равноапостольная
радегаст: радегаст
разбивать: разбивают
разбить: разбитого
развадовская: развадовская
развитие: развития развитие
разворачивать: разворачивают
разговаривать: разговаривают
разговорный: разговорно
разгуляться: разгулявшейся
раздеть: раздела
различный: различными различным различные
размер: размеров
разнообразный: разнообразных разнообразный
разнородный: разнородных
разный: разных разные
разработчик: разработчики
разрыть: разрыв
разрядный: разрядного
разъяснение: разъяснений
рамка: рамках
ран: ран
ранний: раньше ранние раннее
рарог: рарог
раскрываться: раскрывается
распахивать: распахивают
расплывчатый: расплывчаты расплывчатым
распоряжение: распоряжение
распространить: распространены
распугивать: распугивал
распустить: распущенными
рассказ: рассказе рассказам рассказы рассказ рассказах
рассказов: рассказов
рассказывать: рассказывали рассказывает
расследование: расследование
рассматривать: рассматривают
рассматриваться: рассматриваться рассматривалось
расстояние: расстояние
растение: растения
рваный: рваную
рггу: рггу
реализация: реализация
ребенок: детьми детей детям дети
ребята: ребят
ревзин: ревзин
регион: региона регионов
региональный: региональной
регл: регл
редактор: редактор
редакция: ред
редкий: редок редкими
реж: реже
резкий: резкие
результат: результате
река: река рекой
рекомендоваться: рекомендовалось
религиозный: религиозные
религия: религия
ремизов: ремизова
рерих: рерих
республиканский: республиканский
рефлексия: рефлексию
речевой: речевого
речь: речь речью
рипол: рипол
рисовать: рисовали
ритуальный: ритуальная ритуальные
рог: рога рогами
род: рода род
родина: родиной
родины: родины
родитель: родителями родители
родник: родника
родственный: родственные
родство: родство
рожать: рожают
рождение: рождения
рождество: рождество
рожок: рожки
роль: роль роли
роман: романе роман
романтизм: романтизму романтизма
романтический: романтической
ронять: роняют
росный: росным
российский: российская
россия: россии россия
рост: ростом
ростовский: ростовского
ртуть: ртуть
рубаха: рубахи рубахе
рубашка: рубашку
рубить: рубить
ругательство: ругательства ругательством
ругевит: ругевит
рудимент: рудименты
рука: рукой руками рук руках
русалка: русалка русалкой
русалочий: русалочьи
русифицировать: русифицированный
руслан: руслан
русская: русские русских русская русской
русский: русском русского русское русский
русскоязычный: русскоязычного
русый: рус
русь: русь
рута: рута
рэд: рэд
рэдагаванне: рэдагаванне
рюбецаль: рюбецаль
ряд: ряда ряд рядом ряде
ряженый: ряженой ряженых
рязанский: рязанский
рязань: рязань
савва: савва
савецкая: савецкая
сага: саге
садиться: садились садится
сакральный: сакральная
сам: самого самом сама самое
самарский: самарской
самовар: самовара
самостоятельный: самостоятельного самостоятельном
самоубийца: самоубийцы самоубийц
самый: самый самых
санкт-петербург: спб
санкт: санкт
сантиметр: см
сапковский: сапковский
сапковского: сапковского
саратов: саратов
саратовский: саратовского
сарафан: сарафане
сартаева: сартаева
сатанаил: сатанаил
сахаров: сахарова
сбивать: сбивающая
сближать: сближает
сборник: сборник сборники сборнике сборника
сбрасывать: сбрасывают
свадебный: свадебных
сварог: сварог
сварожич: сварожич
сведение: сведения сведениям
свежий: свежие
свердловский: свердловской
сверлиться: сверлились
свесить: свесив
света: свет света
светославич: светославич
свидетельствовать: свидетельствует
свинец: свинце
свиной: свиней
свинья: свиньи
свист: свистом
свободный: свободной
свод: свод
свое: своих своего своим
свой: свой своей свою
связанный: связано связанные связан связанное
связаться: свяжитесь
связывать: связывают
связь: связи связь
святки: святок святки
святовит: святовит
святой: святого святых святой
святочный: святочной святочного
сгу: сгу
сделать: сделанную
сделаться: сделавшееся
се: се
север: север севере севера
севернорусские: севернорусские
сезон: сезоны
сельскохозяйственный: сельскохозяйственными
семантика: семантика
семасиологический: семасиологическом
семиотическая: семиотическая
семиотические: семиотические
сентябрь: сентября
сенькевич: сенькевич
сербохорв: сербохорв
серия: серии серия
серый: серых
серыя: серыя
сестра: сестра сестру
сестричка: сестрички
сеять: сеять
сжечь: сожгут сжечь
сжигаться: сжигавшееся
сибирский: сибирская
сибирь: сибирь сибири
сидеть: сидеть сидя
сила: силу силой сила силы силе
сильный: сильно
сим: сим
симаргл: симаргл
симбирский: симбирской
символ: символ
символизировать: символизирует
символика: символика
символический: символическое символическим
симфонический: симфоническая симфонического
сирин: сирин
система: системе система системы
сицевъ: сицевъ
сказ: сказ
сказание: сказаний
сказать: сказано сказала
сказка: сказка сказок сказки сказкам сказке
сказовый: сказовое
сказочный: сказочная сказочно
сказываться: сказывается
скачать: скачать
сквозной: сквозной
скепсис: скепсис
сковорода: сковороду
скоро: скоро
скорый: скорее
скот: скот скота
скотина: скотиной
скрываться: скрывается
скрытый: скрытые
скрыться: скрылось
скрюченность: скрюченность
скрючить: скрюченную скрюченной скрюченная
скряга: скряг
слабоумие: слабоумием
славянин: славян
славяно: славяно
славяноведение: славяноведения
славянский: славянский славянская славянские славянских славянской славянского славянское
слать: шли
слева: слева
слегка: слегка
след: следов
следовать: следовало
следствие: следствия
следующий: следующее
слишком: слишком
словарь: словарь
словац: словац
словет: словет
слово: слов слове слову словах слова слово
словом: словом
сложно: сложно
служебный: служебные
служить: служить
случай: случае случаях случаи
случайный: случайная
слышашеся: слышашеся
слышно: слышно
смелый: смелый
смерть: смертью смерть смерти
сметать: сметали
смешение: смешении смешение
смешивать: смешиваемая
смешной: смешной
смеяться: смеялись
смирнов: смирнов
смирный: смирными
смола: смолою
смоленский: смоленская
смородина: смородина
сморщенный: сморщенной
смотреть: смотреть
смочить: смоченную
смутный: смутное
смышляев: смышляева
смышляевский: смышляевский
сновидение: сновидениях
сноп: сноп
собака: собаки
собор: соборе
собрание: собрание
событие: события событие
совершаться: совершается
советский: советский советская
совмещение: совмещением
современность: современность
современный: современном современные современной
согласно: согласно
соглядатай: соглядатаев
согнать: согнали
согнаша: согнаша
содержание: содержание
содержаться: содержится
создать: создано создать
сознание: сознания сознании
соискание: соискание
солдат: солдате
солнечный: солнечный
соловецкий: соловецкого
соломинка: соломинка
солонка: солонки
соль: соль
сомовый: сомова
сон: сне
сонный: сонных
сообщение: сообщению
сообщество: сообщество
сообщить: сообщить
соответствующий: соответствующего
соотносить: соотносимая
сорочий: сорочьи
сосед: соседям
сост: сост
составление: составление
составной: составное
состояние: состояниях
состричь: состриженной
сотворение: сотворения сотворение
сохранение: сохранение сохранением
социальный: социальный
социология: социология
социосфера: социосфера
сочинение: сочинения
спасти: спасла
спать: спи спать
спбгу: спбгу
спектакль: спектаклей спектакль
сплетать: сплетать
спокойный: спокойно
спорный: спорно спорным
способ: способы
способность: способностью
способный: способны
справка: справка
сразу: сразу
среда: среда
среди: среди
средство: средство средства средств
срезневский: срезневский
срезневского: срезневского
српски: српски
ссср: ссср
ссылка: ссылка ссылками ссылки
стабильный: стабильная
ставать: ставать
ставить: ставя ставили
ставрополь: ставрополь
стадо: стадо
сталкер: сталкера
становиться: становятся
старательный: старательной
старец: старца
старик: старики старика
старина: старина
старинный: старинного
старое: старым
старуха: старух старуха
старушка: старушкой старушку старушка
статистика: статистика
статус: статус
стать: стала стать
статья: ст статей статья статьи
степень: степени
стер: стер
столетие: столетия
столь: столь
стонать: стонут
стопан: стопан
сторожить: сторожила сторожит
стоячий: стоячая
стравинский: стравинского
страж: страже
страница: страницы страница страницу странице
странный: странное
страх: страх
страшно: страшно
страшный: страшный страшного страшное
стрибог: стрибог
стрижка: стрижку
строение: строения
строитель: строители
строительство: строительстве
строить: строящее
стрыга: стрыга
стук: стука стуком
стучать: стучать
судить: судя
судьба: судьбы
суеверие: суеверия
суеверный: суеверные
суеверье: суеверий
сумського: сумського
суть: сути
сучасного: сучасного
сучить: сучат сучит
сучок: сучок сучка
существо: существо существ существа существами существах
существование: существование
существовать: существуют существовал существовало
сфера: сфера
схватить: схватить
схожий: схожие схожими
считать: считает считали считают
считаться: считалось считаются
сырой: сыра
сюда: сюда
сюжет: сюжетов
ся: ся
т: т
табуирования: табуирования
таинственность: таинственность
тайный: тайна тайны
также: также
тако: тако
такой: таким такими таком таких
тапочку: тапочку
таракан: тараканов
таскать: таскала
татарин: татар
татьяна: татьяна татьяны
тверская: тверской тверская
театр: театр
текст: текст тексты текстов тексту текстам
текущий: текущие текущем
телосложение: телосложения
тембральной: тембральной
темнота: темноте
темя: темени
термин: термина
термит: термитов
тиманова: тиманова
тина: тиной
типичный: типичным типичного
типография: типография
тихий: тихие
ткать: ткать
товарищество: товарищество
товарный: товарный
токарев: токарев
толкование: толкования
толковаться: толковался
толковый: толковый
толстый: толстая толстого толстой
тональность: тональность
тонкий: тонкое тонка
топоров: топоров
топот: топотом
топь: топях
торчать: торчал
тосковать: тоскующее
тот: том тех те тот той
тотчас: тотчас
точить: точащими
трава: травы травами трава
трагедия: трагедии
традиционный: традиционной традиционных традиционные традиционная
традиция: традиция традиции традиций
требовать: требующего
трепать: треплют
треск: треском
третий: третьей
третье: третьего
триглав: триглав
тридевятый: тридевятое
трикстер: трикстер
тритон: тритоне
трифон: трифон
трогать: трогала
троица: троице
тронуть: тронет
тропинка: тропинка
труба: трубу
труд: трудах трудов труду
тряпочка: тряпочек
трясина: трясину
туловище: туловище
туман: туман
туманный: туманном
турупит: турупит
тысячелетие: тысячелетия
убаюкивать: убаюкивает
убегать: убегают
убивать: убивает
убить: убитые убитых
убор: убор уборе
увидеть: увидеть
угол: углы углах углу угол
уголь: углями
угорский: угорских
угроза: угрозы угроза
удаляться: удаляются
ударить: ударив
удаться: удастся
уделить: уделено
удельница: удельница
уезд: уезда уезде
ужас: ужаса
ужасный: ужасным
уйти: ушла
указание: указанием
указатель: указатель
указывать: указывает
указываться: указывается
укладанне: укладанне
укр: укр
украдкой: украдкой
украинец: украинцев
укромный: укромных
укрытие: укрытия
улица: улице улицу
ум: ума
умелый: умелой
умерший: умершего умерших умершие
умирать: умирать
умора: умору
умывальник: умывальника
уна: ун
университет: университет университета
упоминание: упоминания упоминание
упоминать: упоминаемая
упоминаться: упоминаются
употребляться: употребляется употреблялось
упырь: упырь
уральский: уральского уральский
урга: ургу
уродец: уродцы
уродливый: уродливая
урусов: урусов
урчание: урчанием
усадьба: усадьбы
условие: условий условия
услужение: услужение
услышать: услышишь
усопший: усопших
успокоиться: успокоится
усталость: усталости
устный: устная
уступный: уступны
утверждать: утверждали
уток: утки
утро: утром
ухаживать: ухаживал ухаживает
ухать: ухать
ухо: ушей
ухова: ухова
уход: уходе
участие: участие участием
учесть: учесть
ф: ф
факт: факты
фактор: фактор
фантастический: фантастических
фараонки: фараонки
фасмер: фасмер
февраль: февраля февраль
фейклорная: фейклорная
феминнотивы: феминнотивы
феномен: феномен
феодосий: феодосия
фигура: фигуры
фигурировать: фигурируют
филолог: филологов
филологический: филологический
филология: филология
фильм: фильмов
финно: финно
фишер: фишера
флинс: флинс
флинт: флинта
фольклор: фольклором фольклор фольклора фольклоре
фольклорный: фольклорная
фома: фома
фомин: фоминых
фонд: фонд
форма: форма форме
формула: формула
форум: форум
фр: фр
фундаментальный: фундаментальных
функциональный: функциональном
фэнтези: фэнтези
х: х
хаберница: хаберница
хала: хала
хань: хань
характерный: характерны характерные
хата: хату
хватать: хватали
хвост: хвостов хвост
хеннил: хеннил
хихикать: хихикать
хлев: хлеву
хлевнику: хлевнику
хлипкий: хлипкого
ход: ходе
ходить: ходит
хозяин: хозяева хозяевам хозяев хозяина
хозяйка: хозяйке хозяйкой хозяйкам
хозяйственный: хозяйственных
хозяйство: хозяйству хозяйстве
хозяйствовать: хозяйствовала
хомяк: хомяка
хорив: хорив
хороший: лучше хорошей
хорс: хорс
хохотать: хохотать
хрипеть: хрипеть
христианство: христианство
христофорова: христофорова
хрома: хромой
хромой: хромого
хтонический: хтоническому
художественный: художественном художественных художественной
худой: худая
царевич: царевич
царство: царство
царь: царь
цветок: цветок
цветочек: цветочек
целовальник: целовальников
целый: целыми целом целый целым
ценность: ценности
центр: центре центр
центральный: центральная
цепь: цепи
цзинхуэй: цзинхуэй
цивилизация: цивилизации
цивиной: цивиной
цитировать: цитировать
цмок: цмок
чадинского: чадинского
чаплыгин: чаплыгина
час: час
частить: части
часто: часто
часть: частью часть
чаща: чаще чащах
человек: человек человеку людьми человека людей человеком люди людям
человечески: человечески
человеческий: человеческой
чепца: чепце
черви: червями
червона: червона
чердак: чердаке
через: через
черепанов: черепанова
чернева: чернева
чернобог: чернобог
чернобровый: чернобрового
черноглав: черноглав
черноглазый: черноглазого
чернокнижник: чернокнижник
черта: черт черты
чертить: черти
чертополох: чертополох
честь: честь
чех: чех
чеш: чеш
число: число числе
читатель: читателя
читать: читать
чл: чл
чтение: чтений чтения
чтобы: чтобы
чуб: чуб
чувство: чувств
чугайстер: чугайстер
чудо: чудо
чудь: чудь
чуждоезиково: чуждоезиково
чужой: чужого чужом
чулков: чулков
чупахина: чупахина
чуть: чуть
чухломский: чухломское
чучело: чучело
чушка: чушка
шалить: шалят
шаманство: шаманства
шамшуре: шамшуре
шаповалов: шаповалова
швед: швед
шевелиться: шевелиться
шевченка: шевченка
шеин: шеина
шерстить: шерсти
шерсть: шерстью шерсть
шесток: шесток
шить: шить
шиш: шиш
шишара: шишара
шишать: шишать
шишига: шишига
шишимора: шишиморой шишимора шишиморы
шишить: шишить
шишко: шишко
школа: школе
шов: швы
штаны: штанами
шуликуны: шуликуны
шум: шумом
шушканы: шушканы
щека: щек
щекотать: щекочут
щепка: щепку щепок
экз: экз
экономика: экономика
эксмо: эксмо
эксперт: эксперта
элемент: элементы элемент
эльф: эльф
энцикл: энцикл
энциклопедический: энциклопедический
энциклопедия: энциклопедия энциклопедии
энцыклапедычны: энцыклапедычны
энцыклапедыя: энцыклапедыя
эпоха: эпохи эпох
эскиз: эскиз
эстония: эстонии
эстрада: эстрады
этимологический: этимологический
этимология: этимология
этнографический: этнографическая этнографической этнографическое
этнография: этнография
этнокультурный: этнокультурном
этнолингвистический: этнолингвистический
этнология: этнология этнологии
это: этом это этим
этот: этой этих эта эту
ю: ю
юда: юда
юдо: юдо
южнорусский: южнорусской
южный: южная
ютробог: ютробог
являться: является являлась
яга: яга
язва: язве
язык: язык языках языка языке
языковой: языковом языковые
языкознание: языкознание
языческий: языческие
язычество: язычества язычество
яко: яко
якоб: якобы
январь: января
яровит: яровит
ярославский: ярославский ярославская ярославского ярославской
ясли: ясли
