австралия: австралию
авторство: авторства
азкабана: азкабана
аккуратный: аккуратные аккуратными
активистка: активистка
алфавит: алфавиту
альбус: альбус
альбуса: альбуса
амбридж: амбридж
англ: англ
англия: англия
античный: античной
антонин: антонин антонина
архив: архив
архивировать: архивировано
ассоциация: ассоциацию
бал: бал
банкет: банкете
барда: барда
батильды: батильды
беларуская: беларуская
беллатриса: беллатриса
беллатрисой: беллатрисой
беллатрисы: беллатрисы
библиотека: библиотеке
бидля: бидля
биография: биография
битва: битве битвы
блестяще: блестяще
блэк: блэк
бог: бога
боггарт: боггарт
боггартом: боггартом
болгарский: болгарской
больничный: больничном
больший: больше
брат: брату
браун: браун
бросать: бросает
бруствер: бруствер
буквальный: буквально
булстроуд: булстроуд
български: български
бывать: бывает
быстро: быстро
быть: были
бэгшот: бэгшот
важный: важна
вариант: вариант
василиск: василиска василиске василиск
вд: вд
велеть: велела
великобритания: великобритания
вернуть: вернула
вернуться: вернулась
версия: версия
весело: весело
весьма: весьма
взять: взять
вид: виде
визит: визите
викиданных: викиданных
викимедиа: викимедиа
википедии: википедии
википедия: википедия
викисклад: викисклад
викискладе: викискладе
викицитатник: викицитатник
викицитатнике: викицитатнике
викия: викия
виктор: виктором
вино: вину
виноградный: виноградная
вклад: вклад
власть: власти
вместе: вместе
внешность: внешность
возвращать: возвращают
возвращаться: возвращается
возвращение: возвращение
возможность: возможности
войти: войти
волан: волан
волос: волосы волос
волшебник: волшебников
волшебница: волшебницы волшебница
волшебный: волшебные волшебная волшебном волшебный
воплощение: воплощение
восстановление: восстановления
впечатление: впечатление
впоследствии: впоследствии
вратарь: вратаря
врач: врачи
временить: времени
время: время
все: всех всеми
всезнайка: всезнайкой
вселенная: вселенная
всеять: всей
вскоре: вскоре
встреча: встрече
встречать: встречают встречает
встречаться: встречающееся встречаться
второе: второе
второй: вторая
вундеркинд: вундеркинд
выбрать: выбрать выбрала
выглядеть: выглядит
выдать: выдавшего
выделиться: выделиться
выдра: выдра
вызов: вызов
выйти: вышла
выкрадывать: выкрадывают
выкрасть: выкрасть
вымыслить: вымышленных вымышленные
вынесение: вынесения
вырасти: выросли
выручать: выручает
вырывать: вырывает
высокий: высоко
высокомерный: высокомерной
вышеописанный: вышеописанных
выяснить: выяснив выяснить
выяснять: выясняет
г: г
галлеоны: галлеоны
гарри: гарри
гениально: гениально
гермес: гермеса
гермиона: гермиона гермионы гермионе гермиону
героизм: героизме
героиня: героини героинь
глава: главе глава
главное: главных
главный: главную
глаз: глаза глазах
глядеть: глядя
говорить: говорит
год: лет год годами годы года
горазд: гораздо
гораций: горацию
гордиться: гордится
горный: горного
горячее: горячих
готовый: готовой готова
гражданский: гражданскую
грейнджер: грейнджер
греча: греч
греческий: греческое греческого
гриффиндор: гриффиндор
гриффиндора: гриффиндора
гриффиндоре: гриффиндоре
грязнокровка: грязнокровка
густой: густыми
дальнейший: дальнейшем дальнейшая
дамблдор: дамблдор
дамблдора: дамблдора
дантисимус: дантисимус
дар: дары
дата: дата дату
дать: дала дать
двое: двое
де: де
девочка: девочка девочку девочки
действительно: действительно
действовать: действующих действовать
декан: декана
день: дней
деньга: деньги
деть: день
деятельность: деятельностью деятельность
дж: дж
джин: джин
джоан: джоан
джон: джон
дилогия: дилогия
дисциплина: дисциплине
дитя: дитя
длинный: длинными длиннее длинные
догадываться: догадывается
док: док
долгий: долго долгое
должен: должно
должность: должность
долорес: долорес
долохов: долохов
долохова: долохова
дом: дом
дома: дома
домашние: домашних домашние
домовик: домовиков
домыть: домой
дополнительный: дополнительных дополнительные
дополняться: дополняется
допытываться: допытывался
доступный: доступен
дочь: дочь дочери
дразнить: дразнили
драко: драко
дракон: дракона
драться: дралась
древность: древности
друг: друзья друзьями друзей другом друзьям
другой: другими других
дурмстранг: дурмстранг
дуэльный: дуэльном
дьявольский: дьявольских
дюйм: дюйма
е: е
единственный: единственная
елена: елены
ехать: едет едут
женский: женский
женственный: женственной
женщина: женщин
жертва: жертв жертвы
живоглот: живоглот живоглота
животное: животное
жизнь: жизни жизнь
жила: жила
жительство: жительства
забирать: забирает
завалить: завалила
завершить: завершила
завещание: завещания
загадка: загадку
заглавный: заглавная
задание: задания
задать: задано
задача: задач
заклинание: заклинаний заклинание
заклятие: заклятие заклятий заклятием заклятия
закон: законов
заменить: заменить
заметить: заметила
заметно: заметно
замечать: замечает
замок: замок
замуж: замуж
заниматься: заниматься занималась
занудный: занудной
занятие: занятия занятий
занять: заняла
запись: запись
запретный: запретном
запятая: запятых
зарабатывать: зарабатывают
зарегистрировать: зарегистрированный
затем: затем
затея: затея
защита: защите защиту
защищать: защищающих
заявление: заявление
званый: званый
зверинец: зверинце
зверь: звери
зелье: зелий зелье зелья
зеркало: зеркало
зимний: зимней
змея: змей
знак: знак
знание: знаниями знании
знать: знает
значимый: значимые
значительный: значительному
значить: значат
зуб: зубы
игра: игра игры
идеал: идеалы
избранный: избранные
излишний: излишне
изучение: изучение
именно: именно
иметь: имеет
имя: именем имя имени
ингредиент: ингредиенты
иногда: иногда
инструмент: инструменты
интерес: интерес
интересовать: интересующие
информация: информацию
искоренение: искоренением
искусство: искусств
исполнение: исполнение
использование: использования
использовать: используя использовать
испытание: испытаниях
исследовать: исследовав
история: историю история историй истории
источник: источник
итог: итоге
июль: июля
июнь: июня
кабинет: кабинета
камень: камень камня
канализация: канализации
каникулы: каникулы каникулах
карий: карие
карточный: карточная
карьер: карьеру
категория: категории
каштановый: каштановыми каштановые
квиддич: квиддич
квиддичу: квиддичу
кингсли: кингсли
киновоплощение: киновоплощение
клуб: клубе
клык: клыком
клювокрыла: клювокрыла
клювокрылу: клювокрылу
книга: книгах книги книгу книге книга
книжный: книжной
когтевран: когтевран
когтевране: когтевране
код: код
кодекс: кодекс
коллекционный: коллекционная
команда: команду
комната: комната комнаты
конец: конце конца
конспект: конспекты
конструктор: конструктор
контроль: контроля
конфиденциальность: конфиденциальности
конфундус: конфундус
копия: копию
кормака: кормака
королев: королева
короткий: короткие короткий
косой: косом
косолапсус: косолапсус
кот: кота
который: которой которого которая
кошачий: кошачий
крамом: крамом
крестраж: крестраж
крестражей: крестражей
критика: критика
кровь: крови
круциатус: круциатус
крыло: крыле
крыса: крысе крысу
ксенофилиуса: ксенофилиуса
кто: кем кому
кубок: кубок
кук: куки
купить: купить купила
курс: курсе
куча: кучу
кыргызча: кыргызча
лаванда: лавандой
лавгуда: лавгуда
лавгудов: лавгудов
лапа: лап
лес: лесу
лестрейндж: лестрейндж
лесть: лесть
летний: летние
лечиться: лечиться
лицензия: лицензии
лицо: лицу лиц лицом
личина: личинами
лишение: лишениях
ловец: ловцом
логика: логику логике логики
ложный: ложный
лоза: лоза
локация: локации
локонса: локонса
любить: любит любимое
люпин: люпин
м: м
маг: магов
магический: магического магических магическими
магия: магия магии
маглами: маглами
маглы: маглы
мадам: мадам
макгонагалл: макгонагалл
македонский: македонски
маклаггена: маклаггена
маклаггеном: маклаггеном
малфоев: малфоев
малфоем: малфоем
малфой: малфой
малфоя: малфоя
мандрагора: мандрагор
мантия: мантией
материал: материал
мать: мать матерью
маховик: маховик маховика
медальон: медальон медальона
медиафайлы: медиафайлы
менее: менее
менелая: менелая
меняться: меняется
место: место места мест
метла: метлой метлу
метод: методы
меч: мече
миг: миг
миллисенты: миллисенты
минерва: минерва
министерство: министерство министерстве
министр: министр
минутка: минутку
мир: мира мир мире
мирить: мирит
мириться: мирится
миссис: миссис
мистер: мистера мистер
миф: мифа
мифология: мифологии
многие: многие
многий: многом
много: более много
многословный: многословно
многочисленный: многочисленных
множество: множеством
мобильный: мобильная
можно: можно
мозги: мозгами
молния: молнию
молодая: молодая
момент: момента
монгол: монгол
монстр: монстра
морт: морт
морта: морта
мочь: мог могли могут
мракоборцев: мракоборцев
муж: муж
мы: нами
мышление: мышления
н: н
наблюдательность: наблюдательность
набор: набор
навигация: навигации навигация
нагайной: нагайной
над: над
назвать: назвали
назидательный: назидательно
назначение: назначению
назойливый: назойливых
наиболее: наиболее
найти: найдя найдена
наказание: наказание
накладка: накладки
накладывать: накладывает
налаживаться: налаживаются
наложить: наложив
нападение: нападений нападение
направить: направлена
нарушать: нарушают
нарушить: нарушив
наряд: наряду
насмешка: насмешки
начало: начале начала
начинать: начинает
наш: наших
неверный: неверным
невероятно: невероятно
невидимка: невидимкой
негативный: негативно
неделя: недель
недостоверный: недостоверный
недоступный: недоступная
независимость: независимости
неизвестно: неизвестно
некоммерческий: некоммерческой
некоторые: некоторых
немножко: немножко
необходимый: необходимого
необычный: необычные
неопр: неопр
неохотный: неохотно
неподготовленность: неподготовленности
неполный: неполный
непослушный: непослушные
непосредственно: непосредственно
неприязнь: неприязнь
нерабочий: нерабочими
несколько: несколько
несмотря: несмотря
несправедливый: несправедливых
нестандартный: нестандартной
неумение: неумение
никто: никому
новый: нового новые
нора: нору
норберт: норберта
норрис: норрис
носить: носит
нравиться: нравилась
нужно: нужно
об: об
оберегать: оберегая
обижаться: обижается
обитание: обитания
область: области
облик: облик
оборотень: оборотень
оборотный: оборотное
обращение: обращения
обстановка: обстановке
обсуждение: обсуждение
обучение: обучение
общаться: общаются
общественный: общественной
общий: общие
объяснять: объясняет
объятие: объятий
оглашение: оглашении
огонь: огня
ода: од
один: одна один одно одним
одиноко: одиноко
однако: однако
одновременно: одновременно
однокурсник: однокурсниками
оживить: оживила
ожидать: ожидают
оказываться: оказываются оказывается
окружать: окружающих
октябрь: октября
они: им них ними
опасный: опасных
описание: описание
описать: описанных описана
организация: организации организацию
орден: орден
оригинал: оригинала
ориентироваться: ориентироваться
основанье: оснований
основать: основанную
основной: основных
особенно: особенно
особняк: особняке
особо: особо
особый: особые
оставить: оставленный
остановиться: остановилась
остаться: оставшийся
отборочный: отборочных
отважный: отважная
отвар: отвар
ответить: ответить
ответственность: ответственности
отдел: отдел отдела
отдельный: отдельных отдельные
отец: отца отец
отзыв: отзывы
отказ: отказ
отменяться: отменяются
отместка: отместку
отметить: отметила
относиться: относится
отношение: отношения
отправить: отправить
отправиться: отправилась
отправляться: отправляются отправляется
отредактировать: отредактирована
отряд: отряд
охрана: охраны
оцепенеть: оцепеневшей
очень: очень
очередной: очередная
очки: очков
ошибка: ошибке
палочка: палочка
память: память
параметр: параметром
парк: парк
пародия: пародии
патронус: патронус
пенелопа: пенелопы
первое: первым первого первое первых
первоначально: первоначально
первый: первой первая первый
перевод: переводах
перед: перед
передвигаться: передвигается
передний: передние
перейти: перейти перешла
переть: при
переулок: переулке
персонаж: персонажа персонажами персонажи персонажей
персональный: персональные
петтигрю: петтигрю
печать: печати
пиджак: пиджака
писательница: писательница
писать: пишет
письменный: письменные
письмо: письма
питер: питера
плакать: плакать
пламя: пламени
планировать: планировала
побывать: побывав
поведение: поведения
подарить: подарили
подарок: подарок подарке
подбородок: подбородка
подготовить: подготовленная
подготовиться: подготовиться
поддельный: поддельном
подождать: подождала
подозревать: подозревает
подозрение: подозрения
подробный: подробнее
подумать: подумать
подумывать: подумывала
пожертвовать: пожертвовать
пожиратель: пожирателям пожирателей пожиратели
позаимствовать: позаимствовала
поздний: позднее позже
поиск: поиски поиск поиску
пока: пока
показывать: показывает
покидать: покидали
покупать: покупает
пол: пол
ползучий: ползучего
политик: политик политика политике
положение: положение
полтергейст: полтергейстах
полуживотное: полуживотное
полукровка: полукровки полукровка
получать: получает
получеловек: получеловека
получить: полученные получить
поместье: поместье
помогать: помогает
помощь: помощью помощь
помфри: помфри
поначалу: поначалу
понимать: понимает
понять: поняли
попутный: попутно
поразить: поражена
портал: портале портал
поругаться: поругались поругавшись
порядок: порядку
посещать: посещать
последний: последнее последнюю последний последнего последней
посол: после
постепенно: постепенно
постоянно: постоянно
постоянный: постоянная
поступить: поступить
поступление: поступления
посылать: посылает
потерять: потерянной потеряла
поттер: поттером поттер поттера поттере
поттеромания: поттеромания
похожий: похожа
почему: почему
почтить: почти
появление: появление появления
появляться: появляется
правило: правилам
правильный: правильной
править: правила править правил
правка: правок правки
правопорядок: правопорядка
правый: прав
превосходный: превосходно
превращаться: превращается
предлагать: предлагала
предложение: предложениями
предложить: предложила
предмет: предмета предметы
представиться: представились
предшественник: предшественник
предыдущий: предыдущие
предыстория: предыстория
прежний: прежнего
прекрасный: прекрасной
преподаватель: преподаватель
преследователь: преследователям
префект: префект
приглашать: приглашает
приговор: приговора
придумать: придумала
придумывать: придумывает
приезжать: приезжает
признать: признают
признаться: призналась признаются
прийти: прийти
приказ: приказ
примета: приметы
примечание: примечания
принадлежать: принадлежала
принадлежность: принадлежность
принимать: принимать
принц: принца принц
принцесса: принцессы
принять: принял
прислать: прислать
приходиться: приходится
провал: провале
проверить: проверенная
проверка: проверки
проект: проектах
произведение: произведениях
произведенье: произведений
производство: производство
происходить: происходит
происхождение: происхождение
проклясть: проклятое
пропажа: пропажу
прорицание: прорицаниям
просмотр: просмотры
пространство: пространства
противник: противники
профессия: профессии
профессор: профессором профессора профессор профессору
прочий: прочее
прошлый: прошлое
проявиться: проявилось
проявлять: проявляет
прятать: прячет
пустить: пущенное
путеводитель: путеводитель
путешественник: путешественники
путешественница: путешественница
пуффендуй: пуффендуй
пытаться: пытается
пытка: пытками пыток пытки
пышный: пышные
пятый: пятая пятом
работа: работы
ради: ради
развиваться: развиваться
размер: размера
разработчик: разработчики
разрешать: разрешает
разрешение: разрешение
расписание: расписании
расправа: расправы
распределение: распределении
распределять: распределяющая
рассказ: рассказы
рассказывать: рассказывает
расследование: расследования
расстроить: расстроена
растение: растения
расходиться: расходиться
рациональный: рационального
ребенок: детей дети
ребята: ребята
регулирование: регулирования
регулярно: регулярно
редко: редко
рейтинг: рейтинге
религиозный: религиозные
решать: решают решает
решение: решение
рита: рита
ровный: ровными
род: род
родитель: родителям родителями родителей родители
родить: рождена
родиться: родилась
рождение: рождения
рождественский: рождественских
роза: роза
роль: роль роли
роман: романов
рон: рону роном рона рон
роулинг: роулинг
рубеус: рубеус
рука: руке
русский: русский
руфусу: руфусу
сам: сама
самый: самым самых самые
сантиметр: см
саундтрек: саундтрек
сборная: сборной
сведение: сведения
свежий: свежие
свободный: свободной
свое: свои своим своими
свой: свою
связанный: связано связанные
связаться: свяжитесь
святочный: святочный
сделать: сделала
северус: северус
седьмой: седьмая
секунда: секунду
семейный: семейное
семейство: семейства
семикурсника: семикурсника
семью: семью
семья: семья
сентябрь: сентябре сентября
сердечная: сердечная
сериал: сериал
серия: серии серию серия
силковый: силков
сильнодействующий: сильнодействующие
сириус: сириуса сириус
система: системе
ситуация: ситуации
сказать: сказать сказавшей сказала
сказка: сказки
скачать: скачать
скитер: скитер
скользкий: скользкого
скримджеру: скримджеру
скрытый: скрытые
слабый: слабых
следить: следить
слизерина: слизерина
слизнорту: слизнорту
слишком: слишком
слово: слова слово
сложный: сложней
служебный: служебные
случай: случаю случаях
случайный: случайная
смертный: смертного
смертоносный: смертоносных
смерть: смерть смерти
смеяться: смеются
снегг: снегг
снегга: снегга
соблюдение: соблюдение
собрание: собрания
собрат: собратьев
событие: события событий
сова: сову
совершаться: совершается
содержание: содержание
создание: создание
создатель: создатель
создать: создала создать
сознание: сознание
сокрытие: сокрытии
сообразить: сообразил
сообщать: сообщающая
сообщество: сообщество
сообщить: сообщить
соответственно: соответственно
сохранение: сохранением
социальный: социальный
спальня: спальням
спартанский: спартанского
спасать: спасают спасая спасает
спасаться: спасаясь
спасти: спасти спасла
специальный: специально
список: список
списывать: списывать
спокойный: спокойно
спора: споры
способствовать: способствовала способствует
справедливость: справедливость
справиться: справиться
справка: справка
сражаться: сражается
сразу: сразу
срикошетить: срикошетило
српски: српски
српскохрватски: српскохрватски
ссора: ссора
ссориться: ссорятся ссорится
ссылка: ссылка ссылками ссылки
стабильный: стабильная
становиться: становятся
стараться: старается
староста: старостой
статистика: статистика
статус: статус
стать: стала станут стали
статья: статья статье статьи
стебль: стебль
стирать: стирает
стоматолог: стоматологи
страница: страницы страница страницу странице
стремление: стремлением
студент: студенты
студентка: студентке
стычка: стычка
суд: суде
судьба: судьба
существо: существа существами
считать: считают
считаться: считалось
съесть: съел
сыграть: сыграла
сын: сын
сюда: сюда
тайный: тайная тайной
также: также
таки: таки
талантливый: талантливая
татарча: татарча
твой: твоими
текст: текст
текущий: текущие текущая
тем: тем
тематический: тематический
терять: теряя
товарный: товарный
тот: том те тот тому та
травологии: травологии
трансгрессировать: трансгрессировать
трансгрессирует: трансгрессирует
трелони: трелони
трепетный: трепетного
третий: третьей третья
трое: трое
троица: троицы
тролль: тролля
труба: трубы трубам
трудовой: трудовую
турнир: турнира
уверенность: уверенностью
уделять: уделяет
удивленно: удивленно
ужин: ужин
узнавать: узнавать
узнать: узнал
узник: узник
уизли: уизли
указание: указанием
указать: указан
улучшение: улучшению
умение: умение умением
уметь: умеет
умный: умной умные
уничтожать: уничтожает
уотсон: уотсон
урок: уроки уроках
усиленный: усиленно
условие: условий условия
успех: успехи успехами
утрата: утраты
уход: уходу
участие: участие
учащийся: учащаяся
учебник: учебнику
учебный: учебного учебные
ученик: учеников
ученица: ученица
учиться: учиться учились
факультет: факультета факультет
фальшивый: фальшивые
фамилия: фамилией
фанатичный: фанатичным
фантастический: фантастические
фанфике: фанфике
февраль: февраля
феникс: феникса
фигурировать: фигурирует
философский: философский философского
фильм: фильм фильме фильмов фильма
фонд: фонд
формальный: формальных
форум: форум
франция: францию
хагрид: хагрид
хагрида: хагрида
хагридом: хагридом
хагриду: хагриду
характеристика: характеристики
хобби: хобби
хогвартс: хогвартс
хогвартса: хогвартса
хогвартсе: хогвартсе
ходить: ходит
холодный: холодную
хороший: хорошие лучшую лучших лучшими наилучшее
храбрый: храбрая
хьюго: хьюго
хэллоуина: хэллоуина
царить: царя
целоваться: целуется
ценить: ценит
ценность: ценности
цепенеть: цепенеет
цепкий: цепкая
цикл: цикла
цитата: цитаты
цитировать: цитировать
чарли: чарли
часто: часто
часы: часов
чаша: чашу
человек: людях
чемпионат: чемпионат
черта: черта
честолюбивый: честолюбива
число: числе
чистокровный: чистокровных
чистота: чистота
чистый: чистой
читать: читать
член: члены
чрезмерный: чрезмерно
чтобы: чтобы
чудовище: чудовище
чужая: чужими
чуть: чуть
шармбатон: шармбатон
шекспир: шекспира
шестая: шестая
школа: школах школы
шляпа: шляпа
шрам: шрам
э: э
эйлин: эйлин
экзамен: экзамене экзамены экзаменах
экспресс: экспрессе
элемент: элемент
элиезер: элиезера
эльф: эльфов
эмма: эмма
энциклопедия: энциклопедии
это: этом это этому этим
этот: эта
юдковского: юдковского
являться: является
язык: язык языках
январь: января
ярко: ярко
