август: августа
австралийский: австралийского
автомобиль: автомобиль
автор: автора автор
авторский: авторские
авторство: авторства
адаптация: адаптации
азкабан: азкабан
азкабана: азкабана
акромантула: акромантула
активный: активных
алфавит: алфавиту
альбус: альбус
альбуса: альбуса
американский: американская
англ: англ
английский: английский
апрель: апреля
арагог: арагог
арагога: арагога
аргус: аргуса
арест: ареста
артур: артуром артура артур
архивировать: архивированная архивировано
ассоциация: ассоциация
баллада: балладу
барда: барда
бардак: бардак
барьер: барьер
беда: беда
бежать: бегущая
безголовый: безголового безголовый безголовому
бездарный: бездарным
беларуская: беларуская
белизна: белизна
бестселлер: бестселлеров
библиографический: библиографических библиографическими
библиотека: библиотек
библиотечный: библиотечной
бидля: бидля
биннс: биннс
битва: битву битвы
благодаря: благодаря
благоприятный: благоприятные
бладжер: бладжер
бладжеров: бладжеров
бой: боя
больничный: больничное больничном
большой: большой
борьба: борьбе
бояться: боятся боится
брат: братом братья
брать: берут
британский: британского британским
бронвин: бронвин
будущее: будущего
буквальный: буквально
български: български
быть: были
бюрократия: бюрократию
вагнер: вагнер
важный: важнейшим важной важных важные
вакансия: вакансия
варить: варит
василиск: василиском василиска василиск василиску
введение: введением
ввод: вводу
вдобавок: вдобавок
великобритания: великобритании
вернее: вернее
вернона: вернона
верность: верность
веровать: верующих
версия: версия версии
весить: весь
вести: ведут
весь: вся
вечно: вечно
вещь: вещи
взгляд: взглядом
взросление: взросление
взрослый: взрослых
взрываться: взрывается
взять: взять
вид: виде
видеоигра: видеоигра
видеть: видели видят видел
видимость: видимости
викиданных: викиданных
викимедиа: викимедиа
википедии: википедии
википедия: википедия
викисклад: викисклад
викискладе: викискладе
винсент: винсенту
висеть: висящую
вклад: вклад
включить: включила
владелец: владельца
владеть: владеющим
власть: власти
вместе: вместе
вместо: вместо
внешний: внешние
вода: водой
водитель: водителей
возвращаться: возвращается возвращаются
возвращение: возвращение
возможно: возможно
возраст: возрасте
возрождаться: возрождаться
войти: войти
вокзал: вокзалу
волан: волан
волна: волну
волос: волос
волосок: волоску
волшебник: волшебником волшебника волшебников волшебник волшебники
волшебный: волшебную волшебные волшебных волшебный волшебное
волшебство: волшебства
воля: волю
вонзать: вонзает
вопрос: вопросы вопрос
воровать: ворующего
воспоминание: воспоминание воспоминания воспоминаниях
восторженно: восторженно
восторженный: восторженные
восхвалять: восхваляли
впервые: впервые
впечатлит: впечатлит
вполне: вполне
враг: враги
врезаться: врезаются
время: время
все: всему всех всего
всеять: всей
вскоре: вскоре
вспоминать: вспоминает
встретить: встретили
встречать: встречает
встречаться: встречается
встроить: встроил
вступить: вступить
всякая: всякой
всячески: всячески
второе: втором
второй: вторая вторую второй
выбить: выбьет
выбор: выбор выбора
выбрасывать: выбрасывает
выбраться: выбравшись
выводить: выводят
вывозить: вывозит
вызвать: вызвала
выздоравливать: выздоравливают
вызывать: вызывает
выйти: вышел вышедшая
вылечить: вылечить
выпивать: выпивают
выпускать: выпускает
выпустить: выпустили выпустит выпустило выпущена
вырасти: выросшим
вырывать: вырывают
высокомерный: высокомерного высокомерному
вытаскивать: вытаскивают
вытащить: вытащить
вычеркнуть: вычеркнула
вычитать: вычитать
выясняться: выясняется
гарри: гарри
гера: герою
гермиона: гермиона гермионы
героизм: героизме
герой: героя героев герои
главное: главному главного
глаз: глаза
глупый: глупых
гневный: гневное
говорить: говорит говоря говорила
год: году годе лет год годы года
годовщина: годовщины годовщину
годрик: годрик
годрика: годрика
гойла: гойла
гойлу: гойлу
голос: голосов голоса
город: город
грегори: грегори
грейнджер: грейнджер
гремучий: гремучую
гриффиндор: гриффиндор
гриффиндора: гриффиндора
гриффит: гриффит
гришема: гришема
грозить: грозит
грубый: грубых
грэм: грэм
давать: дают
давность: давности
далекий: подальше
дамблдор: дамблдор
дамблдора: дамблдора
дамблдором: дамблдором
дар: дар дары
дата: дата
даффи: даффи
два: два
дверь: дверь
де: де
дебаты: дебатов
дебора: дебора
девочка: девочка девочку девочки девочкой девочек
действие: действия
действовать: действовать действуют
декабрь: декабря декабрь
делать: делает
делиться: делилась делиться
дело: делом
демонстрировать: демонстрирует
день: дней
держать: держал
деталь: деталей
детская: детскую детской детская
деть: день дело
деятель: деятелей
дж: дж
джастин: джастин
джейкобсон: джейкобсон
джинни: джинни
джоан: джоан
джон: джона
джордж: джордж
дилогия: дилогия
дина: дина
директор: директора
дитя: дитя
дневник: дневнике дневник дневника
добавить: добавить
добби: добби
добираться: добирается
догадываться: догадываются
док: док
доказательство: доказательства
доказать: доказать
доказывать: доказывал доказывает
долгий: долгое
долгопупсом: долгопупсом
должность: должность
дома: дома
домашний: домашнего
домовой: домовой домовому
дописать: дописать
дополнительный: дополнительные
допускать: допускал допускать
дорога: дорогу
доставлять: доставляет доставляют
достаточно: достаточно
доступный: доступен
драка: дракой
драко: драко
древность: древности
друг: друзья друзей
другой: другим другие других
дружба: дружба
дурмстранг: дурмстранг
дурной: дурная
дуэль: дуэли
дуэльный: дуэльном
дэвис: дэвис
дядя: дяди дядя
едва: едва
ехать: ехать едут
жанр: жанр
жертва: жертвами жертвы
живой: живую жива
животное: животное
жизнь: жизни жизнь
жуткий: жуткой
забрало: забрала
забросить: заброшенный
завоевать: завоевала
завхоз: завхоза
загадочный: загадочным
заглавный: заглавная
заканчиваться: заканчивается
заклятие: заклятием
заколдованный: заколдованной заколдованную
заколдовать: заколдовал
заколдовывать: заколдовывать
закрывать: закрывая
закрытие: закрытия
залечивать: залечивают
залить: залитом
заложить: заложенные
заложник: заложники
замаскироваться: замаскироваться
заменить: заменить
заметить: заметив
замечать: замечают
замок: замок
занимать: занимает
заниматься: занимаются
занятие: занятия занятии
занять: заняла
запись: запись
запретить: запрещены
запретный: запретного запретное
запрещаться: запрещается
запутанный: запутанной
зарегистрировать: зарегистрированный
заслуга: заслуги
заснуть: заснувших
заставить: заставив
заступаться: заступается
затапливать: затапливает
затем: затем
захватывать: захватывает
защита: защиты
заявление: заявление
заявлять: заявляет
званый: званый
зверь: звери
здание: здания
здоровый: здоровой
зелье: зельем зелье
зенгер: зенгер
златопуст: златопуст
златопуста: златопуста
златопустом: златопустом
зло: зла
злободневный: злободневная
змееуст: змееуст
змеиный: змеиным
змея: змей змею змея змеями
знак: знак
знакомиться: знакомится знакомясь
знаменитость: знаменитостей
знать: знает знают
значение: значения
значительно: значительно
зов: зов
золотой: золотую
зрелый: зрелом
зрение: зрения
ив: иву
игра: игра игры
игрок: игроков
идти: идут шедшую
избивать: избивали
избранный: избранные
известный: известной известнейшим
издание: издания издании
издатель: издателям
издательство: издательством издательство
изменение: изменение
изначально: изначально
изображение: изображение
изолировать: изолирует
икабог: икабог
именно: именно
импровизированный: импровизированном
имя: имя имени
индустрия: индустрии
иной: иными
иносказательный: иносказательно
инструмент: инструменты
информация: информация информацию информацией
искать: ищут
искусство: искусств
использование: использования использованием
использовать: использующие
исправить: исправили
истерик: истерики
истинный: истинное истинного
истолковывать: истолковывает
история: историю история истории
источник: источников источники источниками источником источник
исходить: исходящие
исцелять: исцелять
итог: итоге
июль: июля июль
июнь: июня июне июнь
кабинет: кабинете
каждый: каждого
какой: какую какими
камень: камень камне
кандида: кандида
каникулы: каникулах
карнеги: карнеги
карточный: карточная
кассовый: кассовых
каталог: каталогах
катберт: катберт
категория: категории
квиддич: квиддич
квиддичу: квиддичу
квинсленд: квинсленд
кен: кен
кинг: кинга
кингс: кингс
клуб: клубе
клык: клыка клык клыками
клэнси: клэнси
книга: книг книгах книги книгу книгой книге книга
книжный: книжном книжной
когтевран: когтевран
когтеврана: когтеврана
код: код
кодекс: кодекс
кой: кое коих
колдовать: колдовать
колин: колином колина
коллега: коллег
коллекционный: коллекционная
кольцо: кольцо
команда: команде
комната: комнате комнату комната комнаты
конец: концов конце
конкретизация: конкретизации
конструктор: конструктор
контроль: контроль
конфиденциальность: конфиденциальности
кончаться: кончается
копия: копия
коридор: коридоре коридоров
корморане: корморане
корнуэльский: корнуэльские
короткий: короткие короткий
кость: костей кости
котлы: котлов
который: которым которое которому которой которую которого которые которых которая котором который
кошка: кошку кошка
крайне: крайне
красный: красным
краузе: краузе
кривить: криви
кристал: кристал
критик: критиков
критика: критику критики критика
критически: критически
критический: критический
кричать: кричит
кровь: кровью кровь
кроме: кроме
кросс: кросс
крыло: крыле
крыть: крыло
крэбба: крэбба
крэббу: крэббу
кто: кем кого
кубок: кубок
куда: куда
кук: куки
кукушка: кукушки
кыргызча: кыргызча
лаборатория: лаборатория
лагерь: лагеря
лаудон: лаудон
легенда: легенде легенду
лес: лесу леса
лесничий: лесничего
летать: летать
лететь: летящий
летие: летия
летний: летней
лето: лето
лжец: лжеца
либо: либо
линия: линию
линт: линт
лист: лист
литература: литература литературе
литературный: литературные
лицензия: лицензии
лицо: лицо лица
личина: личинами
личной: личным личные
личность: личностью личность личности
лишение: лишениях
лишь: лишь
ловить: ловит
локация: локации
локонс: локонс
локонса: локонса
локонсом: локонсом
локонсу: локонсу
ломать: ломает
лондон: лондоне
лорд: лорд
любимец: любимцем
любить: любит
любовь: любовь
любой: любые любого
люциус: люциус
люциуса: люциуса
магазин: магазине
магический: магическую магических магическом
магия: магия магию магии магией
маглам: маглам
маглов: маглов
магловской: магловской
магловскую: магловскую
маглорожденные: маглорожденные
маглы: маглы
майя: май
макгонагалл: макгонагалл
македонский: македонски
макнил: макнил
малфои: малфои
малфой: малфой
малфою: малфою
малфоя: малфоя
малфоям: малфоям
малфоями: малфоями
мандрагора: мандрагор
манипулировать: манипулировал
мантия: мантией
маргарит: маргариты
маркетт: маркетт
марта: марта
маскарад: маскарад
материал: материал
матч: матч
мать: матерью
машина: машину машине машина
мая: мая
медаль: медаль
медиафайлы: медиафайлы
мелочь: мелочью
менее: менее
мера: мер
мессенджер: мессенджером
место: место места
меч: меч
мимси: мимси
минерва: минерва
министерство: министерства министерство
мир: мира мир мире
мирно: мирно
мировой: мировой
миртл: миртл
миссис: миссис
мистер: мистер
многие: многие многих
много: более много
мобильный: мобильная
могила: могила
могущественный: могущественной
можно: можно
мозги: мозгов
молли: молли
момент: момент
монгол: монгол
моральный: моральное моральных
морт: морт
морта: морта
мотив: мотивы
мочь: мог могут могла
мудрый: мудрыми
мы: нами
мыслить: мыслить
мэри: мэри
мяч: мячей
набрасываться: набрасывается
навигация: навигации навигация
навредить: навредили
награда: награду наград награды
награждать: награждая
над: над
надпись: надпись надписью надписи
назад: назад
название: название
назвать: назвала назвать
назначать: назначает
назначение: назначении
назойливый: назойливых
называть: называет называющий называл
найти: нашли найдена нашла
наказание: наказания
наказывать: наказывают
накричать: накричать
нападение: нападений нападениям нападения нападениями
написание: написания
написать: написанный написано написанной написать
напоминать: напоминая
направлять: направляют
например: например
напрямую: напрямую
нарушать: нарушать
нарушить: нарушить
насквозь: насквозь
насколько: насколько
наследник: наследника наследником
насчитаться: насчиталось
натравить: натравил
наутро: наутро
находить: находят
находиться: находится находятся
начальник: начальникам
начаться: начавшийся
начинать: начинает
начисто: начисто
наш: наших
неавторитетный: неавторитетными
небо: небе
неверный: неверный
невидимка: невидимкой
невидимость: невидимости
невиллом: невиллом
невредимый: невредимая
неделя: недель
недопустимый: недопустимым
недостаток: недостатков
недостоверный: недостоверный
нежелание: нежелания
незол: незол
неинтересно: неинтересно
некий: неким некое
некоммерческий: некоммерческой
некомпетентность: некомпетентность
некомпетентный: некомпетентных
некорректный: некорректный некорректным
некоторые: некоторые
некоторый: некоторую
нела: нел
нельзя: нельзя
нелюбимый: нелюбимые
немагическое: немагическое
немыслимый: немыслимую
ненависть: ненавистью
ненароком: ненароком
ненужный: ненужной
неопр: неопр
неохота: неохотой
неполный: неполный
непричастность: непричастность
непричастный: непричастен
неприятность: неприятностями
неравнодушный: неравнодушна
несколько: нескольких несколько
несмотря: несмотря
несчастие: несчастью
неудачно: неудачно
нечистокровный: нечистокровных
ника: нику ника
никакой: никакой
никнуть: ник
никогда: никогда
николас: николас
ничто: ничем
новый: нового новыми новые
номер: номером
номинация: номинации
норрис: норрис
ночь: ночь ночью
ноябрь: ноября
об: об
оба: обоим оба
обвал: обвалом
обвинение: обвинения
обвинить: обвинили
обеспечивать: обеспечивает
обитание: обитания
обитать: обитает
обладать: обладает
обложка: обложка
обманщик: обманщик
обнаруживать: обнаруживает обнаруживают
обнаружить: обнаружены
оболванить: оболванен
оборотный: оборотное
образование: образовании
обращение: обращения
обрушиваться: обрушивается
обсуждение: обсуждение
обусловить: обусловлен
общаться: общаться
объект: объектами
объявлять: объявляет
объяснимый: объяснимым
обычно: обычно
обязанность: обязанностей
оглашать: оглашать
оглупеть: оглупевшего
огонь: огня
ограничительный: ограничительных
огромный: огромного огромная
один: одну одной одна одном один одно одним одни
одиночество: одиночестве
одиночка: одиночку
одичать: одичавший
однако: однако
одноклассник: одноклассники
однокурсник: однокурсника
оказаться: оказалась оказавшийся
оказываться: оказывается
окно: окна
около: около
октябрь: октября
они: им ими них
онлайн: онлайн
опасаться: опасалась
опасность: опасность
опасный: опасных опасной опасен опасное
опередить: опередила
опечатка: опечаток
описание: описания описание
описать: описала
опоздать: опоздать
определять: определяет
определяться: определяется
опубликовать: опубликовали опубликована
опытный: опытными
организация: организации
орден: орден
оригинал: оригинала
освобождать: освобождает
основатель: основатель
основной: основные
особенно: особенно
особый: особые
осознавать: осознают
оставлять: оставляют
остановить: остановить
острый: острыми
отбирать: отбирает
ответственность: ответственности
ответственный: ответственный
отвечать: отвечать
отдельный: отдельных отдельные
отец: отца
отзыв: отзывы
отказ: отказ
отказаться: отказалась
отказываться: отказывается
откровенный: откровенной
открыть: откроет открытый открыв открыта
откуда: откуда
отличаться: отличаться
отличный: отличным отличный
отломиться: отломился
отменяться: отменяются
отметить: отметили отмечено отметила отмечена отметил
отмечать: отмечает отмечая
относительно: относительно
относиться: относятся
отношение: отношений отношении
отобрать: отобрал
отогнать: отогнать
отомстить: отомстить
отправлять: отправляют
отправляться: отправляются отправляется
отпугнуть: отпугнула
отпустить: отпустить
отражение: отражение
отредактировать: отредактирована
отряд: отряд
отстранять: отстраняют
отсутствие: отсутствие
отсюда: отсюда
оттуда: оттуда
отшибать: отшибает
оцепенение: оцепенения оцепенении
очень: очень
очередной: очередную
ошибка: ошибке ошибки
ошибочно: ошибочно
падать: падают
палочка: палочку палочка
память: памяти память
паника: паника панике
парк: парк
пародия: пародии пародию пародия
паук: паука пауков пауки пауками
пенелопа: пенелопа
пение: пения пением
первое: первого первом
первый: первой первую первая
перед: перед
переживание: переживаниями
перейти: перейти
перелом: перелом
переносить: переносит
пересекаться: пересекаются
пересмотреть: пересмотреть
переть: при
перехватывать: перехватывал
переход: переходом
перечитать: перечитать
перси: перси
персонаж: персонажи
персональный: персональные
петухов: петухов
петушиный: петушиной
петь: пел
печатный: печатные
печать: печати
пикси: пикси
писатель: писатель
писать: писала
письменный: письменных
письмо: письмо писем письма
плакса: плаксы плакса
план: плане
планировать: планировал
платиновый: платиновую
платформа: платформу
племянник: племянника
плохо: плохо
плохой: худшем худшей
победа: победу
поведение: поведение поведения
повесить: повесила
повод: поводами поводу
погибать: погибали
погибнуть: погибшей
подавить: подавлены
подарок: подарков
подбросить: подбросил
подвал: подвалах
подвиг: подвиги
подземелье: подземелья
поднять: поднятый
подобрать: подобрать
подозревать: подозревают
подозрение: подозрения
подозрительный: подозрительные
подоспевать: подоспевает
подробный: подробнее
подруга: подруга
подсказка: подсказкой подсказок
подсовывать: подсовывают
подставлять: подставляя
подстроить: подстроил
подтверждать: подтверждаемым
поезд: поезд
пожертвовать: пожертвовать
пожиратель: пожиратели
позволить: позволить
поздний: позже
позиция: позицию
поиск: поиск поиску
пока: пока
показать: показать
поклонник: поклонников
полагать: полагает
поле: полю
ползать: ползать
политик: политика политике
полный: полную
полтергейст: полтергейстах
полукровка: полукровкой полукровкам полукровка
получать: получает получаемая получала получал
получить: получила получить
получиться: получилась
помешать: помешан
помимо: помимо
помогать: помогать
помощь: помощь
понять: понять
попадание: попаданием
попадать: попадают
попасть: попал попасть попало
попутный: попутно
попытаться: попытавшись
попытка: попытками попытку
порпингтон: порпингтон
портал: портал
портить: портит
поскольку: поскольку
послание: послание
последний: последний
посол: после
поставить: поставлен
постоянно: постоянно
постоянный: постоянная
пострадать: пострадал пострадала пострадавшие
поступать: поступает поступать
потомок: потомком потомок
поттер: поттер поттера поттере
поттерианы: поттерианы
похвалить: похвалил
похищать: похищает
почта: почту
почтить: почти
поэтому: поэтому
появиться: появись
появление: появление
появляться: появляется
правда: правда правду
правило: правилам
править: править правил
правка: правки
право: праву
правый: права
пратчетта: пратчетта
пребывать: пребывать
превратиться: превратиться
превращаться: превращаются превращаясь
предлагать: предлагает
предмет: предметы
предок: предком
предрассудок: предрассудки
представить: представленной
представиться: представились
представление: представление
предстоять: предстоит
предыдущий: предыдущее
предыстория: предыстория
преждевременный: преждевременными
презрение: презрения
премия: премией премии премию
преподаватель: преподавателей
преследование: преследование
преследовать: преследовать
преступление: преступлениям преступлении
приводить: приводят приводит
признать: признал признала признают признаны признали
призрак: призрак
призыв: призыв
прилетать: прилетают
прилететь: прилететь
применять: применяя
пример: примером
примереть: пример
примечание: примечания
примечательный: примечательных
принц: принц
принять: примут
приписать: приписавший
природный: природный
прислуживать: прислуживает
приструнить: приструнить
приступать: приступают
присудить: присудил
присылать: присылает
приходить: приходят приходит
причастный: причастен
причина: причинам
про: про
пробиться: пробиться
проблема: проблема проблемы
проблемный: проблемных
проверить: проверенной
проверка: проверки
проверять: проверять
проверяться: проверялась
провиниться: провинившихся
проводить: проводит
проговариваться: проговаривается
продолжиться: продолжился
проедать: проедает
проект: проектах
проекция: проекция проекцией
проиграть: проиграна
произведение: произведения
производство: производство
произойти: произошла
происходить: происходят происходит происходящем
происшествие: происшествие
пройти: пройти
прокалываться: прокалывается
прокат: прокат
прокатываться: прокатываются прокатывается
проклясть: проклятое
промывание: промывание
пропаганда: пропагандой
просмотр: просмотры
просто: просто
простой: простым
пространство: пространства
проступок: проступки проступок
протест: протеста
протестовать: протестовали
против: против
противник: противника противник
противоположность: противоположностью
профессор: профессором профессора профессор профессору
прочий: прочее
прочитать: прочитать
проявление: проявление проявлениях
проявляться: проявляется
прямая: прямой
прямой: прямом
прятать: прячут
прятаться: прячутся
публикация: публикации
пугать: пугающей
пустой: пустыми
пустота: пустоту
путеводитель: путеводитель
пуффендуй: пуффендуй
пытаться: пытаться пытается пытаясь
пять: пяти
работа: работы работа
работать: работала
равный: равно
разгадать: разгадать
разгар: разгар
разгневать: разгневанные
разговор: разговор разговора
раздел: разделе
разделить: разделивших
разноситься: разносится
разный: разных разному
разоружение: разоружения
разработчик: разработчики
разум: разумом
рана: раны рану
ранение: ранение
ранний: раньше раннее
расизм: расизма расизм
раскрыть: раскрыли
распределять: распределяющей распределяющая распределяющую
рассказ: рассказы
рассказать: рассказать
рассказывать: рассказывает рассказывают
расследование: расследованию
расследовать: расследуют
рассориться: рассорился
расширение: расширение
реагировать: реагируют реагирует
ребенок: детей
ребята: ребят ребята
регулярно: регулярно
редактор: редакторов редакторам
редакция: редакции
реддл: реддл
реддла: реддла
реддлом: реддлом
редко: редко
религиозный: религиозных религиозные
рептилия: рептилию
ресурс: ресурсы
решать: решает
решаться: решаются решалась
решить: решила
родственник: родственники
рождение: рождения
рождественский: рождественский
роман: романов романа роман романы романах
рон: рону рона рон
рост: роста
роулинг: роулинг
рубеус: рубеус
рубеуса: рубеуса
рука: руке руку рукой руками руки
руководитель: руководителям
рукопись: рукопись
русский: русский
ряд: рядом
сайт: сайте сайты
салазар: салазар
салазара: салазара
сам: самого самой самому самим сама самое
самооборона: самообороны
самопиара: самопиара
самопожертвование: самопожертвование самопожертвования
самый: самый самых
сантиметр: см
саундтрек: саундтрек
сбежать: сбежать
сбоить: сбоят
сведение: сведения
свежий: свежие
света: свете
светский: светский
свободный: свободной
свое: своих свои своего своим своими
свой: свой своей свою
связанный: связанные
связаться: свяжитесь
сдать: сдав
сделать: сделанный сделал
северус: северус
седьмой: седьмой седьмую
семью: семью
семья: семья семей семьи
сентябрь: сентябрь сентября
сердце: сердце
сериал: сериал
серия: серии сериях серию серия
сестра: сестрой
сесть: сесть
сила: силой
сильный: сильный
сирота: сиротой
система: системе
ситуация: ситуацию ситуации
сказка: сказки
скачать: скачать
скелет: скелет
сколько: сколько
скорый: скорее
скрывать: скрывает
скрываться: скрывается
скрытый: скрытые
скрыть: скрыть
сладость: сладости
следовать: следуя следует следовать следуют
следующий: следующее следующими
слеза: слезами
слизерин: слизерин
слизерина: слизерина
слизерине: слизерине
слизеринцев: слизеринцев
слизеринцу: слизеринцу
слишком: слишком
словарь: словари
слово: словам словами
сломать: сломанная
служба: службе
служебный: служебные
служить: служит служить
слух: слухи
случай: случаю случаях случаев
случайно: случайно
случайный: случайная случайных
случаться: случается
случиться: случившемся случилось
слышать: слышать слышал слышит
смертельный: смертельная
смерть: смерть смерти
смотреть: смотрели смотрят
смочь: смогли смог
смысл: смысле
снегг: снегг
снеггом: снеггом
снимать: снимают
снитч: снитч
снова: снова
снять: снятый
собирательный: собирательную
собираться: собиралась собирается
собственный: собственного
событие: событиям события
совершать: совершаемые совершал
совет: совет
советовать: советует
согласный: согласны
содержание: содержание
содержимое: содержимым
создание: созданиям
создать: созданных создать
сознаться: сознаться
сокрыть: сокрытая
сонный: сонным
сообщение: сообщениях
сообщество: сообщество
сообщить: сообщить
соответствующий: соответствующие
сородич: сородичей
состояние: состоянии
сотворить: сотворил
сотня: сотни
сохранение: сохранением
социальный: социальных
спам: спам
спасать: спасают спасает
спасение: спасения
спешить: спешит
список: списке список
спора: споры
способность: способность
справиться: справился
справка: справка
спрашивать: спрашивает
сравнить: сравнили
среди: среди
српски: српски
српскохрватски: српскохрватски
срывать: срывает
ссылка: ссылка ссылками ссылки ссылок
ставить: ставя
сталкиваться: сталкивается
становиться: становятся
староста: староста старостой
старший: старшим
статистика: статистика
статус: статусов
стать: стала ставшую
статья: статья статье статьи
стая: стая
стен: стен стенах стене
стереть: стереть
стивен: стивена
стоить: стоит
столкнуть: столкнуть
столько: столько
сторона: стороны
страйке: страйке
страница: страницы страницами страница страницу страниц странице
странный: странное странные странный
страх: страха страх
страшный: страшный страшной
строгий: строго
строиться: строится
строка: строк
студент: студент
стюарт: стюарт
существо: существо существа
существовать: существуют
схватка: схватку
схожий: схож схожа
считать: считали
считаться: считается
сша: сша
сын: сыну
сэр: сэр
сюда: сюда
сюжет: сюжет
сюрприз: сюрпризов
т: т
таинственный: таинственные
тайна: тайну
тайный: тайная тайно тайной тайную
также: также
такой: такой таким такая такие
талант: талантах талантами
татарча: татарча
тварь: тварь
текст: текст
текущий: текущие текущая
тело: тела тело
телохранитель: телохранителям
тем: тем
тема: тему тема темами темы
тематический: тематический тематические
теория: теории
термин: термина
терри: терри
техник: технику
техника: техникой
тип: типа
товарный: товарный
толщина: толщины
том: томом тома
томас: томаса томас
торт: торте
тот: том тех те тот той
точка: точки
точно: точно
трагедия: трагедия
требовать: требовал требующие требуют
трепетать: трепещите
третий: третья
трое: трое
троица: троица
труба: трубам
трудолюбие: трудолюбием
туалет: туалет туалете туалету туалета
туда: туда
туповатый: туповатым
тэмми: тэмми
тюрьма: тюрьму
тяжелый: тяжело
убедить: убедить
убивать: убивала убивает
убить: убить убила убита
уважение: уважение
увлекаться: увлекается
уводить: уводят уводя
уговор: уговоры
угол: углу
угроза: угроза угрозе угрозой
удалить: удалить
удалять: удаляет
удар: удар удара
удаться: удалось
удачный: удачным
удостоить: удостоен
ужин: ужин
узнать: узнают
узник: узник
уизли: уизли
уильям: уильям
уильямс: уильямс
указание: указания указанием
указать: указано указан указал
указываться: указывается
улика: улик
улучать: улучает
умереть: умер
уметь: умеющий
университет: университета
уникальный: уникальными
уничтожить: уничтожит уничтожена
упоминание: упоминание
упомянуть: упомянутый
урок: уроке уроки
условие: условий условия
усложнять: усложняет
усомниться: усомниться
успевать: успевает
успех: успех
успешный: успешно
установить: установить
установка: установки
устраивать: устраивает устраивают устраивая
утверждать: утверждает
уточнение: уточнения
уточнить: уточнить
участие: участие
участник: участниками
учебник: учебников
учебный: учебном
ученик: учеников ученики учеником
учитель: учителя
учиться: учился
факел: факела
фактически: фактически
факультет: факультета
фантастика: фантастики
фантастический: фантастические
фарс: фарс
февраль: февраля
феникс: феникса фениксом
филипп: филипп
философский: философский философском
филча: филча
фильм: фильм фильмов
финальный: финальную
финч: финч
флетчли: флетчли
фонд: фонд
форум: форум
фотограф: фотографом
фотокамера: фотокамерой
фоукс: фоукс
фоукса: фоукса
фоуксом: фоуксом
фред: фред
фэнтези: фэнтези
хагрид: хагрид
хагрида: хагрида
хагридом: хагридом
характер: характера
хитрость: хитростью
хитрый: хитрыми
хобби: хобби
хогвартс: хогвартс
хогвартса: хогвартса
хогвартсу: хогвартсу
ход: ходе
хороший: лучших хорошей
хорошо: хорошо
хотеть: хочет
хронология: хронология
худой: хуже
хэллоуин: хэллоуин
целый: целом целая
цель: целью
цепенеть: цепенели
цикл: цикл
цитировать: цитировать
чар: чары
чарльз: чарльз
чародейство: чародейства
час: час
часто: часто
часть: часть
чат: чатом
чей: чьи
человек: человек людьми человека людей
человеческий: человеческое
чемпионат: чемпионат
через: через
чернильный: чернильно
черновик: черновики
черта: черт черты
четверо: четверо
чиновник: чиновники
чистить: чистить
чистокровный: чистокровные чистокровных
читатель: читателей
читать: читать
чтобы: чтобы
чудище: чудищем чудище
чудовище: чудовища чудовищем
чужая: чужие
шаблон: шаблонами шаблонов
шармбатон: шармбатон
шелкопряд: шелкопряд
шесть: шесть
шипение: шипения
шипеть: шипит
школа: школа школу школе школы
школьник: школьников
школьный: школьные школьных
шляпа: шляпу шляпе шляпы шляпа
шовинизм: шовинизма
шорты: шорт
шотланддский: шотланддский
штрафовать: штрафуют
эвфемизм: эвфемизмов
эдварда: эдвард
экзамен: экзамены
экранизация: экранизация
экспеллиармус: экспеллиармус
элемент: элемент
эльф: эльфа эльф эльфу
эми: эми
энциклопедия: энциклопедии
это: этом это этим
этот: этой эта
юмор: юмор
юмористический: юмористический
юный: юным юных юного
являться: является являются
явно: явно
яд: яд
ядовитый: ядовитыми
язык: язык языках языка языком
якоб: якобы
январь: января
яростно: яростно
