август: августа
автомобиль: автомобилем
автор: автор
авторство: авторства
адвокат: адвокаты адвокатов
азкабан: азкабан
азкабана: азкабана
айзекс: айзекс
айзексом: айзексом
актерский: актерскую
актриса: актриса
алан: алан
алник: алник
алфавит: алфавиту
альбом: альбом
альбус: альбус
альбуса: альбуса
аманда: аманда
американский: американский
англ: англ
английский: английский
анимация: анимация
апрель: апреля
арагог: арагог
арагогом: арагогом
аранжировка: аранжировкой
аргус: аргус аргуса
аристократический: аристократические
артур: артур артура
архив: архив
архивировать: архивировано
архитектурный: архитектурного
атака: атаке
атмосфера: атмосферу
аудитория: аудитории
баг: баг
балбес: балбесы
барбара: барбара
барда: барда
бегство: бегству
безголовый: безголовый
беларуская: беларуская
бесстрашный: бесстрашный
бета: бет
библиографический: библиографических
библиотека: библиотека
биггерстафф: биггерстафф
бидля: бидля
билл: билл
благодаря: благодаря
бладжер: бладжер
бладжеров: бладжеров
близнец: близнецам
блисдейл: блисдейл
богема: богема
бодлианский: бодлианская
больничный: больничном
больший: большим больше
бонни: бонни
браный: брана браной
брат: братьям
бреннан: бреннан
бригада: бригад
британский: британский
британско: британско
брэдли: брэдли
будущий: будущий
български: български
быть: бывшего
бюджет: бюджет
бюро: бюро
важный: важный
вариация: вариаций
варить: варят
василиск: василиска
вдохновить: вдохновила
вдохновляться: вдохновлялись
великобритания: великобритания великобритании
вернон: вернон
вернуться: вернуться вернулся
вероника: вероника
версия: версию версия
вечер: вечер
взгляд: взглядом
взрослый: взрослого
вид: вида вид
видеокассета: видеокассете
видеть: видели
визуальный: визуальные визуальных визуальным
викиданных: викиданных
викимедиа: викимедиа
викиновости: викиновости
википедии: википедии
википедия: википедия
викисклад: викисклад
викискладе: викискладе
викицитатник: викицитатник
викицитатнике: викицитатнике
виктор: виктор
витрина: витрине
вклад: вклад
включать: включающих
владимир: владимиром владимира владимировичем
властелин: властелин
власть: власти
вместе: вместе
внешний: внешние внешний
вновь: вновь
возвращаться: возвращается возвращаться
возвращение: возвращение
войти: войти
вокзал: вокзала вокзале
волан: волан
волшебник: волшебника
волшебный: волшебные волшебная волшебный
волшебство: волшебства
воплощение: воплощением
воспользоваться: воспользоваться воспользовавшись
воссоединяться: воссоединяется
вписаться: вписаться
впоследствии: впоследствии
враг: враги
врезаться: врезаются
временной: временной
время: время
все: всему
всеять: всей
вскоре: вскоре
встречать: встречает
встречаться: встречается встречаются
встречный: встречен
второе: вторым второго
второй: второй
вуд: вуд
вход: вход
выбор: выбор
выглядеть: выглядит
вызывать: вызывает
выйти: вышло
вымыслить: вымышленном
вынудить: вынудить
выпуск: выпуска
выпустить: выпустить выпустив выпустила выпущен
выражать: выражает
выразить: выразить выразили
высказать: высказал
выступить: выступила выступил
выяснять: выясняют
гарри: гарри
германий: германия
гермиона: гермиона гермионы гермионой гермиону
героизм: героизме
гибрид: гибрид
гигантский: гигантской гигантским
гильдия: гильдии
главное: главные главных
гловер: гловер
глостерский: глостерский
говорить: говоря
год: году лет год годы года
годрика: годрика
гойла: гойла
голова: головой
голос: голос
гоняться: гоняться
горбина: горбин
готовиться: готовящимся
граватт: граватт
грейнджер: грейнджер
гремлин: гремлины
гремучий: гремучую
грим: грим
гринт: гринт
гриффиндора: гриффиндора
гриффитс: гриффитс
грозить: грозит
грэм: грэм
грэмми: грэмми
давать: дающим
дадли: дадли
дадмэн: дадмэн
дамблдор: дамблдор
дамблдора: дамблдора
дамблдором: дамблдором
дамблдору: дамблдору
дань: дань
дар: дары
даремский: даремский
дата: дата
дать: данным
даутфайр: даутфайр
два: две двух
двухдисковом: двухдисковом
двухсотлетний: двухсотлетний
де: де
девон: девон
девочка: девочки девочек
девять: девять
действие: действием
действительно: действительно
действовать: действовать
декабрь: декабря
декорация: декорации декораций
демонстрировать: демонстрирует
деннис: деннис
день: дней дня
дерек: дерек
дефис: дефиса
дж: дж
джастин: джастин
джей: джей
джейми: джейми
джеймс: джеймс
джейсон: джейсон джейсоном
джексон: джексон
джемма: джеммой джемма
джим: джим
джинни: джинни
джипси: джипси
джоан: джоан
джон: джон джона
джонс: джонс
джордан: джордан
джордж: джорджу джордж
джули: джули
джулиан: джулиан
дизайн: дизайн
дилогия: дилогия
дистрибьютор: дистрибьютор
дитя: дитя
длина: длина
длительность: длительность
длительный: длительный
дневник: дневник дневника
добби: добби
добираться: добираться
догадаться: догадавшись
док: док
документальный: документальный
долгишев: долгишев
долгопупс: долгопупс
должен: должен
доллар: долларов
дом: дом домом
дома: дома
домашние: домашним
домовой: домового
дополнительный: дополнительные
дополнить: дополнила
допросить: допросить
дорн: дорн
дорожный: дорожных
доступный: доступен
драко: драко
древность: древности
друг: друзья друзьями другу
другой: другому другие других
дуглас: дуглас
дурмстранг: дурмстранг
дурслей: дурслей
дурсль: дурсль
дуэльный: дуэльном
дэвид: дэвид
дэвис: дэвис
дэниел: дэниел
дядя: дядя
е: е
едва: едва
жанр: жанры
железнодорожный: железнодорожная
женский: женском
жертва: жертвой жертвы
живой: живым
жизнь: жизнь
заблокировать: заблокировал
забрать: забрать
завершиться: завершились
завхоз: завхоза
заглавный: заглавная
задача: задачей
задействовать: задействовано
задумка: задумке
заключительный: заключительных заключительный
заколдованный: заколдованном заколдованный
заколдовать: заколдовал
закончить: закончить
заменить: заменить
замечать: замечает
замок: замке замок замка
заниматься: занимался
занять: занял
запись: запись
запретный: запретном
заработать: заработав
зарегистрировать: зарегистрированный
заставлять: заставляет
затем: затем
заточение: заточении
защита: защиты
заявить: заявил
заявление: заявление
заявлять: заявляет
зверь: звери
звук: звука звук
здание: здание
зелье: зелья
златопуст: златопуст
златопуста: златопуста
златопустом: златопустом
змееустом: змееустом
змеиный: змеиной
змея: змеи змею
знак: знак
знакомиться: знакомится
значение: значения
золотой: золотой
ив: иву
игра: игра игру игры
идти: идти
избавить: избавить
избранный: избранные
известно: известно
издание: издания изданием издании
изображение: изображением
иметь: имеет имели
иностранный: иностранный иностранном
инструмент: инструменты
интервью: интервью
интерьер: интерьера
ирма: ирма
иск: иска иски
искусство: искусств
исп: исп
исполнитель: исполнитель
исполнить: исполнили
использование: использования
использовать: использовал использующие
использоваться: использовалась
история: историю история
источник: источник
исцелять: исцеляют
исчезать: исчезает
исчезновение: исчезновения
июль: июля июле
июнь: июня
йетс: йетс
йорк: йорке
кабинет: кабинет кабинете
кадры: кадры
каждый: каждой
кажется: кажется
каменный: каменный
камень: камень камня
каникулы: каникулы
картина: картина картины
карточный: карточная
кассовый: кассовым
каталог: каталог каталогах
категория: категориях категории категория
качество: качества качестве
квиддич: квиддич
квиддичу: квиддичу
кеннеди: кеннеди
кеннет: кеннет кеннетом
кимберли: кимберли
кингс: кингс
киноакадемии: киноакадемии
кинокомпания: кинокомпании
кинокритик: кинокритиков
кинолента: кинолента
киносериал: киносериала
кинофильм: кинофильме
клайн: клайн
классический: классическим
клиз: клиз
клиффорд: клиффорд
кловис: кловис
кловиса: кловиса
клон: клонов
клуб: клуб клубе
клык: клыком
ключ: ключ
книга: книги книгу книга
книжный: книжных
ко: ко
код: код
кодекс: кодекс
коламбус: коламбус
коламбуса: коламбуса
колин: колин
коллекционный: коллекционная
колтрейн: колтрейн
кольцо: колец
коммерсантъ: коммерсантъ
комната: комнате комнату комната комнаты комнатой
композитор: композитора композитор
композиция: композиция
компьютерный: компьютерная компьютерную
конец: конце концу
конструктор: конструктор
контрастировать: контрастирующие
конфиденциальность: конфиденциальности
копье: копий
корнелиус: корнелиус
короткий: короткие короткий
космомагии: космомагии
косой: косой косом
костюм: костюмам костюмов
кот: кот
который: которое которую которого которые которых которая котором который
коулсон: коулсон
кошка: кошку
крайне: крайне
крейг: крейг
крепость: крепости
кривить: криви
крис: крис криса
кристиан: кристиан
критик: критиков
критика: критика критиками
кровь: кровью
кроме: кроме
кросс: кросс
кружка: кружка
крыло: крыле
крэбба: крэбба
крэйг: крэйг
кубок: кубок
кук: куки
культура: культура
купер: купер
кыргызча: кыргызча
кэнтуэлл: кэнтуэлл
ларусса: ларусса
леди: леди
лейн: лейн
леонарда: леонард
лес: лесу
лесли: лесли
лесничий: лесничего
летать: летающим летающей
летний: летние
линди: линди
листок: листок
лицензия: лицензии
лицо: лицо
лишение: лишениях
лишь: лишь
локация: локаций локации
локонс: локонс
локонса: локонса
локонсом: локонсом
ломать: ломает
ломаться: ломается
лондонский: лондонского
лоу: лоу
льюис: льюис
лэшбрук: лэшбрук
любить: любимый
люк: люк
люциус: люциус
люциуса: люциуса
люциусу: люциусу
м: м
магазин: магазинов
магазинный: магазинные
магия: магия магии
магла: магла
маглов: маглов
маглы: маглы
макгонагалл: макгонагалл
македонский: македонски
маленький: маленький
малфоем: малфоем
малфой: малфой
малфою: малфою
малфоя: малфоя
мальчик: мальчику
мантия: мантией мантию
маргулис: маргулис
марк: марк
маркус: маркус
марта: марта
мартин: мартин
материал: материал
матч: матч матча
мачеха: мачеха
машина: машине
мая: мая
медиа: медиа
медиафайлы: медиафайлы
мейсон: мейсон
меллинг: меллинг
мелодия: мелодия
менее: менее
меррин: меррин
место: место места
месяц: месяцев
меткий: метки
метр: метров
меховой: меховой
меч: меч
мидгли: мидгли
миллион: млн
мина: мин
минерва: минерва
министерство: министерство
министр: министр
мир: мира мир
мириам: мириам
миртл: миртл
миссис: миссис
мистер: мистера мистер
митчелл: митчелл
мнение: мнение
многие: многие
много: более
множество: множества
мобильный: мобильная
мода: моде
молли: молли
молния: молний
молодая: молодой
момент: моментом моменты
монгол: монгол
монстр: монстра
монтаж: монтаж
морт: морт
мортемор: мортемор
московский: московским
мочь: мог могут
мошенник: мошенника
мрачный: мрачными мрачный
мужчина: мужчину
музыка: музыкой музыку музыка
музыкальный: музыкальным
мультсериал: мультсериал
мутный: мутными
мы: нами
мэгги: мэгги
мэн: мэн
мэттью: мэттью
мюррей: мюррей
набор: набора
навестить: навестив
навещать: навещает
навигация: навигации навигация
награда: награду награда награды
награждение: награждения
нагромождение: нагромождением
над: над
назад: назад
название: названием
назначать: назначают
назойливый: назойливых
найт: найт
намекнуть: намекнуть
написать: написанным
напротив: напротив
напрямую: напрямую
наружное: наружного
наследник: наследника наследником наследник
научный: научно
находить: находят находит
начало: начала
начальник: начальник
начаться: начались
начинать: начинают начинает
наш: наших
невидимка: невидимкой
невилл: невилл
невиновность: невиновность
невольно: невольно
недовольный: недовольны
недостоверный: недостоверный
неизвестный: неизвестным
некий: неким некую
некоммерческий: некоммерческой
немой: нем немо
неопр: неопр
неполный: неполный
непростой: непростой
несколько: несколько
несмотря: несмотря
несоответствие: несоответствие
неудачник: неудачниками
нечеловеческий: нечеловеческий
никнуть: ник
новый: новым новый новые новых
номинанты: номинанты
номинация: номинация номинацию номинаций номинации
номинирован: номинирован
номинирована: номинирована
нора: нору норой
норрис: норрис
нортон: нортон
носить: носить
нохчийн: нохчийн
ночь: ночь
ноябрь: ноября
нью: нью
няня: няни
об: об
обвал: обвал
обвинить: обвинил
обитание: обитания
обитатель: обитателей
обитать: обитает
облик: облика
обложка: обложкой обложка обложек
обнаруживать: обнаруживает
обнаружить: обнаружив
оборотный: оборотного
образ: образов образом образ
обращать: обращающего
обращение: обращения
обсуждение: обсуждение
общаться: общаться
общественность: общественностью
общество: общества общество
общий: общей
огонь: огня
одежда: одежда
один: одном одного один
одинокий: одинокий
однажды: однажды
однако: однако
оживать: оживают
оказаться: оказалось оказавшемуся
окаменеть: окаменевшую окаменели окаменевшие
около: около
оксфордский: оксфордском
октябрь: октября октябре
оливер: оливер
она: ею
они: им
опасность: опасность
опасный: опасных
оператор: оператор
описание: описание описанием
определить: определят
опрос: опроса
организация: организации
орден: орден
оригинал: оригинала
освободить: освободить
оскорбительный: оскорбительным
ослеплять: ослепляет
основа: основе
основатель: основателей
основать: основана
основной: основные основной основная
оставить: оставить
остальное: остальных
остров: острове
отбирать: отбирает
ответственность: ответственности
отдельный: отдельных отдельные
отель: отель
отец: отца отец
отказ: отказ
отказываться: отказывается
открывать: открывает
открытие: открытии
открыть: открыть открыта
отметить: отметивших отмечена
отправить: отправленных
отправиться: отправиться
отправляться: отправляются
отражение: отражение
отредактировать: отредактирована
отряд: отряд
отсутствовать: отсутствующие
оттенок: оттенками
оттуда: оттуда
официальный: официальный
охватывать: охватывает
оценка: оценку оценкой
ошибка: ошибке ошибки
палочка: палочку палочка
память: память
панкрас: панкрас
парк: парк
пародия: пародии
партитура: партитуры
паук: пауком пауками
первое: первых
первоначальный: первоначальной
первый: первой
перед: перед
перейти: перейти перешла
переть: при
переулок: переулке переулок
перси: перси
персонаж: персонаж персонажа персонажи персонажей
персонал: персонал
персональный: персональные
перспектива: перспектива
петунья: петунья
печать: печати
пижон: пижоном
пиксель: пиксели
пинс: пинс
плакса: плаксы плакса
план: плана
планировать: планирует
платина: платина
платформа: платформой платформе платформу
племянник: племянника
победа: победу победа
победить: победил
поведение: поведения
погибнуть: погибли погибшей
подвесить: подвешенную
подготовка: подготовке
подкладка: подкладки
подложить: подложил
подобный: подобные
подробный: подробнее
подсовывать: подсовывает
подтверждать: подтверждающим
подходить: подходящую
подчеркнуть: подчеркнуть
пожертвовать: пожертвовать
пожиратель: пожиратели
поздний: позже
поиск: поиск поиску
поймать: поймать поймай
показываться: показывается
покидать: покидает
покинуть: покинуть
политик: политика политике
полнометражный: полнометражных
полный: полную
положительно: положительно
полоска: полоску
полтергейст: полтергейстах
полукровка: полукровка
получать: получает
получить: получила получил получить
польза: пользу
помешать: помешало
помещение: помещением
помона: помона
помощь: помощью
помфри: помфри
попадать: попадает
попасть: попасть
пополниться: пополнившись
поппи: поппи
попытка: попытке
портал: портал
поскольку: поскольку
послание: послания посланием
последний: последний последнем
посол: после
постановка: постановка
постановщик: постановщик постановщика
постоянный: постоянная
построить: построил построен
потеряться: потерявшийся
поттер: поттер поттере
поул: поул
похититель: похититель
почтить: почти
поэтому: поэтому
появиться: появились
появляться: появляется
править: править
правка: правки
пратт: пратт
превратиться: превратившись
преданность: преданность
предварительный: предварительный
предлагаться: предлагается
предмет: предметы
представиться: представились
предыдущий: предыдущему предыдущей предыдущего предыдущий
предыстория: предыстория
прежде: прежде
президент: президентом
премия: премии премия премию
премьер: премьеры премьера
преподаватель: преподавателя преподаватели преподавателем
привет: привет
привлечение: привлечением
приз: приз
признание: признанию
призрак: призрак
призывать: призывает
приключение: приключения
прилавок: прилавки
прилетать: прилетают
прима: прим
применяться: применялись
примечание: примечания
принести: принести
принц: принц
пристройка: пристроек
приступить: приступить
приходить: приходят приходит приходящей
приходиться: приходится
причина: причине причинам
проводить: проводя
продолжение: продолжение продолжением
продюсер: продюсер
проект: проектах
производство: производство
происхождение: происхождения
проклясть: проклятое
пронзать: пронзает
проработать: проработала
просить: просит
просмотр: просмотры
пространство: пространства
профессор: профессора профессор
проход: проход
проходить: проходили
процесс: процесс
прочий: прочему прочего прочее
птица: птица
путеводитель: путеводитель
путин: путиным
путина: путина
пять: пять
пятьдесят: пятьдесят
работа: работе работы работа работу
радио: радио
радиостанция: радиостанции
разбить: разбитых
разгадать: разгадать
разгадка: разгадке
разговор: разговора
раздражать: раздражающий
разместить: размещена
разоблачать: разоблачают
разработать: разработав разработано
разработка: разработка
разработчик: разработчики
райт: райт
рамка: рамках
ранение: ранение
раскрывать: раскрывает
распределять: распределяющей распределяющая
рассказ: рассказы
рассказывать: рассказывает
расширение: расширение
расширить: расширенная
реддл: реддл
реддла: реддла
режиссура: режиссура
результат: результат результате результаты
рейтинг: рейтинг
религиозный: религиозные
релиз: релиз
ресурс: ресурсы
рецензия: рецензий
решаться: решаются
решить: решила
рика: рик
рикман: рикман
ричард: ричарда ричард
ричардсон: ричардсон
ричи: ричи
робби: робби
роберт: роберт
роджер: роджер
родственник: родственников
родственный: родственных
рождественский: рождественские
рождество: рождество
рок: рок
роль: роль ролях роли
роман: романов романе романа
рон: рону роном рона рон
росс: росс
российский: российские российских российского российской
роулинг: роулинг
роулинз: роулинз
рубашка: рубашке
рубеус: рубеус
рубеусом: рубеусом
рука: руке руку
руперт: руперт
русский: русский
русый: рус
рэдклифф: рэдклифф
рэй: рэй
рэнделл: рэнделл
рэнди: рэнди
ряд: рядом
саботировать: саботирует
сажать: сажает
сайт: сайте сайт сайты
салазар: салазар
салазара: салазара
салли: салли
сам: самой
самый: самый самым
сантиметр: см
сатурн: сатурн
саундтрек: саундтрека саундтреков саундтрек
сбор: сборы
сборная: сборной
сведение: сведения
свежий: свежие
свобода: свобода
свободный: свободное свободной
свое: своему своего своими
свой: своей свою
связанный: связанные
связаться: свяжитесь
связь: связям
сделать: сделала
северус: северус
секрет: секретов
семейный: семейные семейный
семейство: семейства
семья: семьи
сент: сент
сентябрь: сентября
сердце: сердец
сериал: сериал
серия: серию серия
сертификат: сертификат
сиквелы: сиквелы
симус: симус
система: системе
сказка: сказки
скачать: скачать
скрытый: скрытые
следующий: следующий
слизерин: слизерин
слизерина: слизерина
словарь: словари
сложность: сложности
сломать: сломанную
служба: службы
служебный: служебные
случай: случаях
случайно: случайно
случайный: случайная
слушать: слушать
слышать: слышать
смайт: смайт
смерть: смерти
смирительный: смирительной
смит: смит
смочь: смог сможешь
снегг: снегг
сниматься: снимались
снитч: снитч
снова: снова
собор: соборы
событие: события
совмещать: совмещала
согласие: согласие
содержание: содержание
создание: создании создание
создатель: создателям
создать: созданным создать
сознание: сознания
сомнительный: сомнительна
сон: снов
сообщество: сообщество
сообщить: сообщить
сопровождение: сопровождением
сосредоточиться: сосредоточиться
состав: состава
составить: составила
состояться: состоялась
сохранение: сохранением
сочинить: сочинивший
сочинять: сочинял
спаситель: спасителем
специалист: специалистов специалисты
спецэффект: спецэффекты
список: список
спора: споры
способный: способной способное
справка: справка
спроектировать: спроектировал
сравнение: сравнении
среди: среди
средний: средней
српски: српски
српскохрватски: српскохрватски
ссылка: ссылка ссылками ссылки
станция: станция
стартовать: стартовал
старший: старшим
старый: старой
статистика: статистика
стать: стало стала
статья: статья статьи
стебль: стебль
стен: стене
стив: стива стив
столкнуться: столкнувшись
страна: страны стране
страница: страницы страница страницу странице
строение: строение
студент: студенты
студия: студии
стюарт: стюарт
суд: суде
судебный: судебного
судно: судах
супер: супер
существо: существа
существовать: существуют
сходство: сходство сходством сходства
сцена: сценами сцене
сценарий: сценария сценарию
сценарист: сценарист
счесть: сочтено
считать: считать
сша: сша
сыграть: сыграл
сюда: сюда
сюжет: сюжет
таинственный: таинственный
тайна: тайну
тайный: тайная тайной тайную
также: также
такой: такие
театральный: театральная
текст: текст
текущий: текущие
телефильм: телефильм
тем: тем
тема: тема
тематический: тематический тематические
тереть: три
термин: термина
терять: теряет
титр: титрах титров
тоби: тоби
товарный: товарный
том: тома
тонкий: тонкую
тот: том те тот той
трек: треков
трепетать: трепещите
тригг: тригг
троица: троица
трость: тростью
туалет: туалете
тюдор: тюдор
тяжелый: тяжело
убивать: убивать убивает
убийство: убийств
уважение: уважение
удостоиться: удостоился
ужин: ужин
узнать: узнавшие узнают
узник: узник
уизли: уизли
уильям: уильям
уильямс: уильямс уильямса
уйти: уйти
указание: указанием
указать: указан
улица: улице
умение: умение
университет: университете
уолтерс: уолтерс
уорик: уорик
уотсон: уотсон
урок: уроке уроки
условие: условий условия
успевать: успевает
успеть: успел
уступить: уступив
утверждение: утверждением
утиль: утиля
участие: участие
участник: участников
учебник: учебниками учебники
учебный: учебный учебного
ученик: учеников ученики ученика
фадж: фадж
фантастический: фантастическая фантастические
февраль: февраля
федерация: федерации
фелпс: фелпс
фелтон: фелтон
феникс: феникса феникс
физический: физическим
филиус: филиус
филлипс: филлипс
философский: философский философского
филч: филч
филча: филча
фильм: фильму фильм фильмов фильмах фильма фильмы фильмом
финниган: финниган
финч: финч
фиона: фиона
флетчли: флетчли
флинт: флинт
флитвик: флитвик
фонд: фонд
форум: форум
фоукс: фоукс
фоукса: фоукса
фрагмент: фрагментов
франшиза: франшизы
фред: фреду фред
фрэнк: фрэнк
футовый: футов
фэнтези: фэнтези
фэнтезийная: фэнтезийная
фэнтезийный: фэнтезийный
хагрид: хагрид
хагрида: хагрида
хагридом: хагридом
хагриду: хагриду
харди: харди
харрис: харриса харрис
хейман: хейман
хемминг: хемминг
хендерсон: хендерсон
хизер: хизер
хитрость: хитростью
хобби: хобби
хогвартс: хогвартс
хогвартса: хогвартса
хогвартсу: хогвартсу
ход: ходе
хозяин: хозяином хозяина
холмс: холмс
хороший: лучшую лучшие лучшая лучший лучшему
хотеть: хотели
храниться: хранились
хроник: хроники
художник: художник художника художником
хью: хью
хьюблер: хьюблер
хьюго: хьюго
цвет: цвета цветами
цитата: цитаты
цитировать: цитировать
чародейство: чародейства
частить: части
часть: частью часть
чей: чья
человек: человек человеком
чемпионат: чемпионат
через: через
четверг: четвергам
читать: читать
чтобы: чтобы
чудовище: чудовище
чуть: чуть
шармбатон: шармбатон
шерлок: шерлок
шесть: шесть
ширина: ширина
ширли: ширли
школа: школа школу школе школой
школьный: школьного
шляпа: шляпы шляпа шляпой
шон: шон
шоу: шоу
эдварда: эдвард
эксперт: экспертов
экспресс: экспрессе
элемент: элемент
эльф: эльфа эльф эльфом
эмма: эмма
энди: энди
эндрюс: эндрюс
энциклопедия: энциклопедии
эпизод: эпизодов
эплебаум: эплебаум
это: этом это
этот: этой эта эту
эффект: эффекты эффектам
являться: является являлась
ядовитый: ядовитым
язык: язык языках языке
якоб: якобы
январь: января
янгблад: янгблад
яп: яп
япония: японии
японский: японской
яркий: яркие
