авторство: авторства
алфавит: алфавиту
англ: англ
анимаг: анимаг
аниме: аниме
вернуться: вернитесь
версия: версия
викиданных: викиданных
викимедиа: викимедиа
википедии: википедии
википедия: википедия
вклад: вклад
войти: войти
волшебник: волшебник
выпускать: выпускает
выходить: выходит
год: года
действовать: действовать
джоан: джоан
добавить: добавить
дополнительный: дополнительные
доступный: доступен
другой: другой других
животное: животное
журнал: журнал
заглавный: заглавная
запись: запись
зарегистрировать: зарегистрированный
заявление: заявление
знак: знак
значение: значений
избранный: избранные
издаваться: издававшийся
издание: издание
издательство: издательство
инструмент: инструменты
интернет: интернет
использование: использования
история: история
источник: источник
июль: июля июль
категория: категория
код: код
кодекс: кодекс
конфиденциальность: конфиденциальности
короткий: короткий
который: который
кук: куки
кэтлин: кэтлин
лицензия: лицензии
манги: манги
марта: марта
материал: материал
мая: мая
мобильный: мобильная
мочь: могут
мы: нами
навигация: навигации навигация
название: названия названиям
начало: начале
некоммерческий: некоммерческой
новый: новые
нужный: нужную
об: об
обсуждение: обсуждение
описание: описание
организация: организации
ответственность: ответственности
отдельный: отдельных
отказ: отказ
отредактировать: отредактирована
ошибка: ошибке
перейти: перейти
персональный: персональные
печать: печати
поведение: поведения
подробный: подробнее
пожалуйста: пожалуйста
пожертвовать: пожертвовать
поиск: поиск поиску
политик: политика
получить: получить
попасть: попали
популяризация: популяризации
последний: последний
постоянный: постоянная
править: править
правка: правки
превращаться: превращаться
представиться: представились
примечание: примечания
проект: проект проектах
просмотр: просмотры
пространство: пространства
развитие: развитию
развлекательный: развлекательный
разработчик: разработчики
роман: романов
российский: российское
россия: россии
роулинг: роулинг
русский: русский
сантиметр: см
сведение: сведения
свежий: свежие
свободный: свободной
связанный: связанные
связаться: свяжитесь
система: системе
скачать: скачать
слово: слова
словосочетание: словосочетания
служебный: служебные
случай: случаях
случайный: случайная
событие: события
содержание: содержание
создать: создать
сообщество: сообщество
сообщить: сообщить
соответствующий: соответствующие
сохранение: сохранением
список: список
справка: справка
ссылка: ссылка ссылку ссылками ссылки
статистика: статистика
статья: статью статья статьи
страница: страницы страница страницу странице
сюда: сюда
также: также
текст: текст
текущий: текущие
товарный: товарный
указание: указанием
указывать: указывала
уметь: умеющий
условие: условий условия
уточнить: уточните
участие: участие
фонд: фонд
форум: форум
цитировать: цитировать
читать: читать
чтобы: чтобы
элемент: элемент
энциклопедия: энциклопедии
этот: эта
язык: языках
японский: японский
