август: август августа
автор: автор
авторство: авторства
адрес: адрес
азкабан: азкабан
азкабана: азкабана
азкабане: азкабане
аластор: аластор
алиса: алису
алфавит: алфавиту
альбус: альбус
альбуса: альбуса
амбридж: амбридж
амбрижд: амбрижд
американский: американской американская
англ: англ
английский: английский
антагонист: антагониста
апрель: апреля
арк: арку
артефакт: артефакт
артур: артура
архивировать: архивировано
архивный: архивная
ассоциация: ассоциации ассоциация
ать: ать
бабушка: бабушку
балл: баллы баллами
барда: барда
беда: беде
бежать: бегущая
безголовый: безголового
безопасность: безопасности
безуспешно: безуспешно
беларуская: беларуская
белизна: белизна
беллатрисса: беллатрисса
беллатриссой: беллатриссой
беллатриссу: беллатриссу
беллатриссы: беллатриссы
беллатрисы: беллатрисы
бесить: бесит
библиографический: библиографических
библиотечный: библиотечная библиотечной
бидля: бидля
битва: битвы
бить: била
блэк: блэк
блэка: блэка
блэков: блэков
боевой: боевые
бой: боя бой
болото: болотом
больница: больницу больнице
большинство: большинство
большой: большой
борьба: борьбе борьбу
бояться: боялся
брат: братом брат братья
британский: британской
бросить: бросить
бруствер: бруствер
будущее: будущем
български: български
быть: будут бывшей были
вакансия: вакансия
вводить: вводя
веи: веи
великан: великаном
великобритания: великобритания великобритании
версия: версия версии
весить: весь
взять: взять
вид: виде
видение: видением видение
видеоигра: видеоигра
видеть: видеть видит видела видел
викиданных: викиданных
викимедиа: викимедиа
википедии: википедии
википедия: википедия
викисклад: викисклад
викискладе: викискладе
викицитатник: викицитатник
викицитатнике: викицитатнике
викия: викия
виновный: виновным
вия: вия
вклад: вклад
владеть: владеть
власть: власти власть
влетать: влетает
вместо: вместо
вмешательство: вмешательством
внезапно: внезапно
внешний: внешние
внешность: внешность
внушать: внушает
воевать: воевавших
возвращаться: возвращается возвращаются
возвращение: возвращение
возникать: возникающими
возрождение: возрождение
войти: вошла войти
вокзал: вокзале
волан: волан
волшебник: волшебников
волшебный: волшебные волшебных волшебный
волшебство: волшебства
вопрос: вопросы вопросами
ворчливый: ворчливый
воспоминание: воспоминания воспоминаний
восстанавливать: восстанавливают
впервые: впервые
враг: врагу
вратарь: вратаря
вредность: вредности
время: время
вручать: вручает
все: всех всем
всевозможный: всевозможные
всеять: всей
вскоре: вскоре
вследствие: вследствие
вспоминать: вспоминает
всречают: всречают
встреча: встречи
встречать: встречают
встречный: встречен
вступать: вступают
всячески: всячески
входить: входят
выведать: выведать
выгонять: выгоняет
выдать: выдал
вызов: вызов
выкинуть: выкинуть
вылить: вылить
вынудить: вынудив вынужден
выпроводить: выпроводить
выпуск: выпуском выпуск
выпытать: выпытать
выразить: выразить
выручать: выручай
высокий: высоко
выставить: выставив
вытворять: вытворяют
выход: выходом
выяснять: выясняет
выясняться: выясняется
га: га
гадкий: гадко
гарантированный: гарантированно
гарри: гарри
гермиона: гермиона гермионы гермионе гермиону
героизм: героизме
герой: героя герои
гибель: гибелью
глава: главе главы
главное: главного
глаз: глаза глазах
глобальный: глобальным
говорить: говорит
год: году лет год годы года
голос: голоса
готовый: готовы
грейнджер: грейнджер
гриммо: гриммо
гриффиндор: гриффиндор
гриффиндора: гриффиндора
гриффиндорского: гриффиндорского
грохх: грохх
грохха: грохха
гроххом: гроххом
группа: группу группы
группдолоресо: группдолоресо
грюм: грюм
грязнокровкой: грязнокровкой
дадли: дадли
далекий: подальше
дамблдор: дамблдор
дамблдора: дамблдора
дамблдору: дамблдору
дампор: дампор
дар: дары
дата: дата даты
дать: дать
де: де
девушка: девушкой
дейрдре: дейрдре
действительно: действительно
действовать: действовать
декабрь: декабря
декрет: декреты
делать: делали
дементоры: дементоры
день: дней
детская: детские
детство: детство
деть: дела
деятельность: деятельности
дж: дж
джастин: джастин
джеймс: джеймс
джинни: джинни
джоан: джоан
джон: джон
джордж: джордж
диггори: диггори
дилогия: дилогия
директор: директором директор директора
дитя: дитя
добби: добби
добиваться: добивается
добиться: добиться
добраться: добраться
догадываться: догадывается
док: док
докопаться: докопался
долг: долг
долгопупс: долгопупс
должен: должны должен
должное: должное
долорес: долорес
дом: дом доме
дома: дома
домовик: домовик
донахью: донахью
дополнительный: дополнительные
дорогой: дорого
доскональный: доскональном
достаточно: достаточно
доступ: доступа
доступный: доступен
драко: драко
драма: драма
древность: древности
друг: друзей другом друзьям
другой: другой другие других другого
дружелюбие: дружелюбие
дружина: дружину
дурмстранг: дурмстранг
дурной: дурная
дурсли: дурсли
дурсля: дурсля
дурслями: дурслями
душа: душой
душевно: душевно
дуэль: дуэль
е: е
едва: едва
единственный: единственно
ееством: ееством
жаба: жабу жабой
жанр: жанр
ждать: ждали
желание: желанию
желать: желая желает
живой: жив
жизнь: жизнь
жить: жить
забирать: забирают
завоевать: завоевал
завязываться: завязываются
заглавный: заглавная
заглядывать: заглядывает
заключаться: заключается
заклятие: заклятие заклятием
заколдованный: заколдованным заколдованные
заколдовывать: заколдовывает
закон: законов
замалчивать: замалчивает
заметить: заметить
замок: замке
заниматься: занимается заниматься
заняться: заняться
запись: запись
заплатить: заплатить
заполучить: заполучить
запретный: запретном
запрещать: запрещая запрещает
зарегистрировать: зарегистрированный
заставлять: заставляя
затем: затем
затопить: затопив
захария: захария
захватить: захватить
защита: защиты защите защиту
защитить: защитить
заявление: заявление
звать: зовут
зверь: звери
зельеварения: зельеварения
зло: зла
злой: злейшему
знак: знак
знакомить: знакомит
знакомиться: знакомится
знакомый: знакомые знакомых
знать: знал
значение: значения
значительно: значительно
зов: зов
золотой: золотую
игра: игра игры
избегать: избегает
избранный: избранные
изгонять: изгоняет
издат: издат
издатель: издатель
издательство: издательством издательстве
издать: издан
изучение: изучению
икабог: икабог
именно: именно
имя: именем имя имени
иной: иной
инспекционный: инспекционную
инструмент: инструменты
информатор: информаторы
информация: информации
исключать: исключают
искусство: искусств
использование: использования
использовать: использовать
история: история
источник: источник
исход: исходе
итог: итоге
июль: июля июль
июнь: июня июнь
кабинет: кабинет кабинете
каждый: каждый
календарный: календарного
камень: камень
камин: камины камин камина
каникулы: каникулы каникул
карточный: карточная
карьер: карьеру
каталог: каталогах
категория: категории
квартира: квартире
квиддич: квиддич
квиддичу: квиддичу
кентавр: кентавра
кикимер: кикимер
кикимера: кикимера
кингсли: кингсли
класс: класса
клуб: клуба
книга: книг книги книгой книгу книге книга
код: код
кодекс: кодекс
количество: количеству
коллекционный: коллекционная
команда: команду
комната: комнате комната
конец: конце
конструктор: конструктор
конструпадаетколо: конструпадаетколо
контролировать: контролирует
конфиденциальность: конфиденциальности
копия: копию копия
копье: копий
коридор: коридор
корморане: корморане
корнелиус: корнелиус корнелиуса
корнер: корнер
короткий: короткие короткий
косой: косом
который: которой которую которого которые которых котором который
крайне: крайне
критик: критиков
критика: критиками
критиковать: критикует
кровавый: кровавым
кровь: кровь
кроме: кроме
круциатус: круциатус
крушить: крушит
крылторых: крылторых
кто: ком
кубок: кубок
куда: куда
кузен: кузена
кук: куки
кукушка: кукушки
курс: курсе
кусать: кусает
кыргызча: кыргызча
лаборатория: лаборатория
лавгуд: лавгуд
лгать: лгать
леонарда: леонард
лес: лесу
лесничий: лесничий
лест: лест
лестрейндж: лестрейндж
лететь: летят
летний: летних
лето: лето
летучий: летучего
лживый: лживое
лили: лили
линча: линча
лицензия: лицензии
лицо: лице
личной: личной
лишать: лишал
лишение: лишениях
лишь: лишь
ловить: ловит
локация: локации
лорд: лорда лорд
луна: луной
любить: любит
любой: любые любой
люпин: люпин
люциус: люциус
люциусом: люциусом
маг: магов маги
магазин: магазином магазинов
магический: магических
магия: магия магии
маглов: маглов
маглы: маглы
майкл: майкл
майя: май
макгонагалл: макгонагалл
македонский: македонски
макмиллан: макмиллан
малфоем: малфоем
малфой: малфой
малфоя: малфоя
малфоям: малфоям
малфоями: малфоями
манера: манеры
мариэтта: мариэтты мариэтта
мария: марии
марта: марта
мастер: мастер
матеони: матеони
материал: материал
мать: мать
махаон: махаон
мая: мая
мблдорить: мблдорить
медаль: медаль
медиафайлы: медиафайлы
медленный: медленно
менять: менять
мера: меры
мерзкий: мерзкой мерзкий
мерсисайд: мерсисайд
место: место места
месяц: месяца
метаморфомаг: метаморфомаг
миллион: миллионов
министерство: министерства министерство министерстве
министр: министра
мир: мира мир
миссис: миссис
мистер: мистера
младший: младшим
мнение: мнение
многие: многие
множество: множество
мобильный: мобильная
могила: могила
можно: можно
молодая: молодых
молодежь: молодежи
молчаливо: молчаливо
момент: момент
монгол: монгол
монета: монеты
монолог: монолог
мораль: морали
морт: морт
морта: морта
морте: морте
морту: морту
мочь: могут
мракоборец: мракоборец
мракоборцы: мракоборцы
мтсехорое: мтсехорое
мунго: мунго
мы: нами
мысль: мыслей
н: н
набирать: набирает
навещать: навещают
навигация: навигации навигация
наводить: наводить
нагайна: нагайна
награда: наград
награждать: награждают
над: над
назад: назад
назвать: назвала
назначаться: назначается
назойливый: назойливых
называть: называет
наказывать: наказывает наказывают
наносить: наносил
нападать: нападавшими нападают нападает
нападение: нападения
направить: направлена
напророчить: напророчила
нарушение: нарушении
насилие: насилием
насовсем: насовсем
настигать: настигает
наступать: наступают
наступление: наступление
находить: находит
нацарапать: нацарапанные
начало: начала
начинать: начинают начинает
наш: наших
неведомый: неведомой
неверный: неверным
невила: невила
невилл: невилл
невиновность: невиновности
негативный: негативных
негласный: негласному
недостоверный: недостоверный
нежелание: нежелание
неистовый: неистовому
некоммерческий: некоммерческой
некоторые: некоторые
ненавидеть: ненавидящая
ненависть: ненависти
неопр: неопр
неподходящий: неподходящий
неполный: неполный
неприязнь: неприязни
несколько: несколько
несмотря: несмотря
несогласный: несогласных
нии: нии
ника: ника
никнуть: ник
никогда: никогда
никто: никто
нимфадора: нимфадора
новый: нового новые новых
нож: ножом
норрис: норрис
нпожирателзгар: нпожирателзгар
об: об
оба: оба
обеспечивать: обеспечивает
обеспокоить: обеспокоены
обитание: обитания
обладать: обладающей
обмануть: обманул
обмен: обмен
обозвать: обозвать
обозреватель: обозреватель
обойтись: обойтись
образ: образ
образование: образовании
обращение: обращения
обсуждение: обсуждение
объяснять: объясняет
обязательство: обязательств
овладеть: овладеть
огонь: огонь огня
огромный: огромный
один: одного один
однако: однако
однотонность: однотонность
окклюменцией: окклюменцией
окклюменции: окклюменции
окончательно: окончательно
окружать: окружают
октябрь: октября
омут: омут
он: нему
они: них
онися: онися
онлайн: онлайн
опасный: опасных
описание: описание
опубликовать: опубликован
опытный: опытными
организация: организации
орден: ордену ордена орден
оригинал: оригинала оригинал
освободиться: освободился
оскорбление: оскорблений
осознавать: осознающий осознавая
оставаться: оставаясь
остальное: остальные
остаться: остаться
ответственность: ответственности
отдавать: отдают
отдел: отдел отделе
отдельный: отдельных отдельные
отдпоэтому: отдпоэтому
отец: отец
отзыв: отзывами
отказ: отказ
открыто: открыто
открыть: откроет
отличаться: отличаться
отлучаться: отлучается
отменять: отменяют
отметить: отметит
отношение: отношения отношении
отображаться: отображаться
оторыа: оторыа
отправиться: отправился
отправлять: отправляют
отправляться: отправляются
отредактировать: отредактирована
отрицательно: отрицательно
отряд: отряда отрядом отряд отряде
отстранить: отстранить
отыскать: отыскать
официальный: официальный
оценить: оценил
оценка: оценки
очередной: очередное очередной
очередь: очередях
ошибка: ошибке ошибку
п: п
палочка: палочки
память: памяти
параметр: параметром
парень: парня
парк: парк
пародия: пародии
патронуса: патронуса
первое: первых первые первом
первый: первую
пергамент: пергамент
перевод: переводе
перед: перед
передать: передал передать
переиздать: переиздали
перейти: перейти
переть: при
переулок: переулке
перо: пером
перси: перси
персонаж: персонажи
персональный: персональные
петтигрю: петтигрю
петуния: петуния
печать: печати
пиар: пиаром
пивз: пивз
писательница: писательницы писательница
писать: писать
письмо: письмо письме
питер: питер
племянник: племяннику
площадь: площади
победить: победить
поведение: поведения
повод: повода поводу
погибать: погибает
погибнуть: погибшего погибнет
подводить: подводит
поддаться: поддаться
поддерживать: поддерживают
подозрение: подозрения
подпись: подписи
подробность: подробности
подробный: подробнее
подруга: подруга
подряд: подряд
подтверждаться: подтверждаются
подходить: подходившего подходил
пожертвовать: пожертвовать
пожиратель: пожирателей пожиратели
поздний: позже
позитивный: позитивными
позор: позором
поиск: поиск поиску
пока: пока
показ: показе
показать: показать
поле: поля
политик: политика политике
полночь: полночь
половина: половину
полтергейст: полтергейстах полтергейст
полукровка: полукровок полукровка
полумна: полумна
получать: получает получают
получаться: получается
получить: получила получил получить
помикам: помикам
помощь: помощью помощь
понимать: понимает
понять: понял
попадать: попадает попадают
попасть: попасть попавшая
попытаться: попытался
попытка: попытке
порох: пороха
портал: портал
порядок: порядка порядки порядке
поскольку: поскольку
послание: послание
посланиерейндж: посланиерейндж
последний: последний
посмешище: посмешище
посол: после
пост: поста постах
постоянный: постоянная
пострадать: пострадавших
поступить: поступили
потой: потой
поток: поток
поттер: поттер поттера поттере
поттеромания: поттеромания
похвалить: похвалила
похитить: похищены
почва: почве
почему: почему
почтить: почти
поэтому: поэтому
появляться: появляются появляется
правда: правды правду
правильный: правильным
править: править
правка: правок правки
практика: практикой
практиковаться: практиковаться
предательство: предательстве
предвкушать: предвкушающим
предел: пределами
предзаказов: предзаказов
предмет: предметы
предсказуемость: предсказуемость
представить: представили
представиться: представились
предчувствие: предчувствие
предыдущий: предыдущая
предыстория: предыстория
прежде: прежде
преимущественный: преимущественно
прекрасно: прекрасно
премия: премия
препираться: препирается
преподавание: преподавания
преподаватель: преподавателя преподаватели
преподавательница: преподавательницы
преследование: преследования
пресс: пресса
преступный: преступную
прибыть: прибывшего
приглашать: приглашает
признавать: признавать
признание: признания
признать: признать
призрак: призрака призраком
прийтись: пришлось
приказ: приказу приказ
прикрывать: прикрывают
применение: применение
применить: применить
примечание: примечания
примечательный: примечательных
принимать: принимает принимать
принц: принц
принять: принявший принятые принят
приревновать: приревновала
присобирается: присобирается
присутствие: присутствие
присутствовать: присутствовала
приходить: приходит
приходиться: приходящаяся
причина: причине причину
про: про
пробалтываться: пробалтывается
проболтаться: проболтался
проверить: проверил проверенной
проверка: проверку проверки
проверяться: проверялась
проводить: проводить проводят
прогонять: прогоняет
продавать: продающие
продать: продано
проделка: проделки
продолжать: продолжая продолжает продолжать
проект: проектах
произведение: произведения
производство: производство
проклатие: проклатие
проклясть: проклятое
прор: прор
прорицание: прорицаний
пророчество: пророчество пророчества пророчестве
просить: просит
просмотр: просмотры
просто: просто
пространство: пространства
против: против
противник: противника
противостояние: противостоянии
протяжение: протяжении
профессор: профессора профессор профессору
прочий: прочее
прочитат: прочитат
прошлый: прошлых прошлый
проявляться: проявляются
прыщ: прыщи
прямая: прямой
публика: публикой
публикаони: публикаони
публикация: публикации
путеводитель: путеводитель
путь: пути
пытать: пытает пытать
пытаться: пыталась пытается
пытка: пыток
пята: пятой
пятый: пятая пятом
пять: пять
работать: работавший
равный: равных равного
рада: рады
разбираться: разбирается
разбить: разбив
разгар: разгар
разделять: разделяет
размолвка: размолвка
разнтвовавшие: разнтвовавшие
разработчик: разработчики
разрешать: разрешает
разрешение: разрешения
раскрытие: раскрытия
распределять: распределяющая
рассказ: рассказы
рассказывать: рассказывает
ребята: ребята
режим: режиму
результат: результате
рекорд: рекорды
религиозный: религиозные
ресурс: ресурсы
рецензент: рецензентов
речь: речь
решать: решают решает
решающий: решающий
римус: римус
риятные: риятные
родитель: родители
родиться: родится
родной: родной родному
родственный: родственных
родство: родстве
рождественский: рождественский
рождество: рождество
розыгрыш: розыгрышей
роман: романов романе роман романы
романтический: романтические
рон: рона рон
ронять: роняет
росмэн: росмэн
россия: россии россия
роулинг: роулинг
рубеус: рубеус
рука: руке руки
руководство: руководством
русский: русский
саботаж: саботаж саботажа
сайт: сайты
сальто: сальто
сам: самого самому само
самый: самые
сантиметр: см
саундтрек: саундтрек
сбегать: сбегают сбегает
сбежать: сбежавшей сбежит сбежать
сведение: сведения
свежий: свежие свежих
свободный: свободной
сводить: сводит
сводной: сводным
свое: свои свое своего своим
свой: свой своей свою
связанный: связанные
связаться: свяжитесь связаться
связываться: связывается
святой: святого
сдача: сдаче
северус: северус
северуса: северуса
седрик: седрика
седьмой: седьмого
сейчас: сейчас
семья: семья семье
сентябрь: сентября
сердце: сердце
сериал: сериал
серия: серии серию серия
сестра: сестрой
сивилла: сивиллу сивилла
сидеть: сидящей
сила: силой силы
синяк: синяках
сириус: сириуса сириус сириусу сириусом
система: системе
ситуация: ситуацию
сказать: сказав
сказка: сказки
скачать: скачать
скейтбордиста: скейтбордиста
склад: склада
скорбеть: скорбит
скорость: скоростью скорость
скрывать: скрывал
скрываться: скрывается
скрытый: скрытые
следующий: следующей следующая
слизерина: слизерина
слизеринцев: слизеринцев
словарь: словари
словно: словно
слово: слова
слуайно: слуайно
служба: службе
служебный: служебные
случай: случаях
случайный: случайная
случаться: случается
случиться: случившегося
слушание: слушании
слышать: слышал
смертельный: смертельная
смерть: смерть смерти
смит: смит
смочь: сможет смог
сначала: сначала
снегг: снегг
снегга: снегга
снеггом: снеггом
снимать: снимают
снять: снят снять
собирать: собирает
собираться: собирался
собственный: собственной
событие: события
соврать: соврал
соврождественские: соврождественские
содержание: содержание
содержаться: содержащимся
создавать: создавать
создать: создал создать
сокровенный: сокровенных
сон: сне
сообщать: сообщает
сообщество: сообщество
сообщить: сообщить
сопротивляться: сопротивляются
сохранение: сохранением
спасать: спасают
спасти: спасти
спастись: спастись
спивак: спивак
список: список
спора: споры
способный: способный способной
справка: справка
спрятать: спрятал
срабатывать: срабатывает
сражаться: сражающимся сражаются сражавшимся
сразу: сразу
среди: среди
српски: српски
српскохрватски: српскохрватски
ссадина: ссадинах
ссылка: ссылка ссылками ссылки
становиться: становится
староста: старостами
старший: старше старший
статистика: статистика
стать: стал стала
статья: статья статьи
стеклянный: стеклянный
стоить: стоят
сторонница: сторонницей
стоять: стояли
страйке: страйке
страна: странах
страница: страницы страница страницу страниц странице
странный: странную странный
студент: студенты
суд: суд суде
существо: существа
существовать: существуют
сыворотка: сыворотку
сын: сыну
сюда: сюда
сюжет: сюжет
таинственный: таинственные
тайком: тайком
тайна: тайн
тайный: тайная
также: также
таки: таки
такой: таким такие
татарча: татарча
текст: текст
текущий: текущие текущая
тело: тела телом
тематический: тематический тематические
теория: теории
тереть: три
термин: термина
товар: товары
товарный: товарный
тонкс: тонкс
тот: том те тот та
травма: травмы
требование: требование
требовать: требует требуют
трелони: трелони
трижды: трижды
трое: троих
туда: туда
турнир: турнире
тщетный: тщетно
тысяча: тысячи
тяжесть: тяжести
убеждение: убеждения
убить: убить
увечье: увечья
уволить: уволить
увольнять: увольняет
угрожать: угрожал
удар: удар
узнать: узнав узнают узнал
узник: узник
уизли: уизли
уйти: уйти
указание: указанию указанием
указать: указан
упоминать: упоминает
упускать: упускает
урок: уроке уроки
условие: условий условия
услышать: услышать
успевать: успевает успевают
успокоить: успокоить
установить: установленному
устроить: устроив
уходить: уходить
участие: участие
участить: участи
участник: участниками участники участников
ученик: учеников ученики ученикам ученика
учитель: учителя учителей
фадж: фадж
фаджа: фаджа
фаджем: фаджем
фаджу: фаджу
факультет: факультеты
фанат: фанаты
фантазия: фантазию
фантастика: фантастики
фантастический: фантастические
февраль: февраля феврале
фейерверк: фейерверк
феникс: феникса
фестралов: фестралов
философский: философский
фильм: фильм фильмов
финч: финч
флетчли: флетчли
флоренца: флоренца
фонд: фонд
форум: форум
фред: фред
фрэнк: фрэнка
фэнтези: фэнтези
хагрид: хагрид
хагрида: хагрида
хагриду: хагриду
характер: характер
хобби: хобби
хогвартс: хогвартс
хогвартса: хогвартса
хогвартсе: хогвартсе
хогсмиде: хогсмиде
ход: ходе
хозяин: хозяин хозяином
хороший: лучше лучшую лучшей
хорошо: хорошо
хотеть: хочет
храбрый: храбрым
цель: цели
цикл: цикл
цитата: цитаты
цитировать: цитировать
ция: ция
чанг: чанг
чародейство: чародейства
час: часа
частично: частично
часть: часть
чеканка: чеканки
человек: человек человеку человека людей людям
чемпионат: чемпионат
через: через
чернильный: чернильно
чжоу: чжоу
числиться: числятся
число: числе
читать: читать
член: членов члены член
чон: чон
чтих: чтих
что: чему
чтобы: чтобы
чуть: чуть
шалость: шалостей
шар: шар
шармбатон: шармбатон
шелкопряд: шелкопряд
шестеро: шестерых шестеро
школа: школу школе школой школы
шляпа: шляпа
штаб: штаб штабом
шумно: шумно
эджком: эджком
экзамен: экзамены экзаменов
элемент: элемент
эльф: эльф
энциклопедия: энциклопедии
эрлстауне: эрлстауне
эрни: эрни
это: этом это этим
этот: этой эта
ябеда: ябеда
явление: явлением
являться: является
явный: явным
язык: язык языках
языковый: языков
якоб: якобы
январь: января
яростный: яростный
