абердинский: абердинский
автор: авторами
авторство: авторства
адам: адам адама
азаран: азаран
акт: акт
александрович: александрович
алфавит: алфавиту
алхимия: алхимии алхимия
американский: американского
аналог: аналоги
ангел: ангелы
англ: англ
английский: английского
анк: анка
анналы: анналы
античный: античными античной античном
антропософия: антропософия
апрель: апреля
аравия: аравии
архивировать: архивировано
архивный: архивная
аспект: аспекты
астральный: астральная астральный
астрология: астрология
бафомет: бафомет
беларуская: беларуская
бенну: бенну
берейшит: берейшит
бертуха: бертуха
беспокоить: беспокоить
бессмертие: бессмертие бессмертия
бессмертный: бессмертной
бестиарий: бестиарий
библиографический: библиографических
библия: библии
блбул: блбул
бог: бога
больший: большая
большинство: большинство
британнику: британнику
брокгауза: брокгауза
брук: брука
брэ: брэ
български: български
быть: были
ван: ван
вариация: вариации
вв: вв
век: век
великое: великое великого
величина: величине
вера: веру
вербилки: вербилок
версия: версия версии
вечно: вечно
вечный: вечной вечную вечного
вид: вида виду
видеть: видели видел
викиданных: викиданных
викимедиа: викимедиа
викиновости: викиновости
википедии: википедии
википедия: википедия
викисклад: викисклад
викискладе: викискладе
викисловаре: викисловаре
викисловарь: викисловарь
викитеке: викитеке
викитеку: викитеку
вителлия: вителлия
вклад: вклад
включать: включает
вместе: вместе
внешний: внешние
вновь: вновь
воды: воды
возрождаться: возрождается возрождающаяся
возрождение: возрождении возрождения
войти: войти
волшебный: волшебные
вообще: вообще
вопрос: вопрос
воскресение: воскресения
воскрешение: воскрешение
впоследствии: впоследствии
время: времена временем время
все: всех
всевышний: всевышний
вспышка: вспышке
встречаться: встречается
выбрать: выбрали
вымысел: вымыслом
выражение: выражению
высокий: высшей
выходить: выходящем
г: г
гадание: гадания
гай: гай
галерея: галерея
ган: ган
гелиополе: гелиополе
гелиополем: гелиополем
гематрия: гематрия
геометрия: геометрия
геральдика: геральдике
геральдический: геральдический
герб: герб
герменевтика: герменевтика
герметизм: герметизм
геродот: геродот
геродота: геродота
гибель: гибели
гигантский: гигантской
гнездо: гнезда
гнозис: гнозис
гном: гномы
гностицизм: гностицизм
говориться: говорится
год: году лет года
гоетия: гоетия
голем: голем
гомункул: гомункул
город: городе
государственный: государственные
грааль: грааль
грехопадение: грехопадение
греция: греции
греча: греч
гримуар: гримуар
дата: дата
датский: датская
дать: данная
дева: деву
девственность: девственность
действовать: действовать
декабрь: декабря
делание: делания делание
демон: демоны
демонология: демонология
ден: ден
дерево: дерева
деяние: деяния
дионис: диониса
добро: добра
долгоживущий: долгоживущая
дополнительный: дополнительные
доступный: доступен
дракон: дракон
древнегреческий: древнегреческая древнегреческой
древнеегипетский: древнеегипетской
древнерусский: древнерусской
древние: древних
древний: древней древнего
древность: древностей
древо: древо
друг: другом
другой: другое другими другие других
дух: духи
душ: душа
е: е
ева: ева евы
египет: египте египта
египетский: египетском
единственный: единственная
екатеринбург: екатеринбург
елизавета: елизавета
енохианская: енохианская
ефрона: ефрона
жар: жар
животное: животных
жизнь: жизни жизнь
завершать: завершающей
заглавный: заглавная
закон: закон
закрыть: закрыть
западный: западная
запись: запись
заполнить: заполнить
запрос: запросы
зарегистрировать: зарегистрированный
заявление: заявление
зибаев: зибаев
зиз: зиз
зло: зла
знак: знак знаки
значение: значения значение
значительно: значительно
зоар: зоар
зодиак: зодиака
золотисто: золотисто
иврит: иврите иврита
иерофант: иерофант
избранный: избранные
изложение: изложение
изображать: изображают
изображение: изображениями изображение
иисус: иисуса
империя: империю
иной: иных иной
инструмент: инструменты
интерпретация: интерпретации
интерпретировать: интерпретирован
информация: информация
исключительный: исключительного
искушение: искушению
использование: использования
использовать: использующие
исследование: исследований
истолкование: истолковании
исторический: исторического
история: история
источник: источниках источники источник
исчезнуть: исчезнуть
итро: итро
иудейский: иудейской
июль: июля
каббала: каббала
каббале: каббале
кадмон: кадмон
кадуцей: кадуцей
каждый: каждые
камень: камень камня
каталанский: каталанская
каталог: каталогах каталоге
категория: категории
качество: качестве
кирилл: кирилл
китайский: китайский
клавдиан: клавдиан
клавдий: клавдий
классифицироваться: классифицируются
классический: классическими классических
книга: книги книге
ковчег: ковчеге ковчега
код: код
кодекс: кодекс
комма: комм
конкретный: конкретного
консекрацию: консекрацию
консульство: консульство
конфиденциальность: конфиденциальности
концепция: концепции
копия: копия
кормило: кормил
королев: королева
короткий: короткий
который: которых которая
красный: красным красного
крест: крест
кругосвет: кругосвет
крыло: крылом
кук: куки
культура: культуре культурах культура
лактанций: лактанций
лактанция: лактанция
лата: лат
легенда: легенду легенда
лежалый: лежал
литература: литературы литература литературе
лицензия: лицензии
луция: луция
любовный: любовные
любой: любом
м: м
магия: магия
македонский: македонски
максим: максимович
малый: малый
мария: мария марию
мартинизм: мартинизм
масонский: масонские
материал: материал
мая: мая
медиафайлы: медиафайлы
менее: менее
меркурий: меркурия
место: местах месте
месячный: месячного
метаморфоза: метаморфозы
метафорический: метафорическом
метаэлементов: метаэлементов
метод: методы
микрокосм: микрокосм
мир: мира мире
мировой: мировая
мистицизм: мистицизм
миф: мифа миф мифы
мифический: мифическая мифические
мифологический: мифологическая мифологический мифологические
мифология: мифологии мифология
мнение: мнению
многие: многие
много: более много
мобильный: мобильная
мой: моего моим
мотив: мотив мотивов
мочь: мог можете могут
муж: мужа
мы: нами
н: н
навигация: навигации навигация
над: над
название: название
называться: называлась
накормить: накормила
народ: народов
народный: народной
нарратива: нарратива
наряд: наряду
научный: научно
некоммерческий: некоммерческой
некоторые: некоторых некоторые
некромантия: некромантия
немецкий: немецком немецкого
немой: нем
неоплатонизм: неоплатонизм
неопр: неопр
непосредственно: непосредственно
неправдоподобный: неправдоподобный
низкий: ниже низшей
новый: новые
нонна: нонн
норвежский: норвежская
носить: носила
нотарикон: нотарикон
нумерология: нумерология
ныть: ной ноя
об: об
оба: обе
обитатель: обитателями обитателей
обновление: обновления обновление
образ: образа
образовательный: образовательный
обращение: обращения
обсуждение: обсуждение
общество: общество
общий: общ
овидий: овидий
огонь: огня
огорчение: огорчениям
одержимость: одержимость
один: одним
однако: однако
оккультизм: оккультизм
около: около
октябрь: октября
онлайн: онлайн
оперение: оперением
описание: описание
опытный: опытными
организация: организации
орел: орлом
оршина: оршина
основной: основные
особь: особь
осуществлять: осуществлял
ответственность: ответственности
отвечать: отвечал
отдельный: отдельная отдельных
отказ: отказ
отличаться: отличаться
относительный: относительное
отредактировать: отредактирована
отчего: отчего
оф: оф
ошибка: ошибке
павел: павла
падший: падшие
панополитанский: панополитанский
пентаграмма: пентаграмма
пентаграмматон: пентаграмматон
пепел: пепел пепла
первое: первое
перевод: перевод перевода
перейти: перейти
пересказ: пересказе
персонаж: персонажи
персональный: персональные
песок: песок
печать: печать печати
пиркей: пиркей
писать: пишет
письменный: письменное
пифагореизм: пифагореизм
пифия: пифия
пища: пищи
пламя: пламени
план: план
плита: плитах
плод: плодом
победа: победа
поведение: поведения
погребальный: погребальных
поддаться: поддалась
подниматься: поднимающимся
подробный: подробнее
пожалеть: пожалел
пожертвовать: пожертвовать
познание: познаний
поиск: поиск поиску
пока: пока
политик: политика
полный: полная
получение: получению
получить: получить
помочь: помочь
помощь: помощью
понимание: понимании
портал: портал
последний: последняя последний
последующий: последующем
посол: после
постоянно: постоянно
постоянный: постоянная
постоянство: постоянство
потоп: потопа
поэма: поэме поэма
появиться: появиться
появляться: появлялся
праведный: праведного
править: править
правка: правка правки
практик: практики
прах: прах праха
пребывание: пребывания
пребывать: пребывающих
предание: предание преданиям
предвидеть: предвидя
представиться: представились
представляться: представлялась
прикорнуть: прикорнув
прилетать: прилетает
примечание: примечания
приписать: приписано
природа: природы
про: про
проблема: проблеме
проверить: проверенной
проверка: проверки
проверяться: проверялась
проект: проектах проекту
проекция: проекция
произойти: произошедших
происхождение: происхождение
просмотр: просмотры
пространство: пространство пространства
прошлый: прошлом
психический: психических
птенец: птенца
птица: птице птица птицы
пять: пять
пятьсот: пятисот
рабба: рабба
раздел: разделе
разный: разному
разработчик: разработчики
райский: райском райского
раннехристианский: раннехристианскими
ранний: раннем
расширение: расширение
расширить: расширив
рая: раю
реальный: реальный
редакция: ред
реинкарнация: реинкарнацию
религиоведа: религиоведа
ресурс: ресурсы
решиться: решился
римский: римскую
родитель: родителя родителем
рождать: рождает
розенкрейцерство: розенкрейцерство
российский: российская
роэля: роэля
русский: русский
русь: руси
сад: саду сада
сакральный: сакральная
саламандра: саламандры
самосожжение: самосожжения самосожжении самосожжение
сангедрин: сангедрин
сантиметр: см
сведение: сведения
свежий: свежие
света: света
свободный: свободной
свое: своего своим
свой: своей свою
свойство: свойство
связанный: связанные связана
связаться: свяжитесь
связываться: связывался
святой: святой
сгорать: сгорая сгорающего
сильф: сильфы
символ: символом символ символы
символизировать: символизирует символизировать
симург: симург
синархии: синархии
система: системе
сказать: сказал
скачать: скачать
скромно: скромно
скрытый: скрытые
словарь: словари словарь
слово: словами
служебный: служебные
случай: случаях
случайный: случайная
смерть: смертью смерть
соболезновать: соболезнуя
событие: события событий
согласно: согласно
содержание: содержание
создать: создать
солин: солин
солнце: солнца солнце
соломон: соломона
сообщать: сообщает
сообщество: сообщество
сообщить: сообщить
соответствие: соответствии
соответствовать: соответствует
сохранение: сохранением
сохранить: сохранившая
спиритизм: спиритизм
спиритуализм: спиритуализм
спиритуалистический: спиритуалистическая
способный: способна
справка: справка
српски: српски
српскохрватски: српскохрватски
ссылка: ссылка ссылками ссылки
стадий: стадии стадия
статистика: статистика
стать: стал
статья: статью статья статье статьи
стита: стита
стихия: стихии
страница: страницы страница страницу странице
суриков: сурикова
существо: существа
существовать: существуют существует
схожий: схожей
считать: считает
считаться: считалось считается считаться
сюда: сюда
т: т
также: также
тарология: тарология
тацит: тацит тацита
тегилим: тегилим
текст: текст тексты
текущий: текущие текущую текущая
тело: тело
темура: темура
теософия: теософия
термин: термина
тетраграмматон: тетраграмматон
теургия: теургия
тип: тип
товарный: товарный
толкование: толкования
томпсон: томпсона
тот: тот той
традиция: традициями
требовать: требуешь требуют
триумф: триумф
тронуть: тронутый
труд: труда
ты: тебе
тысяча: тысячу
уголок: уголке
указание: указанием
указатель: указателе
умирать: умирает
ундина: ундины
уникальный: уникальная
упоминание: упоминание
упоминать: упоминает
упоминаться: упоминается
условие: условий условия
утверждать: утверждают
участие: участие
участник: участниками
фабия: фабия
февраль: февраля
феникс: феникса феникс фениксом фениксы фениксе
физиогномика: физиогномика
философский: философский философского
финист: финист
флюид: флюид
фойник: фойник
фольклорист: фольклориста
фонд: фонд
форма: формой
форум: форум
фридрих: фридриха
футарк: футарк
хава: хава
хавы: хавы
хадаш: хадаш
характеризовать: характеризует
хлопоты: хлопот
хол: хол
холя: холь
хоронить: хоронит
храм: храм
христианский: христианская христианском христианской христианский
христианство: христианстве
христос: христа
царить: царя
целый: целом
церемониальный: церемониальная
церковь: церковь
цитировать: цитировать
частность: частности
человек: человека
человеческий: человеческого
через: через
читать: читать
шотландец: шотландцев
э: э
эден: эдене эдена
эзотеризм: эзотеризм
экзорцизм: экзорцизм
элегия: элегии
элемент: элемент
элементали: элементали
эликсир: эликсир
элиэзер: элиэзер
эмблема: эмблемы
энциклопедический: энциклопедический
энциклопедия: энциклопедии
это: это
этот: этими эта
эфир: эфир
юлия: юлий
юнга: юнга
язык: языках
языковой: языковом
ярко: ярко
