август: августа
авторитетный: авторитетные
авторство: авторства
азия: азии
алкалоид: алкалоидов алкалоиды
алфавит: алфавиту
алхимический: алхимический
альраун: альраун
альрауне: альрауне
амулет: амулетов
англ: англ
англия: англии
анджей: анджея
анна: анны
антропоморфный: антропоморфного
апрель: апреля
архивировать: архивировано
архимандрит: архимандрита
аста: аст
астериды: астериды
атака: атак
баз: базы
беларуская: беларуская
беловатый: беловатого
белый: белая
бесплодие: бесплодия
бесстебельный: бесстебельные
библейский: библейская
библиографический: библиографических
библия: библия библии
битва: битве
богатый: богаты богатым
больший: большая больше
ботанический: ботаническое
бродяга: бродягу
брокгауза: брокгауза
бунин: бунин
български: български
быт: быт
бытие: бытие бытия
быть: были
вампир: вампир
варьироваться: варьируется
василиск: василиска
ведьмак: ведьмака
вернуть: вернуло
верный: вернейшее
версия: версия версии
взгляд: взглядом
вид: виды видом вида вид виде
викивидах: викивидах
викивиды: викивиды
викиданных: викиданных
викимедиа: викимедиа
википедии: википедии
википедия: википедия
викисклад: викисклад
викискладе: викискладе
викисловаре: викисловаре
викисловарь: викисловарь
викитека: викитека
викторианский: викторианской
вино: вина
вклад: вклад
включать: включает
внешний: внешние
возвращать: возвращающее
возможный: возможны
войти: войти
волшебный: волшебные волшебная волшебное
воплотить: воплотила
ворхклик: ворхклик
восток: востоке
вплоть: вплоть
враждебный: враждебные
вредный: вредное
время: времена
все: всех
встречаться: встречаются
второкурсник: второкурсники
вудвилл: вудвилл
выпить: выпьет
вырастить: выращенной
вырывать: вырывают
высокий: высоко
высокоактивный: высокоактивные
вытаскивать: вытаскивают
выход: выход
г: г
газета: газета
галлюциноген: галлюциногена
галлюциногенный: галлюциногенные
ганс: ганс
гарри: гарри
гейнц: гейнц
генрих: генриха
геральта: геральта
германий: германии
германский: германской
гималаи: гималаях
гиосциамина: гиосциамина
гл: гл
глава: главе
глаз: глаза
говорить: говорит
год: года
государство: государством
грегори: грегори
гриб: грибы
густав: густав
давний: давние давняя
дар: дары
дата: дата
датский: датская
дать: данных
два: два
девушка: девушки
действие: действие
действовать: действовать действует
делать: делают
демонический: демонический
джоан: джоан
диаметр: диаметр
диоскоридом: диоскоридом
дистиллят: дистиллятом
добавить: добавив
доктор: доктора
должен: должна
домен: домен
доп: доп
дополнительный: дополнительные
достигать: достигает
доступный: доступен
древний: древнейших древнего
древность: древности
другой: другие других
дух: дух
е: е
египет: египта
елизавета: елизаветы елизавета
ефрона: ефрона
желать: желая
желтый: желтую
жена: жена жену
женский: женские
женьшень: женьшеня
женя: жене
жизнь: жизни
заболоцкий: заболоцкая
заглавный: заглавная
западный: западном
запись: запись
заполнить: заполнить
зарегистрировать: зарегистрированный
затем: затем
зачастую: зачастую
зачать: зачатого
заявление: заявление
зелье: зелье
земля: земли
знак: знак
значение: значения
значительно: значительно
иаков: иакова
иван: иван
избавиться: избавиться
избранный: избранные
известно: известно
изготовление: изготовлении изготовления
изд: изд
издавать: издающее
изначальный: изначальный
изображение: изображениями изображения изображение
иметь: имеют иметь
иначе: иначе
иногда: иногда
инструмент: инструменты
информация: информация информации
инфразвуковой: инфразвуковое
искусство: искусстве
использование: использования
использовать: использующие
использоваться: используются использовалось использовался
история: история
источник: источников источники источник
исход: исхода
июль: июля
йоркский: йоркской
какой: какого
каллимако: каллимако
кальфуччи: кальфуччи
каталанский: каталанская
каталог: каталогах
категорически: категорически
категория: категории
качество: качестве
китай: китая
клад: клада
классификация: классификация
климт: климт
книга: книг
код: код
кодекс: кодекс
колдовской: колдовских
колокольчик: колокольчиков
комедия: комедия
комната: комната
конец: конце
конфиденциальность: конфиденциальности
копетдаг: копетдаге
корень: корню корня корень корни корнями
король: короля
короткий: короткий
который: которым которое которой которые которых котором
крайне: крайне
крахмал: крахмалом
крещение: крещение
крик: крик
кричать: кричит
крошечный: крошечное
крупный: крупными крупные
кук: куки
культура: культура
л: л
ламииды: ламииды
лата: лат
легенда: легендах легенда легенды
лекарственный: лекарственные лекарственная
лие: лие
лии: лии
лингвострановедческий: лингвострановедческий
лист: листья листьями
литература: литература литературе
лицензия: лицензии
ложа: ложе
любовный: любовных
м: м
магический: магическую
макиавелли: макиавелли
малый: малый
мандрагора: мандрагоре мандрагора мандрагоры мандрагор
маргарета: маргарет
маркин: маркина
марта: марта
материал: материал
мать: мать
мая: мая
медицина: медицине медицины
медицинский: медицинского
международный: международное
мессер: мессеру мессера
мечта: мечта
мир: мира мире
миф: мифы
мифология: мифологии мифология
младший: младшая
многие: многие
много: более
многолетний: многолетние многолетних
мобильный: мобильная
мочь: можете могут могло могла
мужской: мужские
мужчина: мужчины
мунк: мунк
мы: нами
н: н
навигация: навигации навигация
название: название
наиболее: наиболее
найти: найденные
написать: написал
напоминать: напоминают
например: например
народ: народов
народный: народной
настойка: настойки настойку
насчитываться: насчитывается
натуралист: натуралистами
научный: научная научное
начало: начале
невеста: невесты
недостаток: недостаток
некоммерческий: некоммерческой
неоднократно: неоднократно
неопр: неопр
несколько: несколько
никифор: никифора
никколо: никколо
никто: никто
ниче: ниче
ничу: ничу
новость: новости
новый: новые
норвежский: норвежская
ночь: ночь
об: об
облик: облик облике
обмен: обмен
обозначать: обозначало
обращение: обращения
обсуждение: обсуждение
общий: общий общей
оглушать: оглушающий
один: один
оказываться: оказывается
окаменелый: окаменел
оккультный: оккультный
окраска: окраску
он: нему
онлайн: онлайн
опасный: опасна
опиат: опиатам
описание: описание
описать: описаны
опытный: опытными
оранжевый: оранжевую
организация: организации
оружие: оружие
основной: основная
особенно: особенно
осуществиться: осуществиться
ответственность: ответственности
отдельно: отдельно
отдельный: отдельных
отказ: отказ
отличаться: отличаться
отредактировать: отредактировать отредактирована
охраняться: охраняется
очень: очень
ошибка: ошибке
первоначально: первоначально
первый: первая
передавать: передавали
передний: передней
перейти: перейти
пересаживать: пересаживают
переть: при
перехватывать: перехватывает
персональный: персональные
песн: песн
песнь: песни песней
печать: печати
писательница: писательницы
плантагенет: плантагенет
плод: плоды
побочный: побочные
поведение: поведения
повесть: повесть
подвергнуться: подвергшемуся
подложить: подложить
подобно: подобно
подробный: подробнее
подсемейство: подсемейство
пожертвовать: пожертвовать
поиск: поиск поиску
пока: пока
пол: поле пол
политик: политика
получить: получить
портрет: портрет
порядок: порядок
посвятить: посвящена
последний: последний
последовать: последовавшее
посмотреть: посмотрел
постель: постель
постоянный: постоянная
постфикс: постфиксом
поттер: поттер поттера
почва: почвы
поэтому: поэтому
править: править
правка: правок правки
предлагать: предлагают
представитель: представители
представиться: представились
преимущественный: преимущественно
приворот: приворотов
применяться: применялся
примечание: примечания
приносить: приносит
принцесса: принцесса принцессы
принять: принято
приписывать: приписывали
приписываться: приписывалась
про: про
проверить: проверенной
проверка: проверки
проверять: проверяема
проверяться: проверялась
проект: проектах
произрастать: произрастает произрастающие
происходить: происходит
проклятие: проклятию
пророчество: пророчества
просмотр: просмотры
пространство: пространства
просьба: просьбе
противоядие: противоядие
прямая: прямым
пряность: пряностями
психотропный: психотропные
пустить: пустили
пять: пяти
раздел: разделами разделе
разделять: разделять
различаться: различался
разработчик: разработчики
расположить: расположенные
растение: растение растения
растенье: растений
рахиля: рахиль
ребенок: детей
регис: регис
редакция: редакцией
результат: результате
рекомендация: рекомендации
рекомендоваться: рекомендуется
реликт: реликтом
ресурс: ресурсы
рецепт: рецептах
рии: рии
род: рода род
розетка: розетку розетки
роман: роману романе роман
российский: российская российской
ростовец: ростовцев
роулинг: роулинг
рувим: рувимом
русский: русский
саженец: саженцы
самоубийство: самоубийство
санкт-петербург: спб
сантиметр: см
сапковского: сапковского
сведение: сведения
свежий: свежие
свободный: свободной
свое: своего
свой: своей
свойство: свойство свойства
связанный: связанные
связаться: свяжитесь
связывать: связывают
связь: связи
сделать: сделать
седой: седые
седьмой: седьмого
семейство: семейство семейства
семироль: семироль
сердце: сердца
сериал: сериале
серия: серии
сестра: сестре
сила: силу сила силы
сильнодействующий: сильнодействующего
система: системе
систематик: систематика
сказаться: скажется
скандальный: скандальный
скачать: скачать
скополамин: скополамина
скрытый: скрытые
сладкое: сладкого
словарь: словари словарь
слово: слово
служебный: служебные
случай: случаях
случайный: случайная
смертельный: смертельно смертельного
смерть: смерти
смесь: смесь
сноска: сносок
снять: снятом
собрать: собраны
собственный: собственного
событие: события
советский: советская
совратить: совратить
содержание: содержание
содержать: содержат содержит
создать: создать
соломон: соломона
сообщество: сообщество
сообщить: сообщить
соответственно: соответственно
состав: состав
сохранение: сохранением
справка: справка
спутниковый: спутников
средиземноморье: средиземноморье
средневековый: средневекового
средневековье: средневековья
средний: средней
средство: средство
ссылка: ссылка ссылками ссылки ссылок
старший: старшей
старый: старая
статистика: статистика
статья: статью статья статьи
стеблевой: стеблевая
стержневой: стержневыми
стихотворение: стихотворение
стоить: стоили
стонать: стонет
страница: страницы страница страницу странице
суеверие: суеверию
суперастериды: суперастериды
супруг: супруга
супружеский: супружеское
существо: существо
существовать: существуют
схватить: схватить
сын: сыном
сюда: сюда
т: т
тайный: тайная
также: также
таксон: таксон
таксономия: таксономия
текст: текст
текущий: текущие текущая
тело: тела
тереть: три
термин: термина
тип: тип
товарный: товарный
топоров: топоров
тот: те та
точно: точно
трава: травы
травянистый: травянистые травянистых
трактат: трактата
требовать: требуют
третичный: третичной
тропановых: тропановых
туркменский: туркменская
тюдора: тюдора
тяжелейшие: тяжелейшие
угощать: угощает
угрожать: угрожающие
удаленный: удалена
указание: указанием
улица: улице
упоминание: упоминания
упоминаться: упоминается
употребление: употребление
условие: условий условия
уступать: уступает
участие: участие
участник: участниками
фантастический: фантастическая
фармация: фармации
февраль: февраля
фигура: фигуру
филипп: филиппы
фильм: фильме
фиолетовый: фиолетового
флора: флоры флора
фонд: фонд
форма: форму
форум: форум
хватать: хватает
химический: химический
хитрец: хитрец
хогвартс: хогвартс
хозяин: хозяина
царство: царство
цвет: цвет
цветковый: цветковые
цветок: цветки
цветущий: цветущего
цениться: ценились
ценный: ценный
цитировать: цитировать
частность: частности
часто: часто
человек: людьми человека
человеческий: человеческую человеческого
читать: читать
чтобы: чтобы
шаблон: шаблоне
широкий: широко
эвдикоты: эвдикоты
эверс: эверс
экз: экз
элемент: элемент
эмиель: эмиель
энтеогены: энтеогены
энциклопедический: энциклопедический
энциклопедия: энциклопедия энциклопедии
это: это
этот: эта
эукариот: эукариоты
явление: явления
являться: является
ягода: ягоды
ядовито: ядовито
ядовитый: ядовитое ядовитые ядовитым
язык: языках
