август: августа
авторство: авторства
адаптированный: адаптированная
адаптировать: адаптировать
азарт: азарте
азкабана: азкабана
алисий: алисия
алфавит: алфавиту
альбус: альбус
альбусу: альбусу
амбридж: амбридж
аналог: аналог
англ: англ
англия: англия англии
анджелина: анджелина
анжелин: анжелину анжелина
арбитр: арбитром
архив: архив
архивировать: архивировано
архивный: архивная
ассоциация: ассоциацией ассоциации
аут: аут
балл: баллов
банк: банк
барбарис: барбариса барбарис
барда: барда
башня: башня башни
бегать: бегают
бедный: бедную
безопасность: безопасности
беларуская: беларуская
белла: белл
берти: берти
библиографический: библиографических
бидля: бидля
билет: билеты
бит: битами
битва: битвы
битый: битой
благодаря: благодаря
бладжер: бладжер
бладжера: бладжера
бладжерами: бладжерами
бладжеров: бладжеров
бладжером: бладжером
бладжеры: бладжеры
блестяще: блестяще
блетчли: блетчли
блэк: блэк
блэка: блэка
болгарин: болгары
болгария: болгария болгарией
болгарка: болгарка
болгарский: болгарским болгарская болгарской болгарских болгарские
болезнь: болезни
болельщик: болельщиков болельщики
боллтаун: боллтаун
болото: болота
болттауна: болттауна
больница: больницу
больничный: больничном
больший: большую больше
большой: велик большого большом большой
бомбочка: бомбочки
борьба: борьбу
боттс: боттс
боул: боул
боумен: боумен
бросить: бросили
броситься: бросился бросились
броский: бросок
брянск: брянска
бушевать: бушевали
български: български
бывать: бывают
быстро: быстро
быстрый: быструю
быть: были
бэгмен: бэгмен
важный: важной
вариант: варианты
вариация: вариацию
василиск: василиска василиск
ввиду: ввиду
вейзи: вейзи
вейл: вейл
вейлы: вейлы
век: веках
великобритания: великобритании
вернуться: вернулся
версия: версия версии
вести: вела ведут
весь: вся
вид: видом вид виде
видеть: видела
викиданных: викиданных
викимедиа: викимедиа
википедии: википедии
википедия: википедия
викисклад: викисклад
викискладе: викискладе
викия: викия
виктор: виктор виктора
вино: вина
виновник: виновник
винсент: винсент
виртуозно: виртуозно
вклад: вклад
включительно: включительно
владеть: владеет
власть: власти
влияние: влияния
вместить: вместить
вместо: вместо
внешний: внешние
вниз: вниз
внимательно: внимательно
вновь: вновь
внутрь: внутрь
возвращаться: возвращается возвращаются
возвращение: возвращение
воздух: воздухе
возмутить: возмутил
возмущение: возмущение
возникать: возникает
возникнуть: возникнут
воинственный: воинственный
войти: войти
волан: волан
волк: волки волков
волчанов: волчанов
волшебник: волшебников волшебники волшебниками
волшебный: волшебные волшебный
вон: вон
вообще: вообще
вооруженный: вооружены
ворот: ворота воротами
восклицать: восклицает
воскрешать: воскрешающий
воспламенение: воспламенения
впадина: впадине
впервые: впервые
вплоть: вплоть
впоследствии: впоследствии
впрочем: впрочем
вратарь: вратарю вратарь
врезаться: врезается
временить: времени
время: временем время временам
вронский: вронского
все: всех всего всем
вселенная: вселенная вселенной
всеять: всей
вскоре: вскоре
вспоминать: вспоминает
вспомнить: вспомнив
второе: второе
второй: второй
вуд: вуд
входить: входить
выбирать: выбирают
выгодный: выгодное
выделить: выделен
выемка: выемок
вызвать: вызвало
выздоравливать: выздоравливают
выиграть: выиграла выиграл
выигрывать: выигрывать выигрывает
выйти: выйти выйдя вышли
выковать: выковал
вылетать: вылетает
вымыслить: вымышленные вымышленная
выпить: выпив
выполнять: выполняет выполняя
выпускать: выпускать
высматривать: высматривает
высокий: высоких высшего
выступить: выступили
выходить: выходит
выясняться: выясняется
галеон: галеонов
галлеонах: галлеонах
гандбол: гандбола
гарри: гарри
геймдизайнеров: геймдизайнеров
гера: герой
гермиона: гермиона гермионой
героизм: героизме
глава: глава
главное: главное
говорить: говорит
год: году лет год годы года
годриковой: годриковой
гойл: гойл
гойла: гойла
гойлом: гойлом
гол: гол голы гола
голова: голову голова голов голове
голодать: голодали
голый: голыми
гоняться: гоняется гоняться
гореть: горящую
госпожа: госпожа
гость: гостей
готовиться: готовилась готовится
гоффери: гоффери
график: график
грегори: грегори
грейнджер: грейнджер
гремучий: гремучую
гринготтс: гринготтс
грифиндору: грифиндору
гриффиндор: гриффиндор
гриффиндора: гриффиндора
гриффиндорским: гриффиндорским
гриффиндору: гриффиндору
гриффиндорцев: гриффиндорцев
гриффиндорцы: гриффиндорцы
громить: громит
грязно: грязно
грязный: грязного
губа: губам
давать: давая
давно: давно
дальнейший: дальнейшем
дамблдор: дамблдор
дамблдора: дамблдора
дамблдору: дамблдору
дар: даров дары
дартмуре: дартмуре
дата: дата
дать: данный
два: два две двух
де: де
действовать: действовать
декабрь: декабря
делать: делать делая
демельза: демельза
дементоров: дементоров
дементоры: дементоры
день: дней дня
деньга: деньги
дерек: дерек
дж: дж
джек: джека
джимми: джимми
джинни: джинни
джоан: джоан
джонсон: джонсон
джордж: джорджу джордж джорджа
диггори: диггори
дилогия: дилогия
димитров: димитров
дин: дином
дина: дин
дисквалифицировать: дисквалифицирован дисквалифицированного
дисквалифицируется: дисквалифицируется
дискуссия: дискуссию
дитя: дитя
длиться: длиться
добавить: добавил
добби: добби
доиграть: доигран
док: док
долгий: долгом долго
должен: должны должен
должный: должной
долорес: долорес
домовой: домовым
домыть: домой
дополнительный: дополнительные
достаться: достанется
достоверность: достоверность
доступный: доступен
драка: драку драке драки
драко: драко
древность: древности
друг: друг другом друга другу
другой: другим другой другие других
дурмстранг: дурмстранг
дыра: дырой
дэйвис: дэйвис
европа: европы
египет: египет
ежедневный: ежедневный
еженедельник: еженедельник
естественно: естественно
жест: жесты
жизнь: жизни
жить: живший
забивать: забивает
забитый: забитый
забить: забила забить
забросить: забросить
забыть: забыл
завещать: завещает
завоевать: завоевать завоевал
заглавный: заглавная
загонщик: загонщиками загонщики загонщиков загонщик загонщика
загонщицу: загонщицу
задача: задачей
заканчивать: заканчивает
заканчиваться: заканчивалась заканчивается
заклинание: заклинанием заклинания заклинание
заключить: заключена
заклятие: заклятие
заколдованный: заколдованный
заколдовать: заколдовал
заколдовывать: заколдовывал
закончить: закончившие
замена: замены
заменить: заменить
заменять: заменяла заменял заменявшую
заметить: заметить
заметно: заметно
занятый: заняты
запасной: запасной запасные
записать: записаны
запись: запись
заплясать: заплясали
запрещать: запрещает
запускать: запускает
зарегистрировать: зарегистрированный
затем: затем
затянуться: затянулась
зафиксировать: зафиксированного
захария: захария
зачастую: зачастую
защитить: защитить
защищать: защищают защищает
заявление: заявление
заявлять: заявляет
зверь: звери
зелье: зелье
земля: земли земле землю
злиться: злится
зло: зла
знак: знак
значение: значения
значительно: значительно
зогров: зогров
золотистый: золотистый
золотой: золотом золотого золотых золотой
зритель: зрителей зритель
ив: иву
иванов: иванова
игра: игра игр игру играх игре игрой игры
играть: играют играет играть игравшие
игровой: игровое игровым
игрок: игроков игрока игроки игрок игроку
идея: идея
избивать: избивают
избранный: избранные
изготовитель: изготовитель
изготовление: изготовлении
изложить: изложенных
изменить: изменила
изначально: изначально
изобретательный: изобретательные
иметь: имевшие имеют имеет
иметься: имеется
иногда: иногда
инструмент: инструменты
интенсивный: интенсивные
интересный: интересные
интерн: интернов
инфа: инфа
ирландия: ирландией ирландии ирландия
ирландский: ирландские ирландского ирландский ирландская
исключать: исключающих
исключаться: исключается
исключение: исключения
искушение: искушением
использование: использование использования
использовать: используя используют
использоваться: используются
испытание: испытаний
история: история истории
источник: источник
итог: итог итоге
июнь: июня
кадры: кадры
каждый: каждые каждой каждый
какой: какая какие каким
кальи: кальи
камень: камень
капитан: капитан капитана капитаном
карточный: карточная
касаться: касаться
каталог: каталогах
категория: категории
кафедральный: кафедральных
квиддич: квиддич
квиддича: квиддича
квиддиче: квиддиче
квиддичные: квиддичные
квиддичный: квиддичный
квиддичу: квиддичу
квирдитч: квирдитч
квиринуса: квиринуса
квиррелл: квиррелл
квиррелла: квиррелла
квирреллом: квирреллом
квирреллу: квирреллу
квоффл: квоффл
квоффла: квоффла
квоффлом: квоффлом
квоффлу: квоффлу
керка: керка
кидать: кидать
класс: класса
клетка: клетке
книга: книгах книги книге
ко: ко
когтевран: когтевран
когтеврана: когтеврана
когтевраном: когтевраном
код: код
кодекс: кодекс
кожа: кожей
колдовство: колдовства
колдун: колдунов
количество: количества
коллекционный: коллекционная
кольцо: колец кольцо кольцами кольца
команда: команды командами командах команда команду команде команд
комментатор: комментатор
комментировать: комментировал
комната: комната комнаты
комплекция: комплекцией
конец: концов концах конце конец конца
конолли: конолли
конструктор: конструктор
контакт: контакт
конфета: конфеты
конфиденциальность: конфиденциальности
конфундус: конфундус
копия: копия
кормак: кормак
кормака: кормака
король: король
короткий: короткие короткий
косвенно: косвенно
который: которым которое которому которыми которую которого которые которых которая который
крайний: крайней
крам: крам
крама: крама
красный: красного
красочный: красочное
крепкий: крепкой
кролли: кролли
кроме: кроме
крохотный: крохотную
круг: круг
круговой: круговой
крупный: крупный
крыло: крыле
крылышко: крылышками
крэбб: крэбб
крэббом: крэббом
кто: кого
кубок: кубок
кузнец: кузнец
куигли: куигли
кук: куки
купить: купил
кут: кут
кэти: кэти
лавгуд: лавгуд
лада: лад
левски: левски
левый: левой
легко: легко
лежалый: лежал
лезть: лезет
лепреконским: лепреконским
лепреконы: лепреконы
лес: лес
летать: летая летают летающих летать летающий
лететь: летящего летит летящие
либо: либо
ливень: ливень
ликование: ликование
линч: линч
линча: линча
линчем: линчем
лицензия: лицензии
лично: лично
лишение: лишениях
ловец: ловца ловцом ловцу ловцов ловец ловцами ловцы
ловить: ловит ловить
локальный: локальную
локация: локации
локоть: локтем
ломать: ломает
лорд: лорда лорд
любой: любое любой
людо: людо
люксембург: люксембурга
люциуса: люциуса
маг: маги маг
магазин: магазин
магический: магических
магия: магия магии
маглов: маглов
магловским: магловским
маглоотталкивающие: маглоотталкивающие
маглы: маглы
майлс: майлс
макгонагалл: макгонагалл
македонский: македонски
маклагген: маклагген
маклаггена: маклаггена
маленький: маленькая
маллет: маллет
малфоем: малфоем
малфой: малфой
малфоя: малфоя
мантия: мантию
маркус: маркусом маркус
мастер: мастер
материал: материал
матч: матч матча матчем матчей матче
мая: мая
медиа: медиа
медиафайлы: медиафайлы
международный: международный международного международной
менее: менее
меняться: меняется
мера: мере
место: место места мест
металлический: металлические
метла: метлу метле метлами метла метлы
мимо: мимо
минервы: минервы
минимальный: минимальным
министерство: министерство министерству
министр: министр министра
минута: минут минуты
мир: мира мир мире
миссис: миссис
многие: многие
много: более много
мобильный: мобильная
модест: модеста
можно: можно
мозговой: мозговую мозговой
молния: молнию
молодая: молодой
момент: моменту момент
монтегю: монтегю
моран: моран
морт: морт
мортом: мортом
москва: москвы
мочь: мог могут
мощный: мощные
мужской: мужскую
мустафа: мустафа
муха: муха
мы: нами нам
мяч: мяча мяч мячи мячей
мячик: мячик
набор: набора
набрать: набранный набрать
навигация: навигации навигация
навсегда: навсегда
награда: награда
над: над
надеяться: надеясь
надолго: надолго
надпись: надпись
название: названием название
назначать: назначают
назойливый: назойливых
называть: называемый называемых
называться: называются
найджел: найджел
найджела: найджела
найти: найти
наказание: наказание
наказать: наказан наказаны
наказывать: наказывают
накладывать: накладывая
наконец: наконец
наложить: наложены
нанимать: нанимают
нападение: нападений нападения
направиться: направились
направление: направлении
направлять: направляют
например: например
напротив: напротив
напряжение: напряжении
нарушение: нарушения
нарушить: нарушивших нарушившая
настолько: настолько
научиться: научились
находиться: находится
начало: началом начала
начаться: начались
начинать: начинает
наш: наших наш
небо: небе
небольшой: небольшой небольшим
невидимка: невидимка
неделя: недели
недоброжелательный: недоброжелательно
недостаток: недостатков
недостоверный: недостоверный
независимый: независимой
неизвестно: неизвестно
некий: некая
некоммерческий: некоммерческой
некоторые: некоторые
нельзя: нельзя
немаленьким: немаленьким
необходимо: необходимо
необходимый: необходимым
неограниченный: неограниченное
неоднократный: неоднократные
неопр: неопр
неполный: неполный
неприличный: неприличные
нервировать: нервирует
нервничать: нервничает
несколько: несколько
несмотря: несмотря
нечаянно: нечаянно
нижний: нижнего
никто: никто
нимбус: нимбус
новгород: новгорода
новенький: новенького
новый: новый новой новые
нога: ног ноги
норрис: норрис
нос: нос
ноябрь: ноября
нравиться: нравится
нужно: нужно
ныне: ныне
об: об
оба: обе оба
обеспечивать: обеспечивают
обитание: обитания
обладать: обладает
облик: облик
образ: образом
обращение: обращения
обрести: обрели
обсуждение: обсуждение обсуждения
общий: общий
объявить: объявил объявлен
обычно: обычно
овальный: овальным
оглушить: оглушила
огненный: огненные
огонь: огня
огромный: огромные
одежда: одежды
один: одной одном один одному одно одним
однако: однако
ожерелье: ожерельем
оказаться: оказалось оказался
оказываться: оказываются оказывается
оканчиваться: оканчивалось
около: около
окончание: окончания
окончательный: окончательным
окончить: окончил
оливер: оливер
он: нему
они: им них
опасный: опасных
описание: описание
описать: описанных описан
оправиться: оправившись оправился
опрокинуть: опрокинув
опытный: опытными
организация: организации
организовать: организован
орден: орден
оскорблять: оскорблять
основной: основную основная
особенно: особенно
остальное: остальные остальных
остаться: оставшихся
осыпать: осыпали
отбивать: отбивать отбивая отбивают
отбить: отбитым отбил
отбывать: отбывает отбывал
ответ: ответ
ответственность: ответственности
отдел: отдела
отдельный: отдельных отдельные
отказ: отказ
откладывать: откладывает
откровенно: откровенно
открываться: открывается открываюсь
открыть: открыл
отличаться: отличался отличаться
отменять: отменяют
относиться: относящийся
отобрать: отобрать
отпасовать: отпасовать
отправить: отправят
отравить: отравить
отредактировать: отредактирована
отряд: отряд
отстранение: отстранения
отчитывать: отчитывает
официальный: официальными официальных
охотник: охотник охотники охотником охотникам охотника
охотников: охотников
охранять: охранявшие охраняемым
очень: очень
очередь: очередь
очки: очкам очков
ошибка: ошибке
падать: падает
падение: падении
палый: пал
память: памятью память
парад: парад
парк: парк
пародия: пародии
пасовать: пасуют пасовать
патронум: патронум
пенальти: пенальти
первое: первым первого первые
первый: первой первый
перевес: перевесом
перед: перед
передать: передать
переделывать: переделывают
перейти: перейти
переломить: переломить
перемещаться: перемещающийся перемещались
переодетый: переодетыми
перепасовывать: перепасовывать
переть: при
периметр: периметр
персонаж: персонажи
персональный: персональные
перчатка: перчатках
песня: песня песню
петербург: петербурга
петь: поют
печать: печати
пиво: пиво
пик: пике
пикс: пикс
пиксу: пиксу
пилотаж: пилотажа
питаться: питаются
плохо: плохо
плохой: плохой
победа: победу победы
победить: победивший победить
побеждать: побеждает
поведение: поведение поведения
подарить: подаренной
подарок: подарке
подать: подать
подача: подаче
поджигать: поджигает
поднять: поднятых
подозревать: подозревает
подробный: подробнее
подряд: подряд
пожаловать: пожалуй
пожертвовать: пожертвовать
пожизненно: пожизненно
пожиратель: пожиратели
позапрошлый: позапрошлом
позволить: позволить позволила
позволять: позволяли
поздний: позже
позиция: позиции позиция
поимка: поимкой поимке поимка
поиск: поиски поиск поиску
поймать: поймала поймавшему поймавший поймает пойманный поймать поймал
пока: пока
показать: показано показать
показывать: показывая
покидать: покидать
пол: поле
поле: полем полю поля
политик: политика политике
положение: положение
полтергейст: полтергейстах
полукровка: полукровка
полумна: полумна
получать: получает
получить: получила получил получили получить
польза: пользу
помешать: помешал помешать
помнить: помнит
помойка: помойке
помочь: поможет
помощь: помощью
попадание: попадание
попадать: попадает
попасть: попав попали попал
популярность: популярность
популяция: популяции
поражение: поражение
порскова: порскова
портал: портал порталов
посетить: посетил
поскольку: поскольку
последний: последний последние последнем последней
посол: после
посредственный: посредственных
поставить: поставлена
постоянный: постоянная
пострадать: пострадавшей
потерять: потерял
поттер: поттером поттер поттера поттеру поттере
поттеромания: поттеромания
поучать: поучать
поэтому: поэтому
появиться: появились появился
появление: появлении
появляться: появляются появляется
пояснение: пояснений
правило: правилами правилам
править: правила править правил
правка: правок правки
правый: правую права право
предварительно: предварительно
предел: пределов
предмет: предметы
предпочтительно: предпочтительно
председатель: председатель
представитель: представители
представиться: представились
представлять: представляющие
предусмотреть: предусмотрены
предшествовать: предшествовал
предъявляться: предъявляются
предыстория: предыстория
прекращаться: прекращалась
препирание: препирания
прибывать: прибывали
прибытие: прибытия
привлечь: привлекли
пригодиться: пригодился
придумать: придумана
приезжать: приезжала
признанный: признан
признать: признали
призывать: призывающее
прикладывать: прикладывает
применение: применение
применить: применил применила
применять: применяет
примечание: примечания примечание
принадлежать: принадлежат
приносить: приносящий приносит принося
принц: принц
принять: приняты
присуждаться: присуждались
присутствовать: присутствует
притворяться: притворяется
причина: причина
проба: пробы проб
пробегать: пробегает
проверить: проверенной проверить
проверка: проверки
проверяться: проверялась
проводить: проводит
проводиться: проводятся проводится проводился
проворный: проворную
программка: программке
продолжать: продолжает продолжать
проект: проектах
проиграть: проиграл проиграли проиграть
проигрывать: проигрывает
проигрышный: проигрышное
производитель: производители
производство: производство
произвольно: произвольно
происходить: происходит происходящем происходили
проклясть: проклятое
пролететь: пролететь
промахиваться: промахивается
пропускать: пропускает
пропустить: пропустит
пророк: пророк
просить: просил
просмотр: просмотры
пространство: пространства
против: против
противник: противника
противница: противницы
противный: противном
противоположный: противоположном противоположных
противостоять: противостоять
профессионал: профессионал
профессор: профессор
прочий: прочее
прямой: прямо
птица: птицу птиц
птичка: птичку птичка
путеводитель: путеводитель
пуффендуем: пуффендуем
пуффендуец: пуффендуец
пуффендуй: пуффендуй
пуффендуя: пуффендуя
пытаться: пытаются пытался пытались
пьюси: пьюси
пята: пятой
пятый: пятый
пятьдесят: пятьдесят
пятьсот: пятьюстами
работа: работу
работать: работают
радость: радостью
раз: разу
разбивать: разбивает
разбушеваться: разбушевавшихся
разгневать: разгневанные
разгомным: разгомным
раздавливать: раздавливали
различный: различные
разница: разницей
разработчик: разработчики
разрешить: разрешено
райан: райан
райт: райт
ракетка: ракетки
ранний: раньше
распевать: распевают
распознавание: распознавания
распределять: распределяющая
рассказ: рассказы
рассказываться: рассказывается
рассчитать: рассчитан
раунд: раунд
регулус: регулус
редкий: редкий
резкий: резко
результат: результате результат результатом результаты
реклама: реклама
религиозный: религиозные
ресурс: ресурсы
решающий: решающей решающий
решение: решение
ричи: ричи
риччи: риччи
робинс: робинс
роджер: роджер
родитель: родителей
родиться: родился
роль: роль
роман: романов
рон: рону рона рон
рональд: рональд
россия: россии
рост: ростом
рот: ртом
роулинг: роулинг
рубеус: рубеус
рука: руку рукой руками рук руках руки
русский: русский
сам: самой самое
саммерби: саммерби
самонаводящийся: самонаводящиеся
самостоятельно: самостоятельно
самый: самую самый самым самые
санкт: санкт
сантиметр: см
саундтрек: саундтрек
сбивать: сбивает
сборная: сборная сборные сборных сборной
сбрасывать: сбрасывать
сведение: сведения сведений
свежий: свежие
свободный: свободной
сводить: сводили
свое: свои своим
свой: свой своей свою
связанный: связанные
связаться: свяжитесь
сдаваться: сдаваться
сделать: сделает сделано
себя: собой
северус: северус
седрик: седрик
седьмой: седьмой
сезон: сезон
сектумсемпра: сектумсемпра
серебристый: серебристыми
середина: середине
сериал: сериал
серия: серии серию серия
сестра: сестра
сесть: сел
сжигать: сжигают
сильный: сильный
синий: синяя
сириус: сириуса
система: системе системой
сказка: сказки
скачать: скачать
сквозь: сквозь
скоро: скоро
скорость: скорости
скоткинс: скоткинс
скоур: скоур
скримжер: скримжер
скримжера: скримжера
скрываться: скрываются
скрытый: скрытые
следующий: следующий следующие
слезать: слезать
сливочный: сливочное
слизерин: слизерин
слизерина: слизерина
слизерином: слизерином
слизеринскую: слизеринскую
слизерину: слизерину
слизеринцев: слизеринцев
сломать: сломанной сломал
слоупера: слоупера
служащий: служащий
служебный: служебные
служить: служит
случай: случае случаях случай
случайный: случайная
смерть: смертью смерти
смит: смит
смотреть: смотрит
смочь: смогли смог
снегг: снегг
снегга: снегга
сниджета: сниджета
сниджетов: сниджетов
снизиться: снизилась
снитч: снитч
снитча: снитча
снитчами: снитчами
снитче: снитче
снитчей: снитчей
снитчем: снитчем
снитчи: снитчи
снова: снова
собираться: собирался
собор: соборов
собраться: собравшимся
событие: события событий
совет: совета совет
современный: современном
содержание: содержание
сожаление: сожалению
создать: создали создать
сознание: сознание
сок: сок
сокрушительный: сокрушительное
сомнение: сомнение
соображение: соображениям соображений
сообщество: сообщество
сообщить: сообщить сообщил
соответствующий: соответствующую
соперник: соперникам соперника соперников
соперница: соперницы
состав: состав
составить: составлен
состояться: состоялась
сохранение: сохранением
сочинить: сочинил
спасти: спасти спасла
специальный: специальных
спинетт: спинетт
спиннет: спиннет
список: список
спонсор: спонсорами спонсоры
спора: споры
спорный: спорное
спорт: спорта
спортивный: спортивная
способ: способов
способный: способный
справка: справка
сражаться: сражаются
сразиться: сразиться
среди: среди
средство: средство
српски: српски
српскохрватски: српскохрватски
ссылка: ссылка ссылками ссылки
стадион: стадион стадиона стадиону
становиться: становятся становится
статистика: статистика
стать: стал стало стали
статья: статья статье статьи
стена: стеной
сто: сто
стоить: стоят стой
стр: стр
страница: страницы страница страницу странице
строить: строили
строиться: строился
студент: студентов
судить: судит
судья: судью судья судьи
существо: существа
существовать: существуют существует
считать: считает
считаться: считается
сюда: сюда
таблица: таблице
табло: табло
тайм: тайм
тайный: тайная тайной
также: также
такой: таким такого такие
тактика: тактики
талантливый: талантливые
талисман: талисманы талисманам
танцевать: танцевали
текст: текст
текущий: текущие текущая
телеигра: телеиграх
телесный: телесной
тем: тем
тема: тему
тематический: тематический
теннисный: теннисные теннисный
тереть: три
термин: термина
терминология: терминологии
терпеть: терпит
терренс: терренс
терять: теряет
течение: течение течением
товарищ: товарищей
товарный: товарный
толк: толку
толкнуть: толкнул
томас: томасом томас
тот: том ту тех те тот
точно: точно
точность: точность
травма: травмами травму травмой
травмировать: травмировав
трансгрессировали: трансгрессировали
трансильвания: трансильвании
транслироваться: транслировалась
транспорт: транспортом
требование: требованиям требованию требования
требовать: требует требуют
тренировка: тренировках
третий: третий третьей
трое: трое
трой: трой
труд: трудом
трюк: трюк
турнир: турнира
турнирный: турнирной
тыквенный: тыквенный
тысяча: тысяч
тяжелейшей: тяжелейшей
убить: убит
увечье: увечьями
увидеть: увидел увидевшим
уганда: уганды
удаление: удаления
удалить: удалить
удар: ударом удары
удариться: ударился
удача: удачи
удержать: удержать
удерживать: удерживает
удовлетворять: удовлетворяли
ужесточилась: ужесточилась
узник: узник
уизли: уизли
указание: указаниями указанием
указать: указан указаны
уклоняться: уклоняться
украсть: украсть
ум: ума
умение: умение
умереть: умереть умру
уметь: уметь
умышленный: умышленно
униженный: униженный
уолперта: уолперта
упасть: упал
упоминаться: упоминается
упустить: упустит
урок: уроки
условие: условий условия
усложнение: усложнения
усовершенствоваться: усовершенствовалось
успеть: успели успел
успешный: успешно
устранить: устранить
устроить: устроили
уход: ухода
уходить: уходить
участвовать: участвует участвовал участвовать участвовало
участие: участие участием
участник: участниками
учебный: учебный учебного
учредить: учреждена
уэльс: уэльса
факт: фактов факты
факультет: факультетов факультет
фанат: фанаты фанатов
фанатского: фанатского
фантастический: фантастические
февраль: февраля
феникс: феникса
фигура: фигуры
физический: физических
филл: филл
философский: философский
фильм: фильм фильме фильмов
финал: финал
финальный: финальная финальным финального
финт: финт
фирма: фирм
флинт: флинтом флинт
фонд: фонд
форум: форум
фред: фреду фред фреда
функция: функцию
хагрид: хагрид
хаотичный: хаотично
хасана: хасан
хватать: хватает
хиггс: хиггс
хитрый: хитрый
хобби: хобби
хогвартс: хогвартс
хогвартса: хогвартса
хогвартсе: хогвартсе
ход: ход ходе
хозяин: хозяина
хороший: лучшую лучшим
хрупкий: хрупкая
цвет: цвета
целоваться: целуется
целый: целый
цель: цель
цитировать: цитировать
чанг: чанг
чар: чары
чарли: чарли
частенько: частенько
частность: частности
часто: часто
часть: часть
человек: человек людей люди
человеческий: человеческой
чемпионат: чемпионаты чемпионатов чемпионат чемпионата чемпионате
через: через
черепно: черепно
честь: честь
четыре: четыре
чжоу: чжоу
численность: численность
чистить: чистящее
читать: читать
член: членов
чтобы: чтобы
шаблон: шаблонами шаблоне
шанс: шанс
шапка: шапка
шар: шары
шарик: шарик
шармбатон: шармбатон
шест: шестах
шестая: шестой
шесть: шести
школа: школу школы
школьный: школьный
шляпа: шляпа
шотландия: шотландии
шоу: шоу
штрафной: штрафные штрафной
щепка: щепки
эдриан: эдриан
эйдан: эйдан
эйдана: эйдана
экзамен: экзамены экзаменов
экспекто: экспекто
элемент: элемент
эльф: эльфом
эндрю: эндрю
энциклопедия: энциклопедии
это: этом это этому этим
этот: этой этих эта
юркий: юрких
являться: является
язык: язык языках
январь: январе января
ястреб: ястреба
