август: августа
авторство: авторства
азкабана: азкабана
алфавит: алфавиту
англ: англ
анджелика: анджелику
ариосто: ариосто
архивировать: архивировано
архивный: архивная
астольф: астольф
астольфом: астольфом
боев: боевой
борхес: борхес
брадаманты: брадаманты
быстрый: быстр
быть: были
век: века
величина: величине
вельтмана: вельтмана
вергилий: вергилию
версия: версия версии
верх: верхом
верховый: верхового
вид: виде
викиданных: викиданных
викимедиа: викимедиа
википедии: википедии
википедия: википедия
викисклад: викисклад
викискладе: викискладе
вклад: вклад
воздушный: воздушной
возможно: возможно
войти: войти
вокруг: вокруг
время: времена
все: всех
вскоре: вскоре
встретить: встретили
вымыслить: вымышленных
г: г
галерея: галерея
гарри: гарри
герб: гербах
герой: героя
гибрид: гибрид гибриды
гиппогриф: гиппогрифы гиппогрифа гиппогрифе гиппогриф
главное: главного
го: го
год: году года
голова: головы
греча: греч
гриб: грибы
гриф: грифах грифы
грифон: грифоном грифон грифона
гюстав: гюстав
гюстава: гюстава
далекий: дальше
дата: дата
дать: данном дать
действовать: действовать
длинный: длиннее
довольный: довольно
доминик: доминик
дополнение: дополнении
дополнительный: дополнительные
дора: доре
достаточно: достаточно
доступный: доступен
другой: другому других другого
дружба: дружба
единица: единицы
еж: ежа
ездить: ездят
ездовой: ездового
ехать: едущие
жан: жан
животное: животного животные
заглавный: заглавная
запись: запись
заполнить: заполнить
зарегистрировать: зарегистрированный
захватить: захвачены
заявление: заявление
знак: знак
значительно: значительно
игра: игре
играть: играет
избранный: избранные
изображаться: изображался
изображение: изображениями
иллюстрация: иллюстрация
имя: имени
индиго: индиго
иной: иное
инструмент: инструменты
искусство: искусстве
использование: использования
использоваться: используется
история: история истории
источник: источник
итальянский: итальянский
й: й
каждый: каждое
калимероса: калимероса
категория: категории
качество: качестве
книга: книгах книге
кобыла: кобылой
код: код
кодекс: кодекс
компьютерный: компьютерной
конекоршунов: конекоршунов
конекоршуны: конекоршуны
конфиденциальность: конфиденциальности
конь: конями коня
копия: копия
корабль: корабле
короткий: короткий
который: который
кук: куки
лайт: лайт
ланселот: ланселот
лата: лат
лев: льва
лес: лесу
летать: летать
либо: либо
литература: литература
лицензия: лицензии
лошадь: лошади лошадь
лудовико: лудовико
луиса: луис
лукиан: лукиана
луна: луну
маг: маги
марта: марта
материал: материал
маховый: маховых
мачта: мачты
медиафайлы: медиафайлы
мерлин: мерлин
мерлина: мерлина
мир: мира
мифический: мифическое мифический мифические
мифологический: мифологические
мифология: мифология
мобильный: мобильная
морской: морского
мочь: могут
мужчина: мужчины
мультсериала: мультсериала
мы: нами
н: н
навигация: навигации навигация
называться: называются
нападать: нападает
населять: населяют
начало: начале
невозможность: невозможность
неистовый: неистовый
некоммерческий: некоммерческой
немаловажный: немаловажную
несообразность: несообразность
новелла: новелле новелл
новый: новые
ночное: ночных
ноябрь: ноября
об: об
обращение: обращения
обсуждение: обсуждение
обязать: обязанная
огромный: огромных
огюст: огюст
один: одного
одноименный: одноименном
означать: означающая
ок: ок
октябрь: октября
они: ими
описание: описание описанием
описывать: описывает
описываться: описывается
опытный: опытными
организация: организации
орел: орла
особенно: особенно
ответственность: ответственности
отдельный: отдельных
отказ: отказ
отличаться: отличаться
отправиться: отправиться
отредактировать: отредактирована
очень: очень
ошибка: ошибке
первое: первым
перейти: перейти
переносить: переносящий
переть: при пер
перо: перьев
персонаж: персонажи
персональный: персональные
печать: печати
писатель: писателя
поведение: поведения
поговорка: поговорка
подробный: подробнее
пожертвовать: пожертвовать
позаимствовать: позаимствовал
позапрошлый: позапрошлом
поиск: поиск поиску
пока: пока
политик: политика
полуворон: полуворон
полугрифон: полугрифон
полуконь: полуконь
полуолень: полуолень
получить: получить
понятие: понятие
популярный: популярным
порой: порой
последний: последняя последний
постоянный: постоянная
поттер: поттер поттере
почтить: почти
поэма: поэме
правдивый: правдивой
править: править
правка: правок правка правки
правящий: правящие
предок: предки
представиться: представились
прекрасный: прекрасную
признать: признать
примечание: примечания
присутствовать: присутствует
про: про
проверить: проверенной
проверка: проверки
проверяться: проверялась
проект: проектах
произведение: произведении
происхождение: происхождением
просмотр: просмотры
пространство: пространства
противник: противника
прошлый: прошлое
птица: птицы
путешествие: путешествий
размер: размеров
разработчик: разработчики
ранний: ранние
ребенок: дети
решить: решили
рисовать: рисовал
роланда: роланд
роль: роль
руджьер: руджьер
русский: русского русский
рыцарский: рыцарской
рыцарь: рыцарь
сантиметр: см
сведение: сведения
свежий: свежие
света: света
свободный: свободной
свое: своих
свойство: свойство
связанный: связанные
связаться: свяжитесь
сезон: сезона
сериал: сериала
серия: серии
синоним: синоним
система: системе
сказать: сказать
сказочный: сказочную
скачать: скачать
скрестить: скрестить
скрытый: скрытые
следовать: следует
следующий: следующий
служебный: служебные
случай: случаях
случайный: случайная
собирать: собирающего
событие: события
современный: современного
согласно: согласно
содержание: содержание
создать: создать
сообщество: сообщество
сообщить: сообщить
сохранение: сохранением
сочетать: сочетает
спасать: спасает
способный: способен
справка: справка
српски: српски
ссылка: ссылка ссылки
статистика: статистика
стать: стал
статья: статья статьи
страна: страну
страница: страницы страница страницу странице
странствовать: странствующий
существо: существо существ
существовать: существовала
сюда: сюда
сюжет: сюжету
также: также
талант: талантов
тануноко: тануноко
таро: таро
текст: текст
текущий: текущие текущая
тереть: три
тип: тип
товарный: товарном товарный
толкование: толкование
толща: толще
тот: те
требовать: требуют
тревер: тревер
увозить: увозит
уж: ужа
узник: узник
указание: указанием
упоминание: упоминания
упоминаться: упоминаются
условие: условий условия
участие: участие
участник: участниками
ф: ф
февраль: февраля
фильм: фильме фильма фильмы
фольклор: фольклор
фонд: фонд
форум: форум
фрагмент: фрагмент
хигасидэ: хигасидэ
хорх: хорхе
цитировать: цитировать
часто: часто
черта: черты
читать: читать
чтобы: чтобы
чудо: чудо
чудовище: чудовища
э: э
эквестрию: эквестрию
элемент: элемент
эльф: эльфов
энгр: энгр
энциклопедия: энциклопедия энциклопедии
это: этом это
этот: этих эта
юитиро: юитиро
язык: языках
