авад: авада
август: августа
автор: автора
авторитет: авторитетом
авторство: авторство авторства
азкабан: азкабан
азкабана: азкабана
азкабане: азкабане
активация: активации
активный: активном
альбус: альбус
амбридж: амбридж
аналогичный: аналогичном
англ: англ
антонин: антонин антонина
астрономия: астрономии
атака: атаки
барда: барда
бартемий: бартемий
бартемиуса: бартемиуса
башня: башней
беглец: беглецы
беларуская: беларуская
беллатриса: беллатриса
беллатрисой: беллатрисой
беллатрисы: беллатрисы
бесчинство: бесчинства
библия: библии
бидля: бидля
битва: битве
бледный: бледная бледной
близкие: близкие
блэк: блэк
болельщик: болельщиков
больший: больших
большинство: большинство
бороться: боролись
борьба: борьба
британия: британии
български: български
быть: будучи бывшие были
василиск: василиск
великобритания: великобританию
вернуться: вернулся
версия: версия версии
вешать: вешали
вид: вид
визенгамот: визенгамот
викиданных: викиданных
викимедиа: викимедиа
википедии: википедии
википедия: википедия
викисклад: викисклад
викискладе: викискладе
викия: викия
вино: вина
висеть: висеть
вклад: вклад
власть: власти
вновь: вновь
внутренний: внутренней
вождь: вождя
возвращение: возвращение
воздействие: воздействием
воздух: воздухе
возможно: возможно
возможность: возможностям
война: войны войне война
войти: войти
вокруг: вокруг
волан: волан
волшебник: волшебников волшебник волшебники
волшебный: волшебной волшебные волшебный
волшебство: волшебства
впадина: впадины впадине
впервые: впервые
враг: врагов враг враги
вред: вред
время: времена время
все: всему всех
вселенная: вселенная
второй: вторая второй
входить: входили
выглядеть: выглядит
выдворение: выдворение
вызывать: вызывает
вызываться: вызывается
вымыслить: вымышленные
вынудить: вынужден
вынужденно: вынужденно
выползать: выползающей выползал
выражение: выражение
высокий: выше
гарри: гарри
гермиона: гермиона
героизм: героизме
глава: главе глава
главное: главных
говорить: говорит
год: году годах годы года
годриковой: годриковой
грейнджер: грейнджер
группа: группы
дамблдор: дамблдор
дамблдора: дамблдора
дар: дары
дать: данные данное
двое: двое
де: де
девиз: девиз
действие: действия
действовать: действовать
день: дней
держать: держали
деть: дело
деятельность: деятельность
дж: дж
джоан: джоан
дилогия: дилогия
дитя: дитя
док: док
доказать: доказана
долгий: долго долгое
долорес: долорес
долохов: долохов
долохова: долохова
дом: дом домами
дополнительный: дополнительные
дополнить: дополнить
достаточно: достаточно
доступный: доступен
драко: драко
древность: древности
друг: друг друга
другой: других
дурмстранг: дурмстранг
дым: дыма
жжение: жжение
жизнь: жизнь
заглавный: заглавная
заклинание: заклинанием заклинания
заключение: заключением
заклятие: заклятия
закон: законов
закончиться: закончилась
замок: замка
запись: запись
зарегистрировать: зарегистрированный
заставить: заставил
захват: захват
зачаток: зачатки
заявление: заявление
заявлять: заявляли
зверь: звери
злодей: злодеи
знак: знак
знакомый: знаком
значение: значение
значительно: значительно
игра: игра игры
идея: идей идею
избежать: избежавшие
избранный: избранные
известный: известные
изо: изо
именно: именно
иметь: имеют
империус: империус
инициатор: инициаторами
иногда: иногда
инструмент: инструменты
информация: информация
использование: использования
использоваться: использовались
история: история
источник: источник
истребится: истребится
исчезновение: исчезновения
итог: итог
камень: камень
караться: карается
карточный: карточная
категория: категории
квартира: квартирой
квиддич: квиддич
квиддичу: квиддичу
кедавра: кедавра
книга: книг книгах книги книге
код: код
кодекс: кодекс
коллекционный: коллекционная
командующий: командующими
комната: комнате комната
конструктор: конструктор
контролировать: контролировал
контроль: контроль
конфиденциальность: конфиденциальности
кончаться: кончается
короткий: короткие короткий
который: которой которых
крауч: крауч
крауча: крауча
кровь: крови
круциатус: круциатус
крыться: кроется
кубок: кубка кубок
кук: куки
кул: кул
левый: левого левой
лестрейндж: лестрейндж
лестрейнджем: лестрейнджем
лидер: лидером лидер
ликвидировать: ликвидирована
литературный: литературные
лицензия: лицензии
лично: лично
лишение: лишениях
лишиться: лишился
лозунг: лозунг
локация: локации
лорд: лорда лорду лорд
любой: любым
люциус: люциус
люциусом: люциусом
маг: магов маги магами
магический: магическую магическая
магия: магия магии
маглов: маглов
маглы: маглы
македонский: македонски
малфоев: малфоев
малфоем: малфоем
малфой: малфой
маска: масках
массовый: массовый
материал: материал
матч: матча
мая: мая
медиафайлы: медиафайлы
место: места месте
местоположение: местоположение
метка: метке метку
меткий: метки метка
министерство: министерства министерством министерство
мир: мира миру мир мире
мировой: мирового
миссис: миссис
младший: младший
много: более много
мобильный: мобильная
могила: могиле
можно: можно
морсмордре: морсмордре
морт: морт
морта: морта
мортом: мортом
мочь: могли могут
мракоборцами: мракоборцами
мракоборцев: мракоборцев
мы: нами
мысль: мыслей
навигация: навигации навигация
над: над
название: названия
назначать: назначал
назойливый: назойливых
наказание: наказания
нанести: нанесли
наоборот: наоборот
нарцисс: нарцисса
начало: начал
начаться: началась
наш: наших
неактивный: неактивная
небо: небе
недостоверный: недостоверный
недоступный: недоступная
нежели: нежели
неимоверно: неимоверно
некоммерческий: некоммерческой
некоторые: некоторых некоторые
необходимо: необходимо
неполный: неполный
непререкаемый: непререкаемым
непростительный: непростительные
нерабочий: нерабочими
несколько: нескольких несколько
новый: новые
норрис: норрис
об: об
обитание: обитания
облако: облако
образ: образом
обращаться: обращались
обстоять: обстоит
обсуждение: обсуждение
общий: общая
объяснять: объясняет
объясняться: объясняется
обычно: обычно
огонь: огня
огромный: огромный
один: одна одного
однако: однако
окончательно: окончательно
они: ими них
опасный: опасных
операция: операциями
описание: описание
опытный: опытными
организация: организации организацию организация
орден: ордена орден
оригинал: оригиналом
основатель: основателя
основное: основном
особняк: особняк
оставлять: оставляли
остальное: остальные
ответственность: ответственности
отвечать: отвечать
отдавать: отдавал
отдельный: отдельных отдельные
отказ: отказ
отличаться: отличаться
отметина: отметина
отметка: отметка
отправляться: отправлялись
отредактировать: отредактирована
отречься: отреклись
отряд: отряд
отчаянный: отчаянная
оформить: оформить
охватить: охватившая
очень: очень
ошибка: ошибке
палочка: палочкой
паника: паника
парк: парк
пародия: пародии
первое: первого первое первых
первый: первой первая
перейти: перейти
переписать: переписать
переработка: переработки
переть: при
персонаж: персонажи
персональный: персональные
петтигрю: петтигрю
печать: печати
питер: питер
побег: побег
поведение: поведения
повсеместный: повсеместного
погибнуть: погибло
подача: подачи
подводить: подводящих
поддержка: поддержка
поделить: поделены
подпись: подпись
подробный: подробнее
пожертвовать: пожертвовать
пожизненно: пожизненно
пожизненный: пожизненным
пожиратель: пожирателями пожирателям пожирателей пожиратели
поиск: поиск поиску
пока: пока
полагать: полагал
полгода: полугода
политик: политика политике
полномочие: полномочия
полтергейст: полтергейстах
полукровка: полукровка
получить: получить
пора: пору
поражение: поражение
портал: портал
посадить: посаженные
посещение: посещения
поскольку: поскольку
последний: последний последние
посол: после
поспешность: поспешность
постоянный: постоянная
потерпеть: потерпели
поттер: поттер поттера поттере
поттеромания: поттеромания
похожий: похожим
почтить: почти
поэтому: поэтому
появиться: появились появилась
появление: появление
появляться: появляется
пояснение: пояснение
правильно: правильно
править: править
правка: правки
предмет: предметы
предплечье: предплечья
представиться: представились
предыстория: предыстория
прекратить: прекратила
преступный: преступные
приказ: приказы
прикосновение: прикосновении
применение: применение
примечание: примечания
принимать: принимал
приниматься: принимается
принц: принц
приход: прихода
причина: причин
проверить: проверенной
проверка: проверки
проверяться: проверялась
проект: проектах
проиграть: проиграли
производство: производство
проклясть: проклятое
просмотр: просмотры
пространство: пространства
против: против
прочий: прочее
путеводитель: путеводитель
пытатели: пытатели
размер: размеров
разный: разными
разработчик: разработчики
ранее: ранее
располагаться: располагается
распределять: распределяющая
рассказ: рассказы
расширить: расширивших
регулус: регулус
реддл: реддл
религиозный: религиозные
решение: решения
родитель: родителей
роман: романов
рон: рон
рот: рта
роулинг: роулинг
рубеус: рубеус
рудольфус: рудольфус
рука: руке руки
русский: русский
ряд: ряд
салазаром: салазаром
сам: самим
сантиметр: см
саундтрек: саундтрек
сведение: сведения
свежий: свежие
свекор: свекром
светлый: светлых
свободный: свободной
свое: своих свои своего своими
связанный: связанные
связаться: свяжитесь
связь: связи связь
сделать: сделали
сдержать: сдержать
сдерживать: сдерживали
северус: северус
седьмой: седьмой
семь: семи
семья: семьи
сериал: сериал
серия: серии серию серия
сзади: сзади
сила: сил
сильный: сильных
символизировать: символизирует
система: системе
сказать: сказано
сказка: сказки
скачать: скачать
скрытый: скрытые
скрыться: скрыться
слева: слева
слизерин: слизерин
слизерином: слизерином
слово: словам
слуга: слугами
служебный: служебные
служить: служит
случай: случаях
случайный: случайная
смерть: смертью смерть смерти
снегг: снегг
снова: снова
собирать: собирать
собрать: собрал
событие: события
содержание: содержание
создать: создал созданная создать
сокурсник: сокурсники
сообщество: сообщество
сообщить: сообщить
состояние: состоянии
сохранение: сохранением
союз: союзе
союзник: союзники
список: список
спора: споры
справа: справа
справка: справка
сражаться: сражавшихся
среди: среди
срочный: срочного
српски: српски
српскохрватски: српскохрватски
ссылка: ссылка ссылками ссылки
ставить: ставил ставит
становиться: становится
старший: старшего старшим
статистика: статистика
статус: статус
статуя: статуи
статья: статья статьи
страница: страницы страница страницу странице
страх: страхе
студент: студентом
суметь: сумели
существенный: существенной
существо: существа
существование: существование
сюда: сюда
тайный: тайная тайной
также: также
такой: такой такая такие
текст: текст
текущий: текущие текущая
тело: тела тело
тематический: тематический
темный: темный
тереть: три
террор: террора
течение: течение
тип: типам
товарный: товарный
тот: том тот
требовать: требует требуют
тюремный: тюремные
тюрьма: тюрьме
убедить: убедить
убийство: убийства
убийца: убийцы
убить: убитые убитых убиты
увидеть: увидев
угасать: угасает
удаться: удалось
ужас: ужас
узнавание: узнавания
узник: узник
уизли: уизли
указание: указанием
улучшение: улучшении улучшения
упоминаться: упоминается
урок: уроки
условие: условий условия
установить: установить
устроить: устроил
участие: участие
участник: участниками
факультет: факультета
фантастический: фантастические
феникс: феникса
философский: философский
фильм: фильм фильме фильмов
финал: финале
фонд: фонд
форма: формы
форум: форум
фраза: фразе
х: х
хагрид: хагрид
хобби: хобби
хогвартс: хогвартс
хогвартса: хогвартса
цель: цели
центр: центре
цитата: цитаты цитатой
цитировать: цитировать
частить: части
частность: частности
часы: часов
чей: чья
человек: человеку люди
чемпионат: чемпионат
череп: череп
число: числе
чистокровный: чистокровными
чистота: чистоты
читать: читает читать
член: члены
чувствовать: чувствуют
шаблон: шаблона
шармбатон: шармбатон
широкий: широко
школа: школу школы
шляпа: шляпа
шпион: шпионом
штаб: штаб
элемент: элемент
энциклопедия: энциклопедии
это: это этим
этот: этой эта эту
являться: является
явный: явным
язык: языках
