автор: автор
авторство: авторства
агент: агенту
азбука: азбука
азкабана: азкабана
алтеда: алтеда
алтеду: алтеду
алтеды: алтеды
алфавит: алфавиту
алый: алое
альбус: альбус
альбуса: альбуса
альбусом: альбусом
амата: амата
амате: амате
амату: амату
аматы: аматы
амстердам: амстердам
англ: англ
английский: английский английского
андрей: андрей
апрель: апреля
аромат: ароматом
арт: арт
архивировать: архивировано
аттикус: аттикус
аукцион: аукцион
аша: аши аша ашу
ба: ба
бабушка: бабушка
барда: барда
беда: бед
бедность: бедности
бежать: бежит бегущая
безнаказанный: безнаказанно
безумный: безумного
безуспешный: безуспешны
белизна: белизна
беречь: берегу
берлин: берлин
бесплодный: бесплодных
беспокоиться: беспокоиться
беспомощность: беспомощности
бессилие: бессилия
бесцельный: бесцельном
бесчестный: бесчестным
бешенство: бешенства
библиотека: библиотека
бидль: бидль
бидля: бидля
биться: бьющееся
благодать: благодать
благоразумный: благоразумно
благотворительность: благотворительности
благотворительный: благотворительной благотворительный
блестеть: блестящее
близкие: близким
близкий: близка
богатый: богатую
болезненный: болезненным
боль: боль
больной: больная
больший: больше
большинство: большинство
большой: большой
бородавка: бородавками бородавки
бородавчатый: бородавчатый
бояться: боясь
бразилиа: бразилиа
бразильский: бразильский
брат: брата братьев братьях брат брату братья
бременить: бремени
брет: брет
бригада: бригаде бригаду бригады
бровь: брови
бросать: бросает
бросаться: бросается
бросить: брошена бросить
бузина: бузины
български: български
былой: былые
быстро: быстро
быстрый: быстра
быть: будучи были
вакансия: вакансия
вальда: вальда
вальду: вальду
валяться: валявшийся
варево: варево
варить: варил
варшава: варшава
ваш: ваше
вброд: вброд
ведьма: ведьму ведьмами ведьма ведьмы
великий: величайшее
велита: велит
величество: величество
верить: верят верила
вернуть: вернуть
вернуться: вернулся
верный: верен
версия: версия
весить: весь
вести: ведет
весьма: весьма
ветка: ветку ветки
вечер: вечером
вещь: вещи
взмахнуть: взмахнув
взять: взять
вид: виде
видеть: видит видели видят видел
викиданных: викиданных
викимедиа: викимедиа
википедии: википедии
википедия: википедия
виктор: виктор
вклад: вклад
владелец: владельцем владельцев
власть: власти
влюбленность: влюбленности
влюбляться: влюбляться
вместе: вместе
вместо: вместо
внутрь: внутрь
внучек: внучки
вовсе: вовсе
вод: воду воде
воды: водах воды
возвращать: возвращать
возвращаться: возвращается
возвращение: возвращение
возглавить: возглавив
воздух: воздух
возлюбить: возлюбленным возлюбленном
возможность: возможность
возмутить: возмущена
возмущение: возмущение
войти: войти
вокруг: вокруг
волан: волан
волос: волос волосами
волосатый: волосатое
волшебник: волшебником волшебника волшебниках волшебников волшебнике волшебник волшебнику волшебники волшебниками
волшебница: волшебниц волшебницы волшебницами волшебнице
волшебный: волшебной волшебную волшебные волшебная волшебном волшебный волшебными
воля: воле
воображение: воображение
вор: вор
воскресить: воскресить
воскрешать: воскрешать воскрешающим
воспользоваться: воспользовался
воспоминание: воспоминания
воспринять: воспринял
восхититься: восхитилась
впадина: впадине
впечатлен: впечатлен
вред: вред
время: время
все: всех всего всем
вскоре: вскоре
встретить: встретил
встречать: встречают встречает
встречаться: встречаются
всякий: всякий всяких
всяческий: всяческими
второе: второму вторых
второй: вторая второй
втянуть: втянуты
входить: входят входит
выглядеть: выглядит
выглядывать: выглядывающую
вызов: вызов
вызывать: вызывающую
выйти: вышли
выкупить: выкуплена
вымыслить: вымышленные
вынести: вынести
вынудить: вынужден вынуждено
выпрыгивать: выпрыгивает
выпустить: выпущены выпущено выпущена
вырезать: вырезает
выручить: вырученные
высмеивать: высмеивает
высокий: высоко
выставить: выставлен выставлена
га: га
гарри: гарри
геллерт: геллерта
гермиона: гермиона гермионы гермионе
героизм: героизме
главное: главным
глубокий: глубока
глубоко: глубоко
глупость: глупости
глупый: глупым глупый
глядеть: глядя
говорить: говорит
год: год годы года
годриковой: годриковой
голова: голову головы
голодный: голодные голодной
голос: голос
гора: горе
гордость: гордостью
гордый: гордым
гордыня: гордыня гордыню
горевать: горевал
горло: горло
город: город
горшок: горшок
гость: гости
грейнджер: грейнджер
гриб: грибом
грин: грин
громкий: громкое
грудь: груди грудь грудью
группа: группе
д: д
давать: дает
даваться: дается
давно: давно
давным: давным
далее: далее
дальнейший: дальнейшая
дальний: дальних дальнее
дамблдор: дамблдор
дамблдора: дамблдора
дамблдором: дамблдором
дар: даров дарах дары
дата: дата
дать: дала
два: два две двух
дверь: дверь
двое: двое
двор: двор
дворец: дворцу дворец
де: де
девушка: девушки девушку девушка
действие: действия
действительно: действительно
действительность: действительности
действовать: действовать
декабрь: декабря
делиться: делятся
дело: деле
демонстрировать: демонстрирует
день: дней
деньга: деньги
деревня: деревню
дерево: дерева дерево
держать: держа
держаться: держится
детская: детской
деть: день
дж: дж
джоан: джоан
дикий: дикое
дилер: дилеры
дилогия: дилогия
директор: директора
дитя: дитя
добиться: добиться
добраться: добраться
добрый: добрый добрые
добыча: добычу
довести: доведя
довольный: доволен
догадаться: догадавшись
дойти: дойдя дойти
док: док
доказательство: доказательство
доказать: докажет
долгий: долго
должен: должна должен
должность: должность
доллар: долларов
дом: дому доме
дома: дома
домыть: домой
доноситься: доносящийся
дополнительный: дополнительные
дорога: дорогу
дорогой: дорогой
дослать: дошли
доспех: доспехах доспехи
достаточный: достаточной
достаться: досталось
достигать: достигает
достойный: достойного достоин
доступный: доступен
др: др
драко: драко
древние: древними
древность: древности
друг: друг друзей друзьям
другой: другим другие других
дурак: дурака
дурмстранг: дурмстранг
дурной: дурная
дэниел: дэниелу
европейский: европейским
едва: едва
единственный: единственному единственным
ежедневно: ежедневно
жадный: жадным жадный
жалеть: жалеет
жалость: жалость
жанр: жанр
желание: желание желании
жена: жены
женатый: женат
жениться: жениться женятся
женский: женскую
женщина: женщинах женщину женщин
жертва: жертв
жестокий: жестоким
жизнь: жизни жизнь
жила: жил
жить: жили живущих
журнал: журнал
заблуждаться: заблуждался
заверять: заверяя
завещать: завещанные завещает завещанного завещал
завидовать: завидуют
зависть: зависть
заводить: заводят
завтра: завтра
заглавный: заглавная
заглянуть: заглянув
заинтересовать: заинтересована
зайчиха: зайчиха
заклинание: заклинания
заключить: заключено
заклятие: заклятий
законный: законных
залечить: залечить
заменить: заменить
замертво: замертво
заметить: заметила
замок: замке замок
записка: записка
запись: запись
заплатить: заплатить
заполучить: заполучить заполучила
зарабатывать: зарабатывать
заработать: заработает
зарегистрировать: зарегистрированный
заставить: заставит
заставлять: заставляя заставляет заставляют
затаскивать: затаскивают
затем: затем
зато: зато
заточать: заточают
захихикать: захихикав
захлопнуть: захлопнув
захотеть: захочет
зацепиться: зацепилась
защищать: защищать
заявление: заявление
заявлять: заявляет
зверь: звери
звук: звуки
здоровье: здоровье
зелье: зелий зелье зелья
земля: землях
зло: зла
злоба: злобу
злой: злыми
злополучный: злополучный
знак: знак
знакомый: знакомому знакомые знакомых
знаменитый: знаменитые
знать: знает знать зная
значит: значит
зов: зов
золото: золото золота
золотой: золотая
зуб: зубах
зубоскал: зубоскал
ибо: ибо
иван: иван
игнотуса: игнотуса
игра: игра игры
идея: идею
избавиться: избавиться
избежать: избежать избежал
избранный: избранные
избрать: избрали
изваять: изваял
известно: известно
изгнание: изгнания
издание: издания издание изданий
издательство: издательством издательство
издать: издано
излечивать: излечивает
излечить: излечить излечив
излечиться: излечиться
излить: излить
изменить: изменить
измениться: изменился
измыслить: измыслить
изнурение: изнурения
изумление: изумлением
изуродовать: изуродованное
изучать: изучало
икабог: икабог
иллюстрация: иллюстрациями
иллюстрировать: иллюстрированы
именно: именно
иметь: имел
имя: имени
иначе: иначе
ингредиент: ингредиентов
инструктор: инструктора инструктором
инструмент: инструменты
интерес: интересом
искать: ищет искала ища
искупаться: искупаться
искусный: искусную
искусство: искусствам
исп: исп
испанский: испанский
использование: использования
использовать: использовать использующие
испытывать: испытывает
иссушать: иссушают
история: историями история
источник: источник
исцеление: исцелении
исчезать: исчезает
исчезнуть: исчезнуть
итал: итал
итальянский: итальянский
июль: июля
июнь: июня
йоркшир: йоркшире
каждый: каждой каждый каждая
казки: казки
какой: каким
камень: камень камнем камни камнями
капитан: капитан
карабканье: карабканье
карточный: карточная
категория: категории
качество: качестве
квеста: квеста
квиддич: квиддич
квиддичу: квиддичу
киев: киев
кинжал: кинжал
клясться: клянется
книга: книг книги книгу книге книга
код: код
кодекс: кодекс
кожа: кожи кожу
колдовать: колдовать
колдовство: колдовство колдовству
колдун: колдуне колдуна колдун
колдунья: колдуньи колдунье колдунья колдуний
колено: колени
коллекционный: коллекционная
комментарий: комментариями
комната: комнате комната
компания: компания
комплект: комплект
конец: концов конце
конкурент: конкурента
конструктор: конструктор
конфиденциальность: конфиденциальности
конфликт: конфликте
конь: коня
копия: копии копия
копье: копий
корень: корней
корморане: корморане
королевский: королевских королевского
королевство: королевство королевства
король: король короля королю
короткий: короткие короткий
котел: котле котла
который: которым которой которую которого которые которых которая котором который
коттедж: коттеджа
крам: крам
красивый: красивую красивым
красота: красотой
крестражах: крестражах
кристофер: кристоферу
кричать: кричит
кровь: кровь
кроме: кроме
крутой: крутой
ксенофилиус: ксенофилиус
ксенофилиуса: ксенофилиуса
кто: кого
кубок: кубки кубок
кук: куки
кукушка: кукушки
купаться: купается купаться
кусок: кусок
куст: кустах кустов
кухня: кухне
ла: ла
лаборатория: лаборатория
лавгуд: лавгуд
лавгуда: лавгуда
ларец: ларец
ласкать: ласкает
лаять: лаять
легенда: легенд
леди: леди
лежать: лежит
летаев: летаев
лечить: лечить
лживый: лживый
лиана: лианы
ликовать: ликуя
линия: линия
литература: литература
литературный: литературные литературному
литтлу: литтлу
лицензия: лицензии
личной: личным
лишение: лишениях
лишить: лишен
лишь: лишь
локация: локации
лондон: лондон
лондонский: лондонские
любить: любимая любимой
любовь: любовь
любой: любого
ма: ма
магический: магической магических магическими
магия: магия магию магии
маглы: маглы
мадрид: мадрид
майя: май
макгонагалл: макгонагалл
маленький: маленькую маленьким
малкович: малкович
малфой: малфой
мантия: мантией мантию мантии
марта: марта
мастерство: мастерством
материал: материал
махаон: махаон
мая: мая
мгновение: мгновение
медальон: медальоне
менее: менее
менестрель: менестрелей
мерзкий: мерзкая
мертвый: мертвую
место: место места
месяц: месяц месяца
метод: методах
мечта: мечты
миллион: миллионов млн
минервы: минервы
министерство: министерство
министр: министра
мир: мира мир мире
миссис: миссис
младенчество: младенчестве
младший: младшему младший
мнение: мнению мнение
многие: многих
много: много
мобильный: мобильная
могила: могиле могила
могущественный: могущественную
мой: мой
молодая: молодая молодой
момент: момент
морт: морт
москва: москва
мост: мост
мохнатый: мохнатое
мочь: мог могут
мощный: мощное
мужчина: мужчина мужчину
мы: нами
наблюдать: наблюдает
навигация: навигации навигация
навсегда: навсегда
награда: награды
над: над
надеяться: надеется надеюсь
название: названия название
назойливый: назойливых
найти: найдя нашла найти
наконец: наконец
наложение: наложения
наложить: наложили
намерение: намерении намерения
намного: намного
нанять: нанять
напасти: напасти
напасть: напасть
написание: написания
написать: написанная написаны написана
напоминать: напоминать
направить: направив
направлять: направляет
напротив: напротив
настолько: настолько
настоящий: настоящую настоящая
научиться: научиться
находить: находят находит
начинать: начинают начинает
наш: наших наш
небрежность: небрежности
невидимка: невидимки невидимкой
невозможный: невозможное
невозмутимость: невозмутимость
недоверчивый: недоверчивый
недостаточно: недостаточно
недостоверный: недостоверный
недоумевать: недоумевало
незадачливый: незадачливому незадачливый
некоммерческий: некоммерческой
нельзя: нельзя
немецкий: немецкий
немногие: немногие
немой: нем
неожиданно: неожиданно
неопр: неопр
неполный: неполный
неприязнь: неприязнь
несколько: нескольких несколько
нести: несли неся
неуверенность: неуверенность
неудачник: неудачнику
нидерл: нидерл
нидерландский: нидерландский
никакой: никакие никаких никакая
никогда: никогда
новый: новые новых новому
нога: ногах нога ногам ноге
номер: номером
норрис: норрис
ночь: ночь
ноябрь: ноября
нужда: нужды
нужный: нужны
об: об
обвиваться: обвиваются
обезглавить: обезглавили
обезопасить: обезопасить
обещать: обещает
обжиться: обжился
обзаводиться: обзаводится
обидеть: обиженный
обитание: обитания
обладать: обладает
облизывать: облизывает
обложка: обложка
обман: обманом
обнаруживать: обнаруживает обнаруживают
обнимать: обнимает
обокрасть: обокрал
образ: образом
обратный: обратно
обращаться: обращались
обращение: обращения
обстоятельство: обстоятельств
обсуждать: обсуждает
обсуждение: обсуждение
объявлять: объявляет
обыскивать: обыскивать
обычный: обычный
огонь: огня
огромный: огромной
одежда: одежде
один: одну одной одна одного один одному
одиннадцать: одиннадцать
одиночество: одиночеству
однажды: однажды
однако: однако
одновременно: одновременно
оживить: оживить
ожидаться: ожидалось
оказываться: оказываются оказывается
окно: окна окно
около: около
окровавить: окровавленной
окружать: окружающих
он: нему
они: им них
оно: оно
опасный: опасных
описание: описание
опубликовать: опубликовать опубликовал
опустошать: опустошают
организация: организации
орден: орден
оригинал: оригинала оригиналом
освободить: освободит
осел: осла
оскорбить: оскорбил
ослепнуть: ослепшее
ослинные: ослинные
основной: основная
особенно: особенно
осознавать: осознает
оставаться: оставаться
оставить: оставил оставить оставленная
оставлять: оставляя
остаться: останется остаться остался
острый: острую
отважный: отважная
отвернуться: отвернулся
отверстие: отверстия
ответственность: ответственности
отвыкнуть: отвыкшее
отговориться: отговориться
отдать: отдать отдал
отдельный: отдельных отдельные
отец: отца отцом
отказ: отказ
отказаться: отказаться
отказываться: отказывается
откликнуться: откликнуться
отломить: отломила
отныне: отныне
отправить: отправить
отправиться: отправиться
отправляться: отправляются
отравиться: отравившегося
отрасти: отросла
отредактировать: отредактирована
отрезать: отрезать отрезает
отряд: отряд
отступить: отступить
отчаяние: отчаяния отчаянии
отчужденность: отчужденность
официальный: официальный
охотиться: охотятся
охотник: охотники
охотников: охотников
очень: очень
ошибка: ошибке
ощущать: ощущает
ощущение: ощущения
падать: падает
палочка: палочку палочка палочками палочки палочкой
париж: париж
парк: парк
пародия: пародии
певерелла: певерелла
пенить: пень
пень: пня пне
первое: первого первое первому первых первые
первый: первой первая
перевезти: перевез
перевод: перевод
переводчик: переводчик
перед: перед
передать: передать
переиздать: переиздала
перейти: перейти
переловить: переловить
переплести: переплетены
переплыть: переплыть
перерезать: перерезал
пересказ: пересказ
переть: при
персонаж: персонажи
персональный: персональные
пес: псов пса
песнь: песни
пестрый: пестрая
печальный: печальна
печать: печати
пир: пиру пир
писательница: писательницы
письмо: письме письма
плод: плодом
победа: победой
победить: победил победить
поведение: поведения
поверить: поверив поверит поверить
повернуть: повернул
повеситься: повесился
повествование: повествования
поворачиваться: поворачивается
подарить: подарила
подарок: подарки
подбадривать: подбадривающей
подвал: подвал
подготовить: подготовлен
поддать: подданными
подземелье: подземелье
подле: подле
поднимать: поднимает
поднять: подняла
подняться: подняться
подобный: подобную
подозревать: подозревала подозревая
подробный: подробнее
подходить: подходит подходящая
подчиниться: подчиниться
поединок: поединке
пожертвовать: пожертвовать пожертвованы
пожиратель: пожиратели
позволить: позволено
позволять: позволяя позволяет
поиск: поиск поиску
пока: пока
показать: показав
показаться: показался
показывать: показывает
покидать: покидает покидать
поклонник: поклонников поклонниками
покрыться: покрылся покрывшегося
покупатель: покупателями
пол: полу пол
полагать: полагая
политик: политика политике
полностью: полностью
полный: полному
полтергейст: полтергейстах
полудрагоценными: полудрагоценными
полукровка: полукровка
получать: получает получают
получить: получила полученное получить
польский: польский
полюбить: полюбить
поместить: поместил
помещать: помещает
помогать: помогают помогал помогает помогать
помочь: поможет помочь
помощь: помощью помощи
понадобиться: понадобится
понимать: понимает
понять: поняв
пополам: пополам
поправить: поправить
попросить: попросил
попытаться: попытается попытаться
попытка: попытками попытки попытке попыток
портал: портал
посетить: посетить
поскольку: поскольку
поскуливанием: поскуливанием
последний: последний последних
посмеяться: посмеялись
посмотреть: посмотреть
посол: после
поставить: поставил поставить
постепенно: постепенно
постичь: постигший
постоялый: постоялый
постоянно: постоянно
постоянный: постоянная
поступать: поступают
посылать: посылают
пот: пот
потерять: потерял
поттер: поттер поттера поттеру поттере
почему: почему
почта: почта
почувствовать: почувствует
пощада: пощады
появиться: появились появился
появляться: появляются появляется
править: править
правка: правки
правый: права
практиковать: практикуют
прачка: прачка
превосходить: превосходит
превратиться: превратилась превратится
предел: пределов
предлагать: предлагает
предложить: предложила
предмет: предметах предметы предмет
представиться: представились
представлять: представлявшие
предъявлять: предъявляет
предыдущий: предыдущее
предыстория: предыстория
прежний: прежнему
прекрасно: прекрасно
препятствие: препятствие препятствия
препятствовать: препятствует
преследовать: преследовать преследовал
преспокойно: преспокойно
пресс: пресс
прибегнуть: прибегнул
привлечь: привлекла
приводиться: приводится
привозить: привозить
приглашение: приглашение
придворный: придворные придворными
придумать: придуманных
признать: признает
прийти: пришла придя пришедших
прийтись: пришлось придется
приказ: приказ
приложить: приложат
применить: применил
примечание: примечания примечание
принимать: принимает
приниматься: принимаются
принц: принц
присоединиться: присоединиться
пристыдить: пристыженный
присущий: присущим
приходить: приходить приходит
причинить: причинит
пробираться: пробираются
проблема: проблем проблемы проблемами
пробраться: пробрался
провести: провели
проводить: проводят
прогонять: прогоняет
продажа: продажи
продать: продана
проделать: проделать
продемонстрировать: продемонстрировали
продолжатель: продолжатели
проект: проектах
произведение: произведения
производство: производство
происходить: происходит
пройти: пройти прошло
проклясть: проклятое
проклятие: проклятие
пронзить: пронзено
проникнуть: проникнуть
пропадать: пропадают
пропасть: пропал
просить: просит
просмотр: просмотры
проснуться: проснулась
просто: просто
простой: простых
пространство: пространства
противоядие: противоядия
профессор: профессора
проход: прохода проход
прочий: прочее
прошлый: прошлого
прощание: прощание
проявлять: проявлять
прыгать: прыгающий
прыгливый: прыгливый
прыгнуть: прыгнуть
прямой: прямо
прятаться: прятаться прячутся прячущуюся прятался
публикация: публикации
путеводитель: путеводитель
путешествие: путешествие
путешествовать: путешествовали
путь: путь пути
пытаться: пытаются пытается пытаясь
пять: пять пяти
раб: рабом
равнодушный: равнодушным
радоваться: радуясь
раз: раза
раздать: розданы
разоблачить: разоблачит
разобраться: разобраться
разработчик: разработчики
разрубить: разрубив разрубить
ранний: раньше
распекать: распекает
распределять: распределяющая
рассвет: рассвете
рассекать: рассекает
рассказ: рассказы
рассказов: рассказов
рассказывать: рассказывает рассказывают
расстроить: расстроены
расти: растущей
расширение: расширение
рвота: рвотой
реальный: реальная
ребенок: детей детям
река: реку реки
религиозный: религиозные
решать: решают решает
решение: решение решению
решить: решил решить решила
ржавый: ржавых
рим: рим
родитель: родителей родители
родные: родных
рождественский: рождественский
ролинг: ролинг
роль: роль
роман: романов романы
рон: рону рона рон
росмэн: росмэн
россия: россии
роулинг: роулинг
рубеус: рубеус
рубин: рубины
рубить: рубят
рука: руке рук руки
рукопись: рукопись рукописи
рунический: рунического
руно: рунами руну
русский: русский
русскоязычный: русскоязычных
русый: рус
руфуса: руфуса
рыться: рыться
рыцарь: рыцарем рыцарь рыцаря
рэдклиффу: рэдклиффу
сага: саги
сад: сада сад
сайт: сайте сайт сайтом
сам: самой самом самому сама само
самый: самую
сантиметр: см
саундтрек: саундтрек
сборник: сборник сборники сборнике
сведение: сведения
свежий: свежие
света: свете
свидетельство: свидетельства
свирепый: свирепых
свободный: свободной
свое: своих свои своему свое своего своим своими своем
свой: своей свою
свора: сворой
связанный: связанные
связаться: свяжитесь
связь: связи
сдать: сдаст
сделать: сделать сделала
северус: северус
седьмой: седьмая седьмой
секрет: секретов
семь: семь
семья: семья
сентябрь: сентября
сердце: сердцу сердце сердца
серебро: серебром
серебряный: серебряные
середина: середине середины
сериал: сериал
серия: серией серию серия
сидеть: сидящей
сила: силу силой сила силах сил силы
символ: символ
система: системе
сказать: сказали сказал сказала
сказка: сказка сказок сказки сказку сказкой
скачать: скачать
склон: склону склон
скримджера: скримджера
скромный: скромным
скрытый: скрытые
скрыть: скрыла
скрючиться: скрючившегося
скульптор: скульптора
слабость: слабость
следующий: следующим следующий следующее следующих
слеза: слезами
слезинка: слезинка
словно: словно
слово: слов словам
слуга: слуг
служба: службе
служебный: служебные
случай: случаях
случайный: случайная
слышать: слышали слышат слышит
смелость: смелость
смертельный: смертельная
смерть: смертью смерть смерти
смех: смех
смешивать: смешивает
смеяться: смеяться
смотреть: смотрят
смочь: смогла сможет смог
смыть: смыла
сначала: сначала
снегг: снегг
снова: снова
собачий: собачьим
собираться: собираются
собраться: собравшись собравшиеся
собственный: собственной
событие: события
совершать: совершать совершают
совершенно: совершенно
совиный: совиная
согласие: согласию
соглашаться: соглашается
содержание: содержание
сожаление: сожаление
создать: создать
сойти: сошел
сокровище: сокровище
сомнение: сомнение
сообщество: сообщество
сообщить: сообщить
соперник: соперника
сосед: соседей соседям
составлять: составляет
состариться: состарился
состояние: состоянию
сотбис: сотбис
сохранение: сохранением
сохранить: сохранив
сочинить: сочинил
специальный: специальное
список: список
сплетничать: сплетничают
спора: споры
спорный: спорные
способность: способностью способностей способностями
способный: способен
справка: справка
спрос: спрос
спрятать: спрятав
спрятаться: спрятавшаяся спрятаться
спустя: спустя
сразу: сразу
средний: среднего средний
средство: средства средств
српски: српски
срубить: срубить
ссылка: ссылка ссылки
старание: старания
старое: старого старые
стартовый: стартовой
старший: старшему старший
старый: старая старую
статистика: статистика
статуя: статуя статую
стать: стал ставшее став стали
статья: статья статьи
стен: стену стене
стерлинг: стерлингов
стечение: стечению
стирать: стирает
стоить: стоит
стол: столом
стон: стоны
стопа: стопы
страдание: страдания
страйке: страйке
страна: странах стране
страница: страницы страница страницу страниц странице
странный: странные странную странно странный
страх: страхи
строиться: строится
стук: стук
сумерки: сумерках
существо: существа
существовать: существуют
сцена: сцены
счастливый: счастливым счастливому
считать: считает
считаться: считается
сын: сын сыну
сэр: сэру сэр
сюда: сюда
сюжет: сюжет
сюжетный: сюжетная
т: т
таз: тазу
тайный: тайная
также: также
такой: такую такой таким
талантливый: талантливую
тапка: тапок
твердый: тверд
твой: твоих твоего
текст: текст
текущий: текущие
тело: тела тело
тем: тем
тематический: тематический
темный: темным
тереть: три
течение: течение
тираж: тираж
товар: товары
товарищ: товарищи
товарный: товарный
токио: токио
толпа: толпа
тоска: тоски
тот: том ту тот тому та
точно: точно
требовать: требует требуют
требоваться: требуется
третий: третья
третье: третьем третьего
трещина: трещина
три: трех
трое: трое
троица: троица
труд: трудов
труп: труп
ты: тебе
тысяча: тыс
убежище: убежище
убить: убить
уверить: уверенный уверен
увидеть: увидел увидели увидеть
угрожать: угрожает
удалить: удалить
удар: удар
удаться: удалось
удача: удаче
удивить: удивленный
ужас: ужас
узнать: узнает
узник: узник
уизли: уизли
указание: указанием
указать: указан
укр: укр
украинский: украинский
украсить: украшены
украсть: украл
улыбаться: улыбается улыбаясь
ум: ума умом уме
умереть: умереть умер умерли
умерший: умерших
уметь: умеющий
умный: умным
умолять: умоляет
упиваться: упивается
упоминание: упоминание
упоминаться: упоминаются
урок: уроки
усиленный: усиленную
усилие: усилия
услать: ушли
условие: условий условия
услышать: услышал
усохнуть: усохшего
успокаиваться: успокаивается
устоять: устоять
утро: утром утро
участие: участие
фантастика: фантастики фантастика
фантастический: фантастические
феерический: феерическую
феникс: феникса
фея: феи
философский: философский
фильм: фильм фильмов
фокус: фокусов фокусами
фонд: фонд
фонтан: фонтане фонтана фонтану фонтан
фортуна: фортуны фортуну
форум: форум
фотокопия: фотокопии
фр: фр
французский: французский
фунт: фунтов
фэнтези: фэнтези
хагрид: хагрид
хвастаться: хвастаться
хватать: хватает
хвататься: хватается
хворь: хворью хворь
хитроумие: хитроумии
хитрый: хитрый
хихиканье: хихиканье
хобби: хобби
хогвартс: хогвартс
хогвартса: хогвартса
хозяин: хозяин хозяина
холодный: холодна
хороший: лучше лучшую
хотеть: хочет хотел
хохотать: хохочущую
храбрость: храбрости
хрустальный: хрустальный
целитель: целитель
цель: целью
цена: ценой
цикл: цикл
цитировать: цитировать
чар: чар
чародей: чародея чародей
частить: части
часы: часов
человек: людей люди людям
чемпионат: чемпионат
червь: червя
через: через
чернильный: чернильно
четверка: четверка четверке
число: числе
чистить: чистящей
читательский: читательские
читать: читать читают
чтобы: чтобы
чувство: чувств
чувствовать: чувствует чувствовать
чудесный: чудесному
чудо: чудо чуда чудеса
шаблон: шаблона
шанс: шансом
шарлатан: шарлатана шарлатан
шармбатон: шармбатон
шедевр: шедевры
шелкопряд: шелкопряд
шесть: шесть
шляпа: шляпа
шляпка: шляпку
шутиха: шутиха шутиху шутихи
экз: экз
экземпляр: экземпляр экземпляров
элемент: элемент
эмблема: эмблемой
энциклопедия: энциклопедии
это: это
этот: этой эта эту
юный: юная
яблоневый: яблоневое
яблоня: яблоню
ядовитый: ядовитым
язык: язык языках
якоб: якобы
январь: января
яп: яп
японский: японский
ярость: ярости ярость
яство: яствами
