авторство: авторства
алфавит: алфавиту
алхимия: алхимии
апрель: апреля
артефакт: артефакты
археолог: археологами
архивировать: архивировано
архивный: архивная
атрибут: атрибута
б: б
барабанный: барабанной
белый: белая
блестеть: блестящий
бог: богов
борис: борисом
брат: братьев
будур: будур
быть: были
важный: важную
величина: величиной
вероятно: вероятно
версия: версия
вид: виде
викиданных: викиданных
викимедиа: викимедиа
википедии: википедии
википедия: википедия
викисклад: викисклад
викискладе: викискладе
викицитатник: викицитатник
викицитатнике: викицитатнике
викке: викке
вклад: вклад
власть: власть
вне: вне
войти: войти
вокруг: вокруг
волшебник: волшебники
волшебный: волшебной волшебные волшебных волшебного волшебная волшебными
волшебство: волшебством
впоследствии: впоследствии
все: всему
всевозможный: всевозможных
выступление: выступлениях
гарри: гарри
герой: героя
гипотеза: гипотезы
гл: гл
главное: главного
глагол: глагола
год: года
город: городе
дата: дата
дать: данный данного
действие: действия
действовать: действовать
декабрь: декабря
дерево: дерева
деревянный: деревянными
держать: держащие
джоан: джоан
диаметр: диаметром
длина: длиной
довольный: довольно
дополнительный: дополнительные
дополнить: дополнить дополнив дополните
доступный: доступен
драгоценный: драгоценным
древние: древние
древний: древнейших
другой: других
жезл: жезлах жезлы жезл жезлов жезла
живой: живых живого
жрец: жрецы
заглавный: заглавная
заготовка: заготовка
заклинание: заклинания заклинание
закон: закон
запись: запись
зарегистрировать: зарегистрированный
затем: затем
зачастую: зачастую
заявление: заявление
земля: землей
знак: знак
знание: знания
значение: значением
играть: играя
избранный: избранные
известный: известен
изображать: изображали
изобразить: изображены
иллюзионист: иллюзионисты
именоваться: именуется
иметь: имели
индоевропейский: индоевропейские
иногда: иногда
инструмент: инструменты
интервью: интервью
искусство: искусство
использование: использование использования
использовать: использующие использовали используют
использоваться: используются используется
история: история
источник: источник
камень: камнем камень
касаться: касается
категория: категории
качество: качества качестве
квантовый: квантовый квантовой
клайв: клайва
книга: книге
код: код
кодекс: кодекс
колдовать: колдуют
колдунья: колдунья
конец: конце
конструкция: конструкцией
конфиденциальность: конфиденциальности
копия: копия
копье: копья
короткий: короткий
который: которых который
кристалл: кристаллом кристаллов
кук: куки
культ: культом
культура: культуре
курс: курс
левый: лев
легенда: легендах
лексика: лексике
либо: либо
литература: литература литературе
лицензия: лицензии
лозоходство: лозоходство
ломоносов: ломоносова
льюис: льюиса
м: м
маг: магов
магический: магические магический
магия: магии магией
македонский: македонски
марта: марта
массовый: массовой
материал: материал
мая: мая
медиафайлы: медиафайлы
миллиметр: мм
мнение: мнению
многие: многие многих
мобильный: мобильная
мочь: могут
мы: нами
н: н
навигация: навигации навигация
найти: найдены
например: например
народ: народов народы
народный: народных
наскальный: наскальные
начинаться: начинается
невидимка: невидимка
недостаток: недостатков
незнайка: незнайка
некоммерческий: некоммерческой
немецкий: немецкого
неологизм: неологизм
неопр: неопр
неотъемлемый: неотъемлемым
неоязыческих: неоязыческих
николай: николая
новый: новые
носов: носова
нужно: нужно
об: об
образ: образа образ
образец: образца
образованный: образованный
обращение: обращения
обряд: обрядов
обсуждение: обсуждение
общение: общения
общий: общ
обычно: обычно
один: один
олма: олма
они: них
описание: описание
описываться: описывается
организация: организации
освоить: освоили
основательный: основательного
особый: особого
ответственность: ответственности
отдельный: отдельных
отказ: отказ
отражение: отражение
отредактировать: отредактирована
оформить: оформленная
ошибка: ошибке
палец: палец
палка: палки палке палка
палочка: палочка палочками палочки
первоначальный: первоначальное
передаваться: передавались
перейти: перейти
переноситься: переносилась
переть: прут
персонаж: персонажа персонажей
персональный: персональные
печать: печати
платяной: платяной
плодородие: плодородия
пнвс: пнвс
поведение: поведения
повестить: повести
подобие: подобия
подобный: подобными
подробный: подробнее
пожалуйста: пожалуйста
пожертвовать: пожертвовать
поиск: поиск поиску
политик: политика
получить: получить
помочь: помогите
помощь: помощью
понедельник: понедельник
последний: последний
постоянный: постоянная
поттер: поттера
править: правило править
правка: правки
превращать: превращает
предмет: предметы предметами
представиться: представились
пресс: пресс
примечание: примечания
про: про
проведение: проведения
программист: программист
продолговатый: продолговатый
проект: проектах
произведение: произведениях
происхождение: происхождении
проппа: проппа
просвещать: просвещает
просмотр: просмотры
пространство: пространства
прочий: прочие
прутик: прутик
прямая: прямая
раздел: разделами
раздеть: раздел
различный: различными различные различных
разработчик: разработчики
растение: растениями
редакция: ред
результат: результате
реквизит: реквизита
религия: религий
рисунок: рисунки
ритуал: ритуалов
родственный: родственных
роль: роль
роман: романов
роулинг: роулинг
рука: руках
русский: русский
ряд: ряда ряде
сантиметр: см
сведение: сведения
свежий: свежие
свободный: свободной
свое: своих
связанный: связанные
связаться: свяжитесь
связываться: связываются
связь: связи связь
серия: серии
сила: сила
символ: символ
символизировать: символизирующими
система: системе
сказание: сказания
сказка: сказках сказок
сказочный: сказочная сказочной
скачать: скачать
скипетр: скипетра
скрытый: скрытые
слово: словам
словосочетание: словосочетания
сложный: сложное
служебный: служебные
случай: случаях
случайный: случайная
сначала: сначала
событие: события
совершать: совершает
совершение: совершения
современный: современных современной
содержание: содержание
создать: создать
создаться: создалась
солнечный: солнечном
сообщество: сообщество
сообщить: сообщить
сохранение: сохранением
справка: справка
срезаться: срезалась
ссылка: ссылка ссылками ссылки
статистика: статистика
статья: статья статьи
страница: страницы страница страницу странице
строиться: строится
стругацкий: стругацкого стругацких стругацким
суббота: субботу
существо: существ
существовать: существуют
считаться: считалось
сюда: сюда
сюжет: сюжет
сюжетный: сюжетную
также: также
творить: творит
текст: текст
текущий: текущие
товарный: товарный
тонкий: тонкое тонкая
трансгрессивный: трансгрессивные
требовать: требует
труд: труда
указание: указанием
указательный: указательный
указать: указан
улучшить: улучшите
умклайдет: умклайдет
умклайдетом: умклайдетом
управление: управления
управлять: управлять
условие: условий условия
участие: участие
фаллос: фаллоса
фантастический: фантастических
февраль: февраля
фигура: фигуры
фокусник: фокусника
фонд: фонд
форум: форум
фэнтези: фэнтези
фэнтезийных: фэнтезийных
ход: ходе
целый: целого
цилиндрик: цилиндрик
цирковой: цирковые
цитата: цитаты
цитировать: цитировать
часто: часто
часть: часть
человек: человека
читать: читать
шаблон: шаблонами
шаман: шаманами
шапка: шапка
широкий: широкое
шкаф: шкаф
электронный: электронного
элемент: элемент элементом
энциклопедия: энциклопедия энциклопедии
это: это
этот: эта
юникоде: юникоде
являться: является
язык: язык языках
