август: августа
австралия: австралия
автор: автор
авторство: авторства
азад: азад
азкабана: азкабана
айнесон: айнесон
актер: актеры
активно: активно
актриса: актриса
алан: алан
александр: александр
алексей: алексей
алекто: алекто
алфавит: алфавиту
альбус: альбус
альбуса: альбуса
альфред: альфред
амикус: амикус
аналитический: аналитическое
англ: англ
английский: английский английское
андрей: андрей
анна: анна
апрель: апреля
арабский: арабские
аргентина: аргентина
аргус: аргус
арестованный: арестованного
артур: артур
архив: архив
архивировать: архивировано
архивный: архивная архивной
астрономический: астрономической
атака: атаку
афшан: афшан
б: б
бакина: бакина
балабан: балабанов
баран: баранов
барда: барда
баррон: баррон
башня: башню башне башни
безрезультатно: безрезультатно
беларуская: беларуская
белла: белл
беллатриса: беллатриса
беллатрисой: беллатрисой
белоруссия: белоруссия
бельгия: бельгия
беспрекословно: беспрекословно
библиографический: библиографических
бидля: бидля
бирн: бирн
блейз: блейз
близиться: близится
болгария: болгария
боль: боли
больничный: больничное
больший: большая
большой: большой
бонни: бонни
бонэм: бонэм
борзунов: борзунов
бразилия: бразилия
брать: берут
браун: браун
бродбент: бродбент
брэдли: брэдли
брюно: брюно
будущее: будущем
български: български
быстров: быстров
бюджет: бюджет
вальда: вальда
василий: василий
вдовин: вдовина
вейн: вейн
великобритания: великобритания
велимир: велимир
венгрия: венгрия
вернуться: вернулся
версия: версия версии
викиданных: викиданных
викимедиа: викимедиа
викиновости: викиновости
википедии: википедии
википедия: википедия
викисклад: викисклад
викискладе: викискладе
викицитатник: викицитатник
викицитатнике: викицитатнике
виленкин: виленкин
винсент: винсент
вклад: вклад
власть: власти
вложить: вложил
влюбиться: влюбился
вместе: вместе
вместо: вместо
внешний: внешние
вовремя: вовремя
возвращаться: возвращается возвращаться
возвращение: возвращение возвращения
войти: вошли войти
волан: волан
волшебник: волшебников
волшебный: волшебные волшебный
воспоминание: воспоминание воспоминания воспоминании
время: временем время
врываться: врывается
все: всех
всеять: всей
вскоре: вскоре
встречаться: встречается встречаться
второе: второго вторых
выбирать: выбираем
выведать: выведал
выговаривать: выговаривает
вынудить: вынужден
выпивать: выпивает
выпить: выпив выпил
выполнение: выполнения
выполнять: выполняет
выпустить: выпущен
выручать: выручай
выход: выход выхода
вячеслав: вячеслав
галлахер: галлахер
гарантировать: гарантируют
гарри: гарри
гексиквелы: гексиквелы
германий: германия
гермиона: гермиона гермионы
героизм: героизме
герой: героев
глава: главе
главное: главных
говорить: говорит
год: лет год годы года
гойл: гойл
голос: голосом голос
гораций: горация гораций
гость: гости
грегори: грегори
грейнджер: грейнджер
грин: грин
гринт: гринт
гэмбон: гэмбон
д: д
дальвина: дальвин
дамблдор: дамблдор
дамблдора: дамблдора
данилов: данилов
дания: дания
дар: дары
дата: дата
дать: данным
де: де
девон: девон
дейв: дейв
действовать: действовать
декабрь: декабря
делать: делать
дельбоннель: дельбоннель
демонстрировать: демонстрирует
денис: денис
день: дней
деть: день
дж: дж
джейми: джейми
джеймс: джеймс
джемма: джемма
джеральдин: джеральдин
джесси: джесси
джим: джим
джинни: джинни
джоан: джоан
джонс: джонс
джордж: джордж
джорджина: джорджина
джошуа: джошуа
джули: джули
диллэйн: диллэйн
дилогия: дилогия
дин: дином
дина: дин
директор: директора
дистрибьютор: дистрибьютор
дитя: дитя
длительность: длительность
добыть: добыть
док: док
долгий: долгое
долгопупс: долгопупс
должность: должность
доллар: долларов
дополнительный: дополнительные
дорогой: дороги
доступный: доступен
дотронуться: дотронулась
драко: драко
дракон: драконах
драма: драма
древность: древности
друг: друга
другой: другие других
дубай: дубай
дубляж: дубляже дубляж
дурак: дурака
дурмстранг: дурмстранг
душ: души
дуэль: дуэль
дэвид: дэвида дэвид
дэвис: дэвис
дэниел: дэниел
египет: египет
жанр: жанры
железнодорожный: железнодорожной
жертва: жертвой
жизнь: жизнь
жить: живут
забини: забини
забирать: забирают
заглавный: заглавная
задание: задание задании задания
заменить: заменить
заметка: заметками
занять: занял
запись: запись
зарегистрировать: зарегистрированный
затем: затем
защита: защиты
заявление: заявление
зверь: звери
зелье: зелий зелье
зельеварение: зельеварение
зельеварению: зельеварению
зельеваренью: зельеваренью
злодеяние: злодеяние
знак: знак
знакомый: знакомый
значение: значения
иванов: иванова
иващенко: иващенко
игра: игра игры
идеальный: идеальные
идти: идут
избранный: избранные
издание: издание
ильин: ильина
имя: имя
индий: индия
индонезия: индонезия
инструмент: инструменты
инферналы: инферналы
информационный: информационно
искать: ищет
искусство: искусств
испания: испания
исписать: исписан
использование: использования
исправление: исправлениями
испугаться: испугался
истец: истец
история: история
источник: источник
исчезательный: исчезательный
италия: италия
итог: итоге
июль: июля
июнь: июня
йейтс: йейтс
йейтса: йейтса
йорк: йорк
кабинет: кабинете
каждый: каждый
казанцев: казанцев
камень: камень камня
канада: канада
картер: картер
карточный: карточная
касаться: касающиеся касается
касса: кассу
кассовый: кассовые кассовых
каталог: каталог каталогах
категория: категории
каф: кафе
квиддич: квиддич
квиддичу: квиддичу
кейв: кейв
кинокомпания: кинокомпания
кинокритик: кинокритиков
кинотеатр: кинотеатрах
кипр: кипр
кловис: кловис
книга: книги
код: код
кодекс: кодекс
коллекционный: коллекционная
колтрейн: колтрейн
комлевый: комлев
комната: комнате комната
композитор: композитор композитором
комсомольский: комсомольской
конструктор: конструктор
конфиденциальность: конфиденциальности
копия: копии копия
кордис: кордис
кормак: кормак
короткий: короткие короткий
косой: косой
костричкин: костричкин
который: которое которой которого которые которых который
крестраж: крестраж
крестражах: крестражах
крестражей: крестражей
крестражем: крестражем
крестражи: крестражи
критик: критиков
крыть: крыло
крэбб: крэбб
крэйг: крэйг
кубок: кубок
кук: куки
кыргызча: кыргызча
кэрроу: кэрроу
кэти: кэти
лаванда: лавандой лаванда лаванды
лавгуд: лавгуд
лариса: лариса
латвия: латвия
легенда: легенда
леджено: леджено
леонидас: леонидас
лестрейндж: лестрейндж
лили: лили
лина: лина
линч: линч
литва: литва
лицензия: лицензии
лишать: лишает
лишение: лишениях
локация: локации
лондон: лондоне лондон
лорд: лорда
луи: луи
льюис: льюис
льюнг: льюнг
людмила: людмила
люпин: люпин
магия: магия магии
маглов: маглов
маглы: маглы
майкл: майкл
макгонагалл: макгонагалл
македонский: македонски
маккрори: маккрори
маклагген: маклагген
малфой: малфой
малфоя: малфоя
марволо: марволо
мария: мария
марк: марк
марта: марта
материал: материал
мая: мая
мегакритик: мегакритик
медальон: медальон
медиафайлы: медиафайлы
мексика: мексика
место: место места
мечтать: мечтал
миллион: млн
мина: мин
минерва: минерва
министерство: министерство
мир: мира мир
мировой: мировые мировую
миссис: миссис
михаил: михаил
мобильный: мобильная
можно: можно
молли: молли
монгол: монгол
морт: морт
морта: морта
мост: мост
мочь: могут
мракоборцем: мракоборцем
музыка: музыку музыка
мы: нами
мэгги: мэгги
мэттью: мэттью
мюррей: мюррей
наблюдать: наблюдать
навигация: навигации навигация
надеяться: надеялись
название: название
назойливый: назойливых
накаляться: накаляются
написать: написал написана
направляться: направляются
нарцисс: нарциссе нарцисса
наталия: наталия
находить: находит
находиться: находится
начинать: начинает
наш: наших
невилл: невилл
недостоверный: недостоверный
недоступный: недоступные недоступная
незадолго: незадолго
некипелова: некипелова
некоммерческий: некоммерческой
немалый: немалой
немецкоговорящая: немецкоговорящая
необходимый: необходимы
неопр: неопр
неполный: неполный
непреложный: непреложный
неприятный: неприятного
непростой: непростое
несколько: несколько
несмотря: несмотря
несопротивляющийся: несопротивляющегося
нидерланды: нидерланды
николай: николай
николас: николасом николас
нимфадора: нимфадора
новость: новости
новый: новые
норрис: норрис
ноябрь: ноября
нью: нью
об: об
обет: обет
обитание: обитания
обитать: обитают
обнаруживать: обнаруживать обнаруживает
оборотень: оборотнях
обращение: обращения
обсуждение: обсуждение
общий: общая
огонь: огня
один: одно
однако: однако
ожерелье: ожерелья
ожидать: ожидают
озвучивать: озвучивал
озвучить: озвучившие
озеро: озеро
оказаться: оказался
оказываться: оказывается
оливер: оливер
омут: омуте
они: ними
оно: оно
опасный: опасных
оператор: оператор
описание: описание
оплакивать: оплакивают
опуститься: опустился
организация: организации
орден: ордена орден
основа: основе
оставить: оставил
оставлять: оставляют
ответственность: ответственности
отдельный: отдельных отдельные
отец: отца
отзыв: отзывы
отказ: отказ
открывать: открывает
отношение: отношения
отравление: отравление
отредактировать: отредактирована
отряд: отряд
официальный: официальный
официантка: официантка
оценка: оценку оценкой
очередь: очередь
ошибка: ошибке
падать: падает
падма: падма
память: памяти
панк: панков
парвати: парвати
парк: парк
паркинсон: паркинсон
пародия: пародии
патил: патил
паук: паука
первоапрельский: первоапрельской первоапрельского
первое: первого первое
первый: первый
перейти: перейти
перенос: перенос переносе
переносить: переносили
переть: при
переулок: переулок
персонаж: персонажи персонажей
персонал: персонал
персональный: персональные
петтигрю: петтигрю
печать: печати
пещера: пещере пещеру
пиар: пиар
пикчерс: пикчерс
питер: питер
поведение: поведения
погоня: погоню
подделка: подделка
подозревать: подозревает
подробный: подробнее
подчиняться: подчиняться
пожертвовать: пожертвовать
пожиратель: пожирателями пожирателем пожиратели
поиск: поиск поиску
покарать: покарать
поклонник: поклонники
покушение: покушения покушение
полина: полина
политик: политика политике
полнометражный: полнометражных
полностью: полностью
положительный: положительные
полтергейст: полтергейстах
полукровка: полукровкой полукровка
полумна: полумна
получать: получает
получить: получил получить
пользоваться: пользуется
польша: польша
помимо: помимо
помочь: помочь
помощь: помощью
помфри: помфри
понимать: понимает
поппи: поппи
портал: портал
португалия: португалия
поручение: поручение
посвятить: посвятить
последний: последний последней
посол: после
поспособствовать: поспособствовало
посреди: посреди
постановщик: постановщик
постоянный: постоянная
поттер: поттер поттера поттере
поттерианы: поттерианы
поцеловать: поцеловала
починить: починить
почтить: почти
появляться: появляются появляется
правда: правды
правильный: правильное
править: править
правка: правки
превращение: превращению
предел: предела
предмет: предметы
предполагать: предполагаемым
предположение: предположению
представиться: представились
предыдущий: предыдущий
предыстория: предыстория
премьер: премьеры премьера
преподаватель: преподавателя
преподавать: преподавал
преследовать: преследует
преступление: преступления
прибывать: прибывает
приводить: приводит
приготовление: приготовление
приказ: приказам
приказывать: приказывает
приключение: приключения
приключенческий: приключенческий
примечание: примечания
приносить: приносит
принц: принц принцем
приходиться: приходится
проверить: проверенная
проверка: проверки
продавец: продавцы
продюсер: продюсеры
проект: проектах
производство: производство
происходить: происходит
прокат: прокат
проклясть: проклятого проклятое
просить: просит
просмотр: просмотры
пространство: пространства
просьба: просьбе
профессор: профессор
прохор: прохор
прочий: прочее
прощать: прощай
пускаться: пускается
путеводитель: путеводитель
пытаться: пытается
пэнси: пэнси
пятый: пятое
р: р
радость: радости
разгневать: разгневанный
разговор: разговора
размер: размере
разоружать: разоружает
разработчик: разработчики
разрушать: разрушают
разум: разума
райт: райт
ральф: ральф
распределять: распределяющая
рассказ: рассказы
расставание: расставанию
реддл: реддл
реддла: реддла
рекорд: рекорд
религиозный: религиозные
релиз: релиз
ресурс: ресурсы
рецензия: рецензий
рецепт: рецепты рецептов
решать: решают решает
рикман: рикман
римус: римус
робби: робби
род: род
родственный: родственных
роль: роль ролях
роман: романов романа
ромильда: ромильда
рон: рона рон
российский: российские
россия: россии россия
роули: роули
роулинг: роулинг
ру: ру
рубеус: рубеус
рудольф: рудольф
румыния: румыния
руперт: руперт
русак: русаков
русская: русской
русский: русском русски русский
русый: рус
рыцарь: рыцаря
рэдклифф: рэдклифф
рязанец: рязанцев
сайт: сайте сайт сайты
самый: самый самых
сантиметр: см
саундтрек: саундтрек
сбор: сборам сборы
сведение: сведения
свежий: свежие
свободный: свободной
свое: свои
свой: своей свою
связанный: связанные
связаться: свяжитесь
северус: северус
сентябрь: сентября
сербитон: сербитон
сериал: сериал
серия: серии серию серия
сестра: сестру
сивый: сивый
симус: симус
система: системе
сказка: сказки
скарлетт: скарлетт
скачать: скачать
скрытый: скрытые
скрыть: скрыл
следовать: следовать
следующий: следующий
слизерина: слизерина
слизнорт: слизнорт
слизнорта: слизнорта
служебный: служебные
случай: случаях
случайный: случайная
смерть: смерти
смит: смит
снегг: снегг
снегга: снегга
снеггом: снеггом
собрать: собрав собрал
собственность: собственность
событие: события
совершать: совершает
совет: советы
согласовать: согласованной
содержание: содержание
содержать: содержит
создать: создать
сомервилль: сомервилль
сообщество: сообщество
сообщить: сообщить
сохранение: сохранением
спасать: спасает
список: список
сполл: сполл
спора: споры
справка: справка
спрятаться: спрятаться
среди: среди
средний: средней
српски: српски
српскохрватски: српскохрватски
ссылка: ссылка ссылками ссылки
стабильный: стабильная
становиться: становится
становление: становления
станция: станции
старый: старый
статистика: статистика
статья: статья статьи
степан: степан
степень: степени
стив: стив
страдать: страдает
страна: страны
страница: страницы страница страницу странице
строма: строма
студент: студенты
стюарт: стюарт
сумерки: сумерек
существо: существа
существовать: существуют
сценарий: сценария
сша: сша
сын: сыну
сюда: сюда
сюжет: сюжет
сюзанна: сюзанн
таинственный: таинственный
тайна: тайну
тайный: тайная тайны
также: также
тарзан: тарзан
татарча: татарча
тварь: твари
текст: текст
текущий: текущие текущая
телевидение: телевидение
тем: тем
тематический: тематический тематические
тен: тена
термин: термина
тимоти: тимоти
тиффин: тиффин
тихон: тихонов
тичборн: тичборн
товарный: товарный
токио: токио
том: тома
томас: томасом томас
тонкс: тонкс
торфинн: торфинн
тот: том
тоус: тоус
трансформеров: трансформеров
трек: треки
третье: третьим
триллер: триллер
трюк: трюком
турция: турция
тьюлис: тьюлис
убивать: убивает
убийство: убийство
убить: убить
узник: узник
уизли: уизли
уик: уик
уильямс: уильямс
указание: указанием
указать: указана указан
украина: украина
умереть: умереть
уничтожение: уничтожению уничтожении
уолтерс: уолтерс
уорик: уорик
уотсон: уотсон
урок: уроки
условие: условий условии условия
усложнить: усложненному
услышать: услышать
устраивать: устраивают
участие: участие
учебник: учебником учебник
уэйлетт: уэйлетт
файнс: файнс
фантастический: фантастические
февраль: февраля
фелпс: фелпс
фелтон: фелтон
феникс: феникса
фенрир: фенрир
филиус: филиус
философский: философский философского
филч: филч
фильм: фильму фильм фильмов фильма фильмы
фильмз: фильмз
финляндия: финляндия
финниган: финниган
флитвик: флитвик
фонд: фонд
формат: формате
форум: форум
франковый: франкова
франкоговорящий: франкоговорящая
франция: франция
фред: фред
фредди: фредди
фрэнк: фрэнк
фэнтези: фэнтези
фэнтезийный: фэнтезийный
хагрид: хагрид
хант: хант
хейман: хейман
хелен: хелен
хелена: хелена
хердман: хердман
хиро: хиро
хобби: хобби
хогвартс: хогвартс
хогвартса: хогвартса
хогвартсе: хогвартсе
хорватия: хорватия
художник: художник
хупер: хупер
хупером: хупером
цитата: цитаты
цитировать: цитировать
чанг: чанг
час: час
частичка: частичку
часть: часть
чей: чьим
чекан: чекан
человек: человека
чемпионат: чемпионат
черкасов: черкасова
чехия: чехия
чеховский: чеховской
чжоу: чжоу
чили: чили
число: числе
чистый: чисто
читать: читать
чоудхури: чоудхури
чтобы: чтобы
чуть: чуть
шармбатон: шармбатон
шаффер: шаффер
швейцария: швейцария
шестая: шестой
шефали: шефали
широкий: широкий
шкаф: шкаф
школа: школу школе
шляпа: шляпа
штукатурова: штукатурова
шутка: шуткой
щербак: щербаков
эванна: эванна
экранизация: экранизация
эларика: эларика
элемент: элемент
эмират: эмираты
эмма: эмма
энд: энд
энох: энох
энциклопедия: энциклопедии
эпизод: эпизоде
эстония: эстония
это: этом это этому
этот: этой эта
юлия: юлия
язык: язык языках
январь: января
япония: япония
