автор: автора автор автором
авторство: авторства
азкабана: азкабана
алфавит: алфавиту
альбус: альбус
англ: англ
английский: английский английские
апрель: апреля
архивировать: архивировано
барда: барда
бежать: бегущая
белизна: белизна
библиотека: библиотеки библиотеке
библиотечный: библиотечных
бидля: бидля
благотворительный: благотворительный
български: български
вакансия: вакансия
вд: вд
версия: версия
вид: вида видов
викиданных: викиданных
викимедиа: викимедиа
википедии: википедии
википедия: википедия
вклад: вклад
власть: власти
возвращение: возвращение
возможный: возможные
войти: войти
волан: волан
волшебный: волшебные волшебный
выдумать: выдумал
выйти: вышла
вымыслить: вымышленные вымышленной вымышленная
вынос: вынос
выпуск: выпуск
гарри: гарри
гермиона: гермиона
героизм: героизме
год: году годы года
гоночный: гоночных
грейнджер: грейнджер
дамблдор: дамблдор
дамблдора: дамблдора
дар: дары
дата: дата
де: де
действовать: действовать
декабрь: декабря
день: дней
дж: дж
джоан: джоан
дилогия: дилогия
дитя: дитя
док: док
дополнительный: дополнительные
доступный: доступен
доход: доходы
драко: драко
древность: древности
другой: другие других
дурмстранг: дурмстранг
дурной: дурная
жанр: жанр
заглавный: заглавная
запись: запись
запрещать: запрещающее
зарегистрировать: зарегистрированный
заявление: заявление
зверь: звери
зло: зла
знак: знак
знаменитый: знаменитый
зов: зов
золотой: золотого
игра: игра игр игры
избранный: избранные
издатель: издатель
издательство: издательства
издать: издан
икабог: икабог
иллюстрация: иллюстрации
имя: имя
инструмент: инструменты
ирландский: ирландские
использование: использования
история: история истории
источник: источник
камень: камень
карточный: карточная
категория: категории категория
квиддич: квиддич
квиддича: квиддича
квиддичу: квиддичу
кеннилуорти: кеннилуорти
книга: книг книги книгу книгой книге книга
код: код
кодекс: кодекс
коллекционный: коллекционная
команда: команды
комната: комната
конструктор: конструктор
конфиденциальность: конфиденциальности
копия: копией
корморане: корморане
короткий: короткие короткий
кровь: кровь
кубок: кубок
кук: куки
кукушка: кукушки
кэтлин: кэтлин
лахути: лахути
летательный: летательной
лицензия: лицензии
лишение: лишениях
локация: локации
магический: магического
магия: магия магии
маглы: маглы
майя: майя
малфой: малфой
марта: марта
материал: материал
махаон: махаон
место: места
метла: метлы
министерство: министерство
мир: мира мир
миссис: миссис
мобильный: мобильная
могила: могила
модель: модели
модификация: модификации
морт: морт
мочь: могут
мы: нами
навигация: навигации навигация
название: названия
назойливый: назойливых
наказание: наказания
написать: написана
направить: направлены
нарушение: нарушения
находиться: находящейся
наш: наших
недостоверный: недостоверный
некоммерческий: некоммерческой
неполный: неполный
новый: новые
норрис: норрис
носитель: носитель
нравиться: нравится
об: об
обитание: обитания
обложка: обложке
обнаружить: обнаружил
обращение: обращения
обсуждение: обсуждение
огонь: огня
опасный: опасных
описание: описание
описать: описаны описанная
описываться: описывается
организация: организации
орден: орден
оригинал: оригинала оригиналом оригинал
основа: основе
основной: основные
ответственность: ответственности
отдельный: отдельных отдельные
отказ: отказ
отредактировать: отредактирована
отряд: отряд
официальный: официальном
ошибка: ошибке
парк: парк
пародия: пародии пародией
переводчик: переводчик
перейти: перейти
персонаж: персонажи
персональный: персональные
печать: печати
поведение: поведения
подробный: подробнее
пожертвовать: пожертвовать
пожиратель: пожиратели
поиск: поиск поиску
политик: политика политике
полтергейст: полтергейстах
полукровка: полукровка
получить: получить
портал: портал
последний: последний
постоянный: постоянная
поттер: поттер поттеру поттере
появление: появление появления
править: правило правила править правил
правка: правки
предел: пределы
предмет: предметы
представиться: представились
предыдущий: предыдущая
предыстория: предыстория
принц: принц
продажа: продаж
проект: проектах
произведение: произведения
производство: производство
проклясть: проклятое
просмотр: просмотры
пространство: пространства
протяжение: протяжении
прочий: прочее
путеводитель: путеводитель
развитие: развитие
различный: различные
разработчик: разработчики
ранее: ранее
ранний: ранних
распределять: распределяющая
рассказ: рассказы
рассмотреть: рассмотрена
реальный: реальная реальных
религиозный: религиозные
рождественский: рождественский
роман: романов романе романы романах
рон: рона рон
росмэн: росмэн
россия: россии
роулинг: роулинг
рубеус: рубеус
русский: русский
сайт: сайте
сантиметр: см
саундтрек: саундтрек
сведение: сведения
свежий: свежие
свободный: свободной
своеобразный: своеобразной
связанный: связанные
связаться: свяжитесь
северус: северус
сердце: сердце
сериал: сериал
серия: серии серию серия
система: системе
сказать: сказал
сказка: сказки
скачать: скачать
скрытый: скрытая
слово: словам
служба: службе
служебный: служебные
случай: случаях
случайный: случайная
смертельный: смертельная
смерть: смерти
снегг: снегг
снитча: снитча
событие: события
содержание: содержание
содержать: содержит
создать: создать
сообщество: сообщество
сообщить: сообщить
сохранение: сохранением
список: список
спора: споры
спорт: спорта
справка: справка
српски: српски
српскохрватски: српскохрватски
ссылка: ссылка ссылки
статистика: статистика
статья: статья статьи
страйке: страйке
страница: страницы страница страницу страниц странице
существо: существа
сюда: сюда
тайный: тайная
также: также
тактический: тактические
текст: текст
текущий: текущие
тематический: тематический
тираж: тиража
товарный: товарный
узник: узник
уизли: уизли
уисп: уисп
уиспа: уиспа
указание: указанием
указать: указано
урок: уроки
условие: условий условия
участие: участие
фантастический: фантастические
феникс: феникса
философский: философский
фильм: фильм фильмов
фонд: фонд
форум: форум
хагрид: хагрид
хобби: хобби
хогвартс: хогвартс
хогвартса: хогвартса
цикл: цикл
цитировать: цитировать
чемпионат: чемпионат
чернильный: чернильно
читать: читать
шаблон: шаблона
шармбатон: шармбатон
шелкопряд: шелкопряд
шляпа: шляпа
эволюция: эволюция
эксперт: эксперт
элемент: элемент
энциклопедия: энциклопедия энциклопедии
это: это
этот: этой эта эту
являться: является
язык: язык языках
январь: января
