аберфорт: аберфорт
абстрактно: абстрактно
абстрактный: абстрактный
авад: авада
авгур: авгура авгур авгуров авгуры
авгуреев: авгуреев
август: августа
австралийский: австралийских
австралия: австралию австралии
автор: автор
авторитет: авторитетом
авторитетный: авторитетных
авторство: авторства
агрессивный: агрессивен агрессивные агрессивное агрессивны агрессивного агрессивным агрессивна агрессивный
адаптация: адаптация
адрес: адрес
азия: азии
азкабан: азкабан
азкабана: азкабана
акнекрыс: акнекрыс
акнерыс: акнерыс
акромантул: акромантул
акромантула: акромантула
акромантулами: акромантулами
акромантулов: акромантулов
акромантулы: акромантулы
активно: активно
активный: активной
актиния: актинию
акулобраз: акулобраз
акулообраз: акулообраз
ала: алой
аластор: аластор
алеть: алеет
аллергический: аллергической
алфавит: алфавиту
алфавитный: алфавитный
алый: алого алое алая
альбинос: альбиносов
альбус: альбус
альбуса: альбуса
альтернатива: альтернативы
амбридж: амбридж
америка: америке америки
американский: американские американский
англ: англ
английский: английского английском
англия: англия англию англии
андрос: андрос
апатия: апатии
апельсин: апельсины
апрель: апреля
арагог: арагог
арагога: арагога
аренда: аренду
ариан: арианы
арнольд: арнольдом
артефакт: артефактов
артур: артур
архив: архив
архивировать: архивировано
архивный: архивной
астрология: астрология
атака: атак
атлантика: атлантике
аттестация: аттестация
аудио: аудио
африканский: африканское африканская африканские
ашвиндер: ашвиндер
б: б
баз: базе
бандиман: бандиман
банк: банке банка
банши: банши
барабашка: барабашка
барда: барда
бег: бег
бегемот: бегемота
безболезненный: безболезненного
безвредный: безвредный
безголовый: безголовым безголового
беззащитный: беззащитного
безобидный: безобидное
безопасность: безопасности
безрогий: безрогая безрогой
безумный: безумный
безуспешно: безуспешно
бейн: бейн
бейна: бейна
белка: белка
белокурый: белокурый
белоснежный: белоснежной
белые: белым белые белых
белый: белого белой белая
берег: берегах
береговой: береговая
беречь: берегу
беседа: беседу
бесплотный: бесплотные
бесполезность: бесполезности
беспомощный: беспомощным беспомощного
беспорядочный: беспорядочным беспорядочного
бессмертный: бессмертными бессмертную
бестелесный: бестелесного
бесформенный: бесформенного
бесцельность: бесцельность
бесшумно: бесшумно
бидля: бидля
билл: билл
билливиг: билливиг
биограф: биограф
битва: битвой битве битвы
благодаря: благодаря
благоприятный: благоприятен
бладжер: бладжер
бладжеру: бладжеру
бледно: бледно
бледный: бледного бледная
блестеть: блестящими блестящие
ближний: ближайшем
близкий: близко поближе
близнец: близнецы
блэк: блэк
блэка: блэка
боггарт: боггарт
боггарта: боггарта
боггарту: боггарту
боггарты: боггарты
бодроперцового: бодроперцового
бок: бок
болезнь: болезнью болезни
болотный: болотный
болото: болота болотах
болтрушайка: болтрушайка
болтрушайки: болтрушайки
боль: боль болью
больной: больного больным
больший: большей большими большая большие больших большую больше
большинство: большинство
большой: большом большой
бормотание: бормотание
борнео: борнео
бородавочник: бородавочник
бороться: бороться
борьба: борьбы борьбой борьбе
ботва: ботву
боутракл: боутракл
боязнь: боязнь
бояться: боятся боится боялись
браконьер: браконьеров
брат: брата братьев
браун: браун
брачный: брачного
британия: британии
британский: британских
бритва: бритва
бронебрюх: бронебрюх
бронебрюхами: бронебрюхами
бронза: бронзы
бронированный: бронированной
бросить: бросить
бруно: бруно
бруствер: бруствер
брюшко: брюшка
бугристый: бугристым
будущее: будущего будущим
буквальный: буквально
букля: буклей
буркин: буркина
бусина: бусины
български: български
бывать: бывает
бык: бык
быстро: быстро
быстрота: быстротой
быстрый: быстрые быстр быстрый
быть: будут будучи были
бякоклешень: бякоклешень
важный: важной важных
валлийский: валлийского валлийский
валун: валун
вальс: вальс
вампир: вампиры
вариант: вариант
василиск: василиском василисков василиска василиск василиски
ваш: ваша
вблизи: вблизи
ввести: ввела
вдоль: вдоль
ведьма: ведьме ведьма
везти: везут
вейла: вейла
вейлы: вейлы
век: века веков
веление: велению
велеть: велят
великан: великаны великанам великаном великан великанов великана
великанский: великанской великанских
великанша: великанши
великий: величайшее
великобритания: великобритании
великолепный: великолепные великолепная
величественный: величественное величественная
величина: величиной
венгерский: венгерского венгерский
веретенниц: веретенниц
веретенница: веретенница
верить: верят
вернуть: вернуть
вернуться: вернуться вернувшись
вероятно: вероятно
вероятный: вероятнее
версия: версия версии
вертеться: вертится
верх: верхом
верховый: верховая
верхушка: верхушки
вершина: вершинах
вес: веса
весить: весит весь
весомый: весом
весь: вся
весьма: весьма
ветвь: ветвях
веточка: веточки
вечно: вечно
вечный: вечные
вещество: веществ вещество
вещь: вещей вещь
взаимодействовать: взаимодействовать
взамен: взамен
взбесить: взбесили
взгляд: взгляд взгляда взгляду
взглянуть: взглянуть
взрослый: взрослых взрослые взрослом взрослого
взрывать: взрывают
взрываться: взрываться взрывается взрывающееся
взрывопотам: взрывопотам
взять: взять
взяться: взялся
вид: виды вида видов виду вид виде
видение: видения
видеопродукция: видеопродукции
видеть: видеть видит видели видны видят видела видел
видимо: видимо
видимый: видимому
видно: видно
викиданных: викиданных
викимедиа: викимедиа
википедии: википедии
википедия: википедия
виктор: виктору
винки: винки
вино: вин
вить: вьют
вклад: вклад
владелец: владелец
владелица: владелица
владение: владения владение
владеть: владеющий владеют
влажный: влажных
власть: власти
вместе: вместе
вместо: вместо
вмешательство: вмешательство
вмешаться: вмешайся
вмешиваться: вмешиваться
вмещать: вмещать
вне: вне
внешне: внешне
внешность: внешность
внимание: внимание внимания
внутренность: внутренности
внутри: внутри
вовремя: вовремя
вод: вода
вода: водой
водиться: водится водятся
водный: водных
водяной: водяного водяных водяные водяной водяному
водящий: водящих
возвращаться: возвращается
возвращение: возвращение возвращения
воздействие: воздействие
воздействовать: воздействующих
воздух: воздухе воздух
возможно: возможно
возмущение: возмущение
возникать: возникать возникающей возникает
возраст: возраста возрасте
возрождаться: возрождается
возрождение: возрождение возрождения
война: войной войну
войско: войска
войти: войти
вокруг: вокруг
волан: волан
волк: волк волка
волна: волна
волос: волосы волос волосом волосами
волосатый: волосатый волосатым
волосок: волосок
волшебник: волшебника волшебников волшебник волшебнику волшебники волшебниками волшебникам
волшебница: волшебниц
волшебный: волшебной волшебные волшебных волшебная волшебный волшебным волшебными волшебное
волшебство: волшебство
вообще: вообще
воодушевить: воодушевить
вопить: вопящую
вопль: вопль вопли
вор: ворам
ворожба: ворожбой
вороной: вороным
восемь: восемью восьми
воскресить: воскресить
воспоминание: воспоминания
воспретить: воспрещено
воспринимать: воспринимает
восток: востока востоке
восточный: восточной восточно
восход: восхода
восьмиглазый: восьмиглазый
восьминедельного: восьминедельного
впервые: впервые
вплоть: вплоть
вполне: вполне
впоследствии: впоследствии
впрочем: впрочем
враг: врагов
вражда: вражда
вращаться: вращающимся вращаются
вред: вред вреда
вредитель: вредителем вредителями
временами: временами
временить: времени
время: время
времяпрепровождение: времяпрепровождением
вроде: вроде
все: всему всех всего всем
всевозможный: всевозможным
всеять: всей
вскоре: вскоре
вследствие: вследствие
всплывать: всплывают
вспрыгивать: вспрыгивает
вспыхивать: вспыхивает
вспышка: вспышке
встретить: встретить
встретиться: встретится
встреча: встреча встречей встречи
встречать: встречающий встречает
встречаться: встречается встречаются
вступать: вступать
всякая: всякую
всякий: всякого всяких всякие
всячески: всячески
второе: втором второму
второй: второй
вход: вход
входить: входят входит
выбирать: выбирать
выбрать: выбрать выбрал
выбраться: выбраться
выведение: выведение
вывести: выведена выведены
вывозиться: вывозятся
выглядеть: выглядит выглядели
выгнать: выгнать
выгнутый: выгнутым
выгода: выгоду
выгонять: выгоняет
выделять: выделяют
выдерживать: выдерживают
выдра: выдра выдру
выдумать: выдумано
выдыхать: выдыхать выдыхаемое
выжигать: выжигает
вызвать: вызвала вызвал вызвавшего вызвать вызванный вызвали
вызов: вызова вызов вызове
вызывать: вызывать вызываемая вызывает вызывающим вызывают вызывая
выискивать: выискивают выискивать
выйти: вышел
вылезать: вылезает
вылетать: вылетают
вылечить: вылечил
вылиться: выльется
вылупление: вылупления
вылупляться: вылупляются
вымыслить: вымышленных вымышленные вымышленного
выносить: выносит
вынудить: вынудить вынуждена
вынуждать: вынуждая
выпал: выпал выпала
выполнить: выполнить
выполнять: выполняет выполняют
выпучить: выпученными
вырастать: вырастают
вырасти: вырастут вырос
вырастить: выращен вырастившим
выращивать: выращивают
вырезать: вырезано
вырываться: вырываются
высасывать: высасывают
высидеть: высидеть
высказывание: высказывания
выскакунчик: выскакунчик
выследить: выследить
высовываться: высовывающееся
высокий: высокого высокий высшей высоко выше
высокомерный: высокомерное
высокочастотный: высокочастотное высокочастотного
высота: высоту высотой
высотный: высотных
выстреливать: выстреливая выстреливает
выступать: выступающими выступать
высушить: высушенные
вытворять: вытворять
вытеснить: вытеснила
вытягиваться: вытягивается
вытянутый: вытянутой
выходить: выходят
выцарапать: выцарапать
выцарапывать: выцарапывали
вычитать: вычитав
вышеописанный: вышеописанной
вышеупомянутый: вышеупомянутого
г: г
габриэль: габриэль
галстучек: галстучек
гарри: гарри
гебридах: гебридах
гебридский: гебридский
генеральный: генерального
геометрический: геометрические
германий: германии
гермиона: гермиона гермионы гермионе гермиону
героизм: героизме
герпием: герпием
гибель: гибель
гибкий: гибкие
гибрид: гибриды
гигантский: гигантская гигантских гигантский
гипноз: гипноза
гиппогриф: гиппогрифы гиппогрифа гиппогрифу гиппогрифом гиппогриф
гиппокамп: гиппокамп
гиппокампус: гиппокампус
гирлянда: гирлянды
глава: главе главами главы глава
главное: главным главное
главный: главная главный
глагол: глаголы
гладкий: гладкое гладкая гладкой
глаз: глазами глазам глаз глаза глазах
глазок: глазками
глиноклок: глиноклок
глиноклока: глиноклока
глиноклоки: глиноклоки
гловер: гловер
глубокий: глубже глубокой глубоких
глупый: глупые
глядеть: глядя
глянцевый: глянцевый
гнев: гнев
гнедой: гнедой
гнездиться: гнездится гнездятся
гнездо: гнезде
гниль: гнили
гном: гном гнома гномов
гоблин: гоблинам гоблин гоблины гоблинов гоблинами
гоблинской: гоблинской
говорить: говорить говорит говорила
говорят: говорят
говорящий: говорящие говорящего
год: году лет годы года
годрика: годрика
гойла: гойла
голова: голову голова головы головой голов голове
головастик: головастиков
головокружение: головокружение
голодный: голоден
голос: голоса голосом голос
голосок: голосок
голубить: голубь
голубоглазый: голубоглазый
голубой: голубого голубой
гора: горах
горазд: гораздо
гораций: гораций
горб: горбами
горбатый: горбатый горбатое
гордость: гордость
гордый: гордый
горе: горем
гореть: горящий гореть
горностай: горностая горностай
горный: горные горных
горстка: горстка
горсть: горстью
горячительный: горячительного
горячо: горячо
гостиная: гостиную
гот: готов
готовый: готовы
граббли: граббли
гранитный: гранитно
гранить: грани
грат: грата
графство: графстве
грациозный: грациозную
гребень: гребнями гребня
гребешок: гребешки
гребнеспин: гребнеспин
грейнджер: грейнджер
греция: греции
греча: греч
греческий: греческое греческие греческих
гриб: грибы
грибовидный: грибовидные
грива: грива гриву гривой
гриммо: гриммо
гринготтс: гринготтс
гринготтсе: гринготтсе
гриндилоу: гриндилоу
грифон: грифон грифоны грифона
гриффиндора: гриффиндора
грозить: грозит
громамонт: громамонт
громамонта: громамонта
громамонтами: громамонтами
громамонтов: громамонтов
громкий: громче громко
грохх: грохх
грохха: грохха
гроххом: гроххом
грубый: грубого грубых грубой
грудной: грудные
груз: груз
группа: группа группы
грызун: грызунами
грюм: грюм
грюмошмели: грюмошмели
грюмошмель: грюмошмель
грязно: грязно
грязный: грязных
губительный: губительно губительным
густой: густо густого густой густую густые
дабы: дабы
давать: давала давая давать
давний: давних
дадли: дадли
далее: далее
далекий: подальше дальше
дальнейший: дальнейшая
дальний: дальнего дальнем
дама: даму
дамблдор: дамблдор
дамблдора: дамблдора
дамблдором: дамблдором
дамблдору: дамблдору
дар: дарах дары
дата: дата
дать: дали данном данный данная данные дал дать
два: два две двух двумя
двигаться: двигаться
движение: движений
двор: дворе
двуногие: двуногие
двурог: двурог
двурога: двурога
де: де
девочка: девочка девочки девочкам девочкой
дедушка: дедушки
действие: действием
действовать: действующие действовать действующее действуют действует
декабрь: декабря
декоративный: декоративное
делакур: делакур
делать: делает делать делала делают
делить: делит
дело: делу деле
дементор: дементор
дементора: дементора
дементорам: дементорам
дементорами: дементорами
дементоров: дементоров
дементоры: дементоры
деменция: деменция
демимаска: демимаска
демон: демоны демон
демонстрировать: демонстрирует
день: дней дне дни
деньги: денег
деревня: деревни деревне
дерево: дерева деревьях дерево деревья деревьев
деревянный: деревянную деревянные
деревяшка: деревяшку
держать: держать держали держал держит
десяток: десятков
десять: десяти десять
деталь: деталь
детеныш: детеныши
детоед: детоед
детский: детский
деть: день дело
деятельность: деятельности
дж: дж
джарви: джарви
джастин: джастина
джеймс: джеймс
джек: джек
джинни: джинни
джон: джона
джордж: джордж джорджа
джулиан: джулиан
джунгли: джунгли
диаметр: диаметром
диггори: диггори
дикий: диких
дилогия: дилогия
дина: дин
директор: директором
дириколей: дириколей
дириколь: дириколь
диринар: диринар
диринаров: диринаров
диринары: диринары
дитя: дитя
длина: длиной длину длина длины длиною длине
длиннорогий: длиннорога длиннорог
длиннорогов: длиннорогов
длиннорогу: длиннорогу
длинный: длинными длинным длинные длинное длинны длинном длинный
дно: дно дну
добавить: добавлено
добавлять: добавляют
добби: добби
добрый: доброй
добывание: добывания
добыть: добыть
добыча: добычу
доверять: доверяют
доводиться: доводилось
довольный: довольно
дождливый: дождливую
дождь: дождь
дожить: дожить
док: док
доказать: доказать
доказывать: доказывающего
докси: докси
долгий: долго дольше долгое
долгопупс: долгопупс
должен: должен
долина: долинах
долорес: долорес
доля: долю
дом: дом дому доме
дома: дома
домашние: домашних домашним домашними
домашний: домашнего домашнее домашней домашний
домовик: домовики домовиков домовиком
домовой: домовой домовых домовые
домыть: домой
дополнительный: дополнительные
дополнить: дополнив
допустить: допустим
дорога: дорогу
дороговизна: дороговизну
дорогой: дорого
дорсет: дорсет
дорсете: дорсете
доставить: доставлена
доставка: доставки
доставлять: доставлять
достаточно: достаточно
достаточный: достаточным
достигать: достигают достигающая достигающее достигающие достигает достигать
достижение: достижения достижении
доступ: доступ
доступный: доступен доступны
доучиться: доучиться
доходить: доходя
др: др
драгоценный: драгоценные драгоценными
драка: драка
драко: драко
дракон: дракона драконам дракону драконов драконами драконы дракон
драконий: драконьим драконью
древний: древней
древность: древности
дрессировка: дрессировке
дрир: дрир
дромарог: дромарог
дромарога: дромарога
дромарогах: дромарогах
дромарогов: дромарогов
дронт: дронтами
друг: друг друзей другом друга
другой: другим другой другими другая другие других другого
дружба: дружбу
дружный: дружен
дубина: дубину дубинами
дурмстранг: дурмстранг
дух: дух духам духи
душ: душу души
душераздирающий: душераздирающую
дыба: дыбы
дым: дыма
дыхание: дыхание
дышать: дышат
дюжина: дюжину
дюйм: дюймов дюйма дюймами
европа: европе европы
египет: египте
египетский: египетские
еда: еда едой еду
едва: едва
единорог: единорога единорог единороге
единственный: единственное единственным единственный единственные
еж: ежом ежа
ежемесячно: ежемесячно
ездить: ездят
есть: ест едят
жаба: жабу
жадно: жадно
жажда: жажды
жало: жала жало жале
жар: жара жар
желание: желание желанию
железа: железы
желудок: желудка
жемчужина: жемчужины
жемчужный: жемчужным жемчужно
женский: женского
женщина: женщины женщина женщину
жеребенок: жеребята жеребят
жертва: жертв жертву жертвам жертвы жертва
жесткий: жесткие
жестокий: жестоким
живность: живность
живой: живой живого
живородящий: живородящи
живот: животе живота
животное: животного животным животное животных животные животными животном
жизнедеятельность: жизнедеятельности
жизнь: жизни жизнь жизнью
жилистый: жилистые
жилища: жилища
жить: жили жить живущее живущего живущий живущая живут живущие
жмыр: жмыр
жмыра: жмыра
жмырами: жмырами
жмыров: жмыров
жмыры: жмыры
жребий: жребию
жрыль: жрыль
жужжание: жужжания
жук: жука
журнал: журнала
жуткий: жуткий жутко
жучков: жучков
забавлять: забавляет
забавный: забавные
заблудиться: заблудился
забодать: забодать
забор: забор
забота: заботы
забрало: забрал
забрать: забрали
забыть: забыли
зависание: зависание
зависеть: зависит
зависимость: зависимости
завывание: завывания
загадать: загадана загаданную
загадка: загадку загадка
загадочный: загадочные
заглавный: заглавной заглавная
заглушать: заглушающим
загрыбаст: загрыбаст
задание: задания
задача: задача
задел: задел
задний: задних задние заднюю задней
заир: заире
заканчиваться: заканчиваются
закапывать: закапывают
заклинание: заклинанием заклинанию заклинания заклинаниям заклинаний заклинание
заклинатель: заклинателей
заклятие: заклятие заклятий заклятьем заклятье заклятия
заколдовывать: заколдовывает
закон: законам законов
законный: законных
закончиться: закончилась закончилось
закоулок: закоулках
закружиться: закружится
зало: зала
заломить: заломил
заманивать: заманивает
заманить: заманить заманив
замариновать: замариновать
замена: замена
заменить: заменить заменивший
заменять: заменяют
заметить: заметить замечена заметили
заметно: заметно
заметный: заметным
замечательно: замечательно
замечательный: замечательным
замечать: замечают замечали
замешательство: замешательство
замирать: замирая
замок: замку замка
заморозить: замороженные заморозить
замысловатый: замысловатые
занимать: занимают
занятие: занятиях
запад: западе
запатентовать: запатентованных
запах: запах
запечатать: запечатав
запись: запись записей
заплатить: заплатившего заплачено
заповедник: заповедники заповедник
заползать: заползает
заполнить: заполненное
заполонять: заполоняют
запретить: запретили
запретный: запретного запретном запретный
запускать: запускают
запустить: запустил
заранее: заранее
зарегистрировать: зарегистрированный
заряд: заряд
заслуга: заслуга
засохнуть: засохшее
заставить: заставившим заставить
заставлять: заставляет заставляют
застрять: застрял
заступник: заступник
затаиться: затаится
затем: затем
зафиксировать: зафиксированное зафиксированы
захват: захвата
захватить: захватили
захватывать: захватывает
захотеть: захотел захочет
зачастую: зачастую
зачем: зачем
зашвырнуть: зашвырнуть
защита: защиты защитой защите защиту
защититься: защититься
защитник: защитника защитник защитникам защитников
защитный: защитную защитные
защищать: защищают защищает защищая защищать
заявитель: заявителя
заявление: заявление
заяц: заяц
зверь: зверя зверю зверям зверь зверей звери
звук: звуками звуков
звучать: звучит звучащее
здание: зданий
зеландия: зеландии
зеленоватый: зеленоватого зеленовато зеленоватую
зелье: зелий зелье зелья
земля: земли земле землю
земляной: земляных
земной: земной земного
зеркало: зеркале
зима: зиму
злобный: злобным злобные злобную злобного
злой: злых
злостный: злостным
змеевидный: змеевидное
змееподобный: змееподобным
змеиный: змеиным
змей: змеем змеев
змея: змеи змей змея
знак: знака знак
знакомство: знакомстве
знаменитый: знаменитой знаменитые
знаменовать: знаменует
знание: знанием
знать: знает знали
значение: значения
значительно: значительно
значительный: значительными
золотистый: золотистыми золотистые
золотой: золотыми золотая золотые золотых золотой
золотоподобное: золотоподобное
золь: золе
зомби: зомби
зоолог: зоологов зоологи зоолог
зоология: зоологию зоология
зрачковый: зрачков
зрачок: зрачками
зрелище: зрелище
зрелость: зрелости
зуб: зубами зубов зубы зубах
игра: игра игре игры
играть: играют
идея: идеи идею
избегать: избегать избегает
избежать: избежать
избиение: избиение
избранный: избранные
изваяние: изваяние
известно: известно
известный: известна известных известные известны известным известен
извлечь: извлечь
изгнать: изгнать
изготавливать: изготавливают
изготовление: изготовлении изготовления
издавать: издают
издавна: издавна
издать: издали
излечиться: излечиться
излучать: излучают
излюбить: излюбленными
изменяться: изменяться
измученный: измучен
изображать: изображающие
изображение: изображением
изогнутый: изогнутые
изучать: изучают изучает
изучаться: изучаются
икра: икру
икринка: икринками
илфракомбского: илфракомбского
именно: именно
иметь: имеющие имеют имевший иметь имеет
иметься: имеется
имитация: имитацию
иммунитет: иммунитет
имя: имена имя имени именам
иначе: иначе
ингредиент: ингредиентов
индивидуум: индивидуума
индий: индии
индийский: индийском
инкрустировать: инкрустированным
иногда: иногда
иностранный: иностранному
инспектор: инспектора
инструмент: инструменты
интеллект: интеллекта интеллектом
интеллектуальный: интеллектуальные
интенсивный: интенсивная
интервью: интервью
интерес: интереса
интересно: интересно
интересный: интересной
инфернал: инфернал
инферналы: инферналы
инфинитив: инфинитиве
информация: информацию информации
информировать: информировать
инцидент: инцидента
ипопаточник: ипопаточник
ирландия: ирландии
ирландский: ирландской ирландский
искать: ищет
исключение: исключением исключение
исключительно: исключительно
исключительность: исключительности
исключительный: исключительную
исключить: исключили
исковеркать: исковерканное
ископаемое: ископаемые
искра: искры
искрящеся: искрящеся
искусственный: искусственного
искусство: искусств
испепелить: испепелить
исполнить: исполнены
использование: использования
использовать: использует использовать использующие использовали использованы используемую используют
использоваться: используются использоваться используется
испортить: испортит
испугаться: испугался
испускать: испускает испускать
испытание: испытания
испытывать: испытывает испытывают
иссинить: иссиня
исследование: исследование исследования
исследовательский: исследовательской
истерик: истерике
истерический: истерические
истерия: истерию
история: история истории
источник: источников источникам источник
истребить: истребили
истребление: истребления
исходить: исходит
исцелять: исцеляют
исцеляться: исцеляется
исчезать: исчезая исчезает исчезать исчезающее
ишак: ишака
ищейка: ищеек
июль: июля
июнь: июня июнь
й: й
йети: йети
кабан: кабан
кабинет: кабинета
каждый: каждой каждый каждая
кажется: кажется
кайма: каймой
какой: каком какую какое
калейдоскопический: калейдоскопические
каменеть: каменеют
камень: камню камень камнями
камыш: камыша
канава: канавах
канарейка: канарейка
канцелярский: канцелярских
каплевидный: каплевидной
каппа: каппы каппу каппой каппа
караться: карается
карета: кареты
карлик: карлики
карликовый: карликовые
картофелина: картофелину
карточка: карточка
карточный: карточная
категория: категорий категории
качаться: качаться
качество: качества качестве
квадратный: квадратных
квалифицированный: квалифицированный квалифицированных
квиддич: квиддич
квиддиче: квиддиче
квиддичу: квиддичу
квинтолап: квинтолап
квинтоног: квинтоног
квирелл: квирелл
квиринус: квиринус
квиррелл: квиррелл
квирреллом: квирреллом
кг: кг
кедавра: кедавра
келпи: келпи
кельпи: кельпи
кенгуру: кенгуру
кентавр: кентавров кентавры кентавр
кизляк: кизляк
кикимер: кикимер
кингс: кингс
кингсли: кингсли
киноверсии: киноверсии
кисть: кистями
кит: кита
китай: китае
китайский: китайский китайской китайского
кичиться: кичатся
клабберт: клабберт
клабберта: клабберта
клаббертами: клаббертами
клаббертов: клаббертов
клабберту: клабберту
кладка: кладке кладки
клан: кланов клана
класс: класс классу
классификация: классификация классификацию
клейкий: клейкого
клетка: клетки
клешнеобразный: клешнеобразными
клешнепод: клешнепод
клешнепода: клешнепода
климат: климат климатом
клинохвост: клинохвост
клубкопух: клубкопух
клубкопухи: клубкопухи
клубочек: клубочек клубочки
клумба: клумбы
клык: клыки клыков клыками
клюв: клюв клювом
клювокрылом: клювокрылом
кляксовый: кляксовый
кляча: кляча
книга: книгах книги книге
ко: ко
кобра: кобра
коготь: когти
когтеврана: когтеврана
код: код
кодекс: кодекс
кожа: кожа кожи кожей кожу
кожица: кожица
коза: коз козами
козел: козла
козий: козьим
кокон: коконы коконов
колдун: колдун колдунов
колебаться: колеблется
колено: колени
количество: количество количествах
коллекционный: коллекционная
колония: колонии колония
колпак: колпаки
колючий: колючих
коммерческий: коммерческие
комната: комната
компаньон: компаньоном
композиция: композиция
комфортно: комфортно
конго: конго
конец: концов конце конец концу конца
конечность: конечности конечность
конструктор: конструктор
контакт: контакта
контракт: контракт контракту
контролировать: контролировать
контролироваться: контролируется
контроль: контроль контролю контроля
конфедерация: конфедерация
конфета: конфет
конфиденциальность: конфиденциальности
конфисковать: конфискованной конфискованные
кончиться: кончилась
конь: коней коня
конюшня: конюшнях
копия: копии
копыто: копытами копыта
копье: копий
кора: корой
корабль: корабли
корень: корней корни
коридор: коридоре
коричневый: коричневыми коричневого коричневые коричневой
кормак: кормак
кормиться: кормятся
корнуэле: корнуэле
корнуэльский: корнуэльская
корова: коров
короткий: коротких короткие короткими короткий
короткокрылый: короткокрылый
короткорылу: короткорылу
косой: косом
костлявый: костлявые
кость: кость
костюм: костюмы
кот: кот
котелок: котелков котелком
котлы: котлах
который: которым которое которыми которой которую которого которые которых которая котором который
кочка: кочку кочки
кошачий: кошачьими
кошелек: кошельки
кошка: кошку кошками кошка
краб: крабы краб крабами крабов
крайне: крайне
крайний: крайний крайней
кракен: кракен
крама: крама
краму: краму
крап: крапом крапа крап крапов
крапива: крапивой
крапинка: крапинками
красивый: красивое красивый красивым
красношапы: красношапы
красный: красные красный красная красного
крауч: крауч
крепкий: крепкие
крепость: крепости
крик: крик
крильмар: крильмар
критика: критик
кричать: кричать
кровать: кроватью
кровожадный: кровожадные
кровь: крови кровью кровь
кроме: кроме
кросс: кросс
крот: кротов
крохотный: крохотные крохотных
крошечный: крошечных крошечной
круглый: круглый круглые
круп: круп
крупный: крупнее крупными покрупнее крупное крупную крупных крупные
крылатый: крылатых крылатые крылатого
крыло: крыльях крыльями крыльев крылья
крылышко: крылышки
крыса: крыс крысу крысами
крыша: крыши
крэбба: крэбба
крюкорог: крюкорог
ксенофилиусом: ксенофилиусом
кстати: кстати
кто: кем кого кому
кубок: кубок кубке
куда: куда
кук: куки
купальный: купальные
купе: купе
купить: купил
купол: купола
куриный: куриное
курносая: курносой
курчавый: курчавые
кусачий: кусачая
куст: кусты
кустарник: кустарников
кучка: кучку
кэдоган: кэдоган
лаванда: лаванда
лавгуд: лавгуд
лавгудом: лавгудом
ладонь: ладони
лазиль: лазиль
лакомство: лакомство
лань: лань лани
лапа: лапами лапах лапы
лапка: лапками
ласка: ласки
лата: лат
латинский: латинского
латынь: латыни
лебедь: лебедь лебедя
лев: льва
левитация: левитация
левый: левая левой
легенда: легенде легенды
легко: легко
леопард: леопард
лепрекон: лепрекон
лепреконы: лепреконы
лес: лесу леса лес лесах
лесистый: лесистых
летаплащ: летаплащ
летать: летающее летать летает летающий
лететь: летят
летифолд: летифолд
летучий: летучей летучих летучие
лечебный: лечебными
лечурка: лечурка
леший: леший
либо: либо
лили: лили
лиловый: лиловое
лимонный: лимонной
линия: линия
линчевать: линчевало
лис: лис
лист: листьями листьев
листва: листвой
литература: литературе
литься: льющихся
лихорадка: лихорадки лихорадку
лицензия: лицензию лицензии
лицо: лице лицо лица лицом
личико: личики
личинка: личинки
личность: личности
лишать: лишающий
лишение: лишениях лишение
лишиться: лишится
лишь: лишь
лоб: лба
лобалуг: лобалуг
лобалуга: лобалуга
лобалугу: лобалугу
лобстером: лобстером
ловкость: ловкостью
ловушка: ловушку
лодыжка: лодыжках
локация: локации
локонс: локонс
ломать: ломать
лорд: лорд
лох: лох
лохматый: лохматой
лошадиный: лошадиным лошадиные лошадиную лошадиное
лошадь: лошади лошадь лошадей
лука: лук
лукотрус: лукотрус
лукотрусы: лукотрусы
луна: луна
лунный: лунный лунного лунном
лунь: луне
лысая: лысая лысой
лысый: лысые
львиный: львиной львиный
любимец: любимец
любить: любят любил любимая любимой любит любимое
любовный: любовного
любовь: любовью любовь
любой: любое любыми любые любого любой любом любая
любопытный: любопытных
люпин: люпин люпином люпина
люциус: люциус
лягушка: лягушкой
м: м
маг: магов маги магам магами
магистрат: магистрата
магически: магически
магический: магического магической магическую магические магических магическая магический магическому магическое магическими
магия: магия магии магией
маглам: маглам
маглами: маглами
маглов: маглов
магловских: магловских
магловской: магловской
маглы: маглы
магозоолог: магозоолог
магориан: магориан
магориана: магориана
мадам: мадам
мак: мак
макбун: макбун
макбунов: макбунов
макбуны: макбуны
макгонагалл: макгонагалл
макгоннагалл: макгоннагалл
маккливертов: маккливертов
маккливерты: маккливерты
маклагген: маклагген
макмилан: макмилан
макмиллан: макмиллан
максим: максим
максимализм: максимализмом
маленький: маленький маленького маленькая маленьких маленькие мал маленькими меньше мало малейшее маленькое
малоподвижный: малоподвижен
малфоев: малфоев
малфой: малфой
малфоя: малфоя
мальчик: мальчики мальчика
мандрагора: мандрагора мандрагоры
мандрагораводы: мандрагораводы
мантикор: мантикор
мантикора: мантикора
мантикорой: мантикорой
мантикоры: мантикоры
мантия: мантий
манящий: манящих
маргориан: маргориан
маркус: маркуса
марс: марс
мастер: мастер
масть: масти мастей
материал: материал материала
матч: матча матчу
мать: матери
маховик: маховика
мая: мая
мгновенно: мгновенно
медведь: медведь
медленный: медленный медленно
медный: медного
меж: меж
международный: международная международной
меланхолия: меланхолию
мелкий: мелкими мелкой мелкие
мелководный: мелководных
мелодичный: мелодичным
мелодия: мелодии
менее: менее
меньший: меньших
менять: меняет менять
мера: мере
мероу: мероу
месиво: месиво
местами: местами
местечко: местечко
местность: местностях местности
место: место местах места мест месте
местоимение: местоимений
месяц: месяцев месяц
металл: металла металл
металлический: металлическим
метаморфа: метаморфа
метать: мечет
метла: метлой метле
метод: метод
метр: метров
мех: меха меху мехом
меч: меч
мечта: мечты
мечтатель: мечтатель
мешочек: мешочек мешочка
миграция: миграции
миленький: миленькие
миля: миль
минерва: минерва
миниатюрный: миниатюрные
министерство: министерства министерство министерством министерстве
министр: министром
миновать: миновала
минута: минут
мир: мира миру мир миры мире миров
мирно: мирно
мирный: мирным
мировоззрение: мировоззрения
мировой: мирового
миссис: миссис
мистер: мистер
миф: мифах
мифический: мифическое
мифология: мифологии мифология
млекопитающее: млекопитающими
мнение: мнению
многие: многими многие многих
многий: многом
много: более много
множество: множество
мобильный: мобильная
могучий: могучей
мода: моды
можно: можно
мозг: мозга
мозолистый: мозолистые
мой: мой
моко: моко
мокрица: мокрицами
молли: молли
молодая: молодых
молодой: моложе
молчание: молчание
моль: молью
момент: моменту момент
монстрология: монстрология
мор: море
моргать: моргает моргать
морда: морда мордами мордой морды
мордочка: мордочку мордочками
мореход: мореходов
морить: моря
морской: морских морские морского морской
морт: морт
морта: морта
морщерогий: морщерогий
мох: мхом
мохнатый: мохнатый мохнатое мохнатые
мочеполовой: мочеполовых
мочь: мог можете могли могут могло
мощный: мощные мощной
мрак: мрака
муж: мужа
мужской: мужского
мужчина: мужчина мужчины
мумия: мумия
мурлыкать: мурлыкать
мусор: мусором
мусорщик: мусорщик
мы: нами нам
мыслительный: мыслительные
мышь: мыши мышей
мягкий: мягкие мягчайшего
мясистый: мясистые
мясо: мясом мясо мяса
мяч: мяч
н: н
наблюдатель: наблюдателей
наблюдать: наблюдавших
наблюдаться: наблюдалось
наблюдение: наблюдение
набор: набор
навигация: навигации навигация
наволочка: наволочкой
навсегда: навсегда
навык: навыками
наглядно: наглядно
нагота: наготу
над: над
надежда: надежды
надеяться: надеялась надеясь
надлежащий: надлежащем
надувной: надувной
наездник: наездника
наесться: наевшегося
назад: назад
название: названия названием название
названый: названы названа
назвать: назвала назвать названный
наземникус: наземникус
назойливый: назойливых
называть: называли
называться: называется
наиболее: наиболее
наименее: наименее
найти: найти найден
накидка: накидку
накинуть: накинуть
наклониться: наклониться
наличие: наличием наличию наличии
наложить: наложенным
намеренно: намеренно
нанести: нанести
нападать: нападают нападать нападает нападающего
нападение: нападении нападение
напасть: напасть напал
наподобие: наподобие
наполнить: наполненного
напольный: напольных
напоминать: напоминающим напоминающей напоминает напоминающими напоминают напоминающий
направить: направить
направление: направление
например: например
наргл: наргл
наргла: наргла
нарицательный: нарицательного
нарл: нарл
нарла: нарла
нарлом: нарлом
нарлу: нарлу
народ: народ народа народу
нарост: нарост
наружность: наружности
наружу: наружу
нарядный: нарядно
насекомое: насекомое насекомых насекомыми
населять: населяют
насколько: насколько
насладиться: насладиться
наследник: наследником наследник
наследственный: наследственные
наследство: наследству
насмерть: насмерть
настойка: настойка
настойчиво: настойчиво
настолько: настолько
настоящее: настоящим настоящего
настоящий: настоящую настоящий
настроить: настроенных
наступить: наступит
насчитывать: насчитывало
натянутый: натянутыми
научиться: научился
находить: находят находит находить
находиться: находится находилась
нация: наций
начало: начале
начать: начали
начинание: начинания
начинать: начинает
начинка: начинку
наш: наших наш наши
нашествие: нашествиями нашествий
небольшой: небольшого невелика небольшое небольших небольшая
невероятный: невероятной
невидимка: невидимок
невидимый: невидимы невидимым невидимыми
невилл: невилл
невинность: невинности
невинный: невинных
невозможно: невозможно
недавно: недавно
неделя: недель недели
недостаток: недостатков
недостаточно: недостаточно
недостоверный: недостоверный
недоступный: недоступные недоступная
недоумевать: недоумевающих
независимость: независимости
независимый: независимое независимых
незадачливый: незадачливому
незначительный: незначительны
неизвестно: неизвестно
неизвестный: неизвестное неизвестна
неимоверный: неимоверную
нейтрализовать: нейтрализован
нейтралитет: нейтралитет
некий: некий
некогда: некогда
некоммерческий: некоммерческой
неконтролируемый: неконтролируемыми неконтролируемо
некоторые: некоторых некоторые
некоторый: некоторое некотором
нелетающий: нелетающая
нельзя: нельзя
немедленно: немедленно
немецкий: немецким
немногие: немногих
немой: нем
ненавистный: ненавистного
ненаходимые: ненаходимые
ненаходимым: ненаходимым
необитаемый: необитаемых
необходимо: необходимо
необходимый: необходимые
необъяснимый: необъяснимые
необычайно: необычайно
необычно: необычно
необычный: необычное необычный необычна
неодобрительно: неодобрительно
неожиданный: неожиданных
неопр: неопр
неосторожный: неосторожных
неотличимый: неотличим
неохота: неохотой
неплохо: неплохо
непобедимый: непобедимый
неподвижный: неподвижна неподвижным
неполный: неполный
непомерный: непомерную
непрерывный: непрерывным
неприязнь: неприязнь
неприятность: неприятности
непропорциональный: непропорционально
непрямой: непрямой
нередко: нередко
несколько: нескольких несколько
несмотря: несмотря
несознательный: несознательных
несоразмерный: несоразмерно
неспокойный: неспокойной
несс: несс
несчастие: несчастье
несчастная: несчастным
несчастный: несчастный
неудачливый: неудачливой
неудачный: неудачного
неудивительный: неудивительно
неудовольствие: неудовольствия
неуправляемый: неуправляемый
нечто: нечто
нижний: нижней
низкий: низкую ниже низкий
ника: ника
никакой: никакой
никнуть: ник
никогда: никогда
никто: ником никто никому
нимфадора: нимфадора
нимфадоры: нимфадоры
ниоткуда: ниоткуда
нисколько: нисколько
ниша: ниши
новозеландский: новозеландский
новый: новой новые новых
нога: ногами ногах ног ногой ноги ногу
ножка: ножки ножками ножек
ноздря: ноздрей
нона: нон
нора: норы норах нору
норберт: норберт норберту
норвегия: норвегии
норвежский: норвежский
нордфолке: нордфолке
нормальный: нормальную
норрис: норрис
нос: нос носу
носить: носить носили
носорог: носорогом
нотт: нотт
ночь: ночам ночью
нрав: нравом
нравиться: нравятся нравящийся
нужно: нужно
нужный: нужным
нунду: нунду
ныне: ныне
нынче: нынче
ныряльщик: ныряльщиков
нырять: ныряет
ньют: ньют
нюхлер: нюхлер
об: об
оба: оба
обворожительный: обворожительную
обглодать: обглоданным
обезьяна: обезьяной обезьян обезьяну обезьяна
оберегать: оберегаемого
обеспечение: обеспечения
обеспечивать: обеспечивает
обесчестить: обесчестил
обидчик: обидчика
обитание: обитания
обитатель: обитателей
обитать: обитающим обитает обитают обитающего обитала обитающая обитающее обитающий
обладание: обладания
обладатель: обладатель
обладать: обладающее обладает обладают
облако: облаке
облик: облик облике
обличие: обличии
обман: обманом
обнаруживать: обнаруживали обнаруживает
обнаружить: обнаружен обнаруживший обнаружены обнаружить
обновлять: обновлять
обожать: обожает
оборотень: оборотень оборотня оборотни
оборотничество: оборотничество
оборотный: оборотное оборотного
обосноваться: обосновался
образ: образом образе
образованность: образованность
образовать: образуешь
обратить: обратить
обратиться: обратятся
обратный: обратном
обращаться: обращаются
обращение: обращения
обретать: обретают
обстановка: обстановке
обсуждение: обсуждение обсуждения
обтянуть: обтянутый
обучать: обучать обучал
обучение: обучения обучении
обхватить: обхватит
обходиться: обходятся
общаться: общаются
общество: общество
общий: общую общее
общительный: общительные
объединиться: объединившимися
объект: объектах объект объекте
объективный: объективно
объяснять: объясняемую
объясняться: объясняются объясняется
обыкновение: обыкновение
обыкновенный: обыкновенный обыкновенным
обычно: обычно
обычный: обычных обычный
обязанность: обязанности
обязательно: обязательно
обязать: обязаны обязан
овца: овцы овцами овец
оглушать: оглушающим
оглушительный: оглушительные
оглянуться: оглянется
огневица: огневица
огнедышащий: огнедышащий
огненный: огненных огненные огненными огненный огненного огненной
огонь: огне огонь огня огню
огра: огра
огреть: огрел
огромный: огромными огромный огромного огромные огромных огромную огромной огромное
огурец: огурец
одежда: одежду одеждой одежде одежды
один: одну одной одна одном одного один одно одним
одинаково: одинаково
одиннадцатый: одиннадцатый
одиночка: одиночку
однако: однако
одновременный: одновременного
одноклассник: одноклассников
одноногое: одноногое
одомашнить: одомашненные одомашнили одомашнена
ожидание: ожидании
ожидать: ожидаю
ожоговый: ожогов
озвучивать: озвучивает
озеро: озере озера
означать: означающее означало означающая означает
озорник: озорников
оказать: оказать
оказаться: окажется оказался
оказывать: оказывает
оказываться: оказывается
окаменеть: окаменеть
оканчиваться: оканчивается
океан: океане
оккамии: оккамии
оккамий: оккамий
около: около
оконечность: оконечности
окончание: окончание
окрас: окрас
окрасить: окрашены
окраска: окраски окраску окраска
окрестность: окрестностях
окружать: окружающих
окружить: окружили
окружность: окружности
олень: оленями олень оленя
олливандер: олливандер
омар: омара
омела: омеле
омут: омуте
он: нему
она: ею
они: им ими них ними
оно: оно
опаловый: опаловый опалового
опасность: опасность опасности
опасный: опасных опасные опасен опасное опасным опасна опасный опасны опаснее
оперение: оперения оперением
описание: описание описании
описывать: описывает описываемых
описываться: описывается
оплакать: оплакать
оповестить: оповестить
оправдать: оправдано
опрометчивый: опрометчиво
опускаться: опускается
опустошить: опустошить
опухоль: опухоль
опыт: опытом
опытный: опытный опытному опытных опытные опытными
орангутанг: орангутанга
оранжевый: оранжевая оранжевой
орган: органов
организация: организации
орден: ордена орден
орел: орла
оригинал: оригинал
орлиный: орлиные
оружие: оружие оружием оружия
освободить: освободить освободил
освобождаться: освобождается
освобождение: освобождение
ослепительно: ослепительно
ослушаться: ослушаться
основа: основе
основатель: основателя основатель
основать: основанные
основное: основном основным
основной: основной основная
особенно: особенно
особенность: особенностью особенности
особенный: особенным
особый: особое особей особым особых особые особую
особь: особь особи особями особям
осознание: осознанию
осознать: осознав
оставаться: остаются оставаться
оставить: оставленный оставить оставленного
оставлять: оставляя оставляют оставляет
остальное: остальные остальное
останавливать: останавливать
остаться: осталось оставшийся
осторожно: осторожно
остров: остров острове
остроклювый: остроклювую
острый: острыми острые острых острый
осуществлять: осуществляемый
отбиваться: отбиваться
ответ: ответом ответ
ответить: ответить
ответственность: ответственности
ответственный: ответственного
отвечать: отвечают
отгадывать: отгадывать
отговорить: отговорить
отдел: отдел отдела отделе
отделаться: отделаться
отделение: отделениях
отдельный: отдельной отдельных отдельные
отец: отца отцом
отказ: отказ
отказаться: откажутся
откладывать: откладывают откладывает откладывать
открыть: открытую
откуда: откуда
откусить: откушенной
отлив: отливом
отличать: отличает
отличаться: отличаться отличается отличаются
отличие: отличие
отличительный: отличительной отличительные отличительным
отличить: отличить
отличный: отличные
отлов: отлову
отловить: отловить
отменный: отменные
отменять: отменяйте
отместка: отместку
отметина: отметинами
отметить: отметить
отнести: отнесены
отнимать: отнимающее
относительно: относительно
относиться: относится относятся
отношение: отношения отношению отношений отношении отношениях отношение
отогнать: отогнать отогнал
оторвать: оторванная
отпечаток: отпечаток
отправить: отправили
отправиться: отправился
отправляться: отправляется
отпугивание: отпугивания
отражать: отражает
отразить: отразить
отрастать: отрастают
отредактировать: отредактирована
отрицательно: отрицательно
отрубать: отрубающего
отряд: отряда отряд
отступник: отступника
отсутствовать: отсутствуют отсутствующей
отсюда: отсюда
отталкивать: отталкивающую отталкивающих
отцовский: отцовским
отчасти: отчасти
отчаяние: отчаяния
отчаянно: отчаянно
охватить: охватит
охота: охота
охотиться: охотились охотится
охотно: охотно
охрана: охраны
охранник: охранников охранники
охранять: охранявшие охраняемый охранять охраняющих охранял охраняющее охраняя охраняют охраняемым
оценить: оценена
очаровать: очаровать
очевидно: очевидно
очень: очень
очередной: очередную очередной
очередь: очередь
ошибка: ошибке
ошибочно: ошибочно
ощутимый: ощутимые
п: п
павлин: павлин павлина
падеж: падеже
палец: пальцы пальцами пальца
палочка: палочек палочками палочки
память: памяти память
пантера: пантера
панцирь: панциря панцирем панцири
пар: пары пару
паразит: паразиты паразитами паразит
парвати: парвати
парить: парить
парк: парк
пародия: пародии пародия
парусник: парусник
паря: пари
пасть: пасти
патил: патил
патока: патоку патока
патронум: патронум
патронус: патронус
патронуса: патронуса
патронусов: патронусов
патронусы: патронусы
паук: паук пауки пауками
паутина: паутину
певица: певицы
пение: пения пение
пепел: пепел пепла
пепельный: пепельный пепельного
пеплозмей: пеплозмей
пеплозмея: пеплозмея
первое: первого
первоначальный: первоначальный
первый: первой первую первый
перебить: перебили
перебросить: перебросив
переваривать: переваривает
перевод: переводах переводе перевод
переворот: перевороте
перед: перед
передавать: передавать
передать: передали
передача: передачи
передвигаться: передвигается передвигающийся передвигаются
передневать: переднюю
передний: передние передних
передозировка: передозировка
переживанье: переживаний
переименовать: переименовали
перейти: перейти перешедших
переклассифицировать: переклассифицировать
перемена: перемены
перемещаться: перемещаться
перемещение: перемещением
перенаправить: перенаправлено
перенос: переноса
переносить: переносить
перенять: перенять
переодеться: переодевшихся
переполнить: переполненные
перепончатый: перепончатыми перепончатые
перепуганно: перепуганно
перепугать: перепуганные
перепутать: перепутать
переросток: переростка
переть: при
переулок: переулке
перехватываться: перехватывается
перец: перец
период: периода
перманентный: перманентное
перо: перья перьях перьев пером перьями
перси: перси
персидский: персидский
персона: персоной
персонаж: персонаж персонажем персонажей персонажи
персональный: персональные
перуанский: перуанский
перчатка: перчатки
пес: псов
песнь: песнь песни
песня: песня
петух: петуха
печальный: печальными
печать: печати
печень: печень
пещера: пещеры пещере
пи: пи
пивзом: пивзом
пикси: пикси
питать: питающий питает
питаться: питающаяся питается питаются питаясь
питомец: питомца
питтиман: питтиман
пить: пьющему пить пьют
пища: пищи пищу
плавно: плавно
пламя: пламя пламени пламенем
планк: планком
пластик: пластика
плат: плату
плата: платой
платформа: платформу
плачевный: плачевны
плен: плен
плечо: плеч
плимп: плимп
плимпа: плимпа
плимпы: плимпы
плод: плод
плоский: плоским плоские плоскими
плотный: плотная
плотоядный: плотоядны
плоть: плоти
плохой: худшем
площадь: площадь
плюс: плюсы
побережье: побережье побережья
побочный: побочным побочный
поведение: поведении поведения
поверхность: поверхность поверхности
повсеместно: повсеместно
повстречать: повстречал
повсюду: повсюду
повышать: повышающих
повышаться: повышается
повязка: повязки
погибать: погибает
поглощать: поглощая поглощать
поглощение: поглощения
поголовье: поголовье
погрузить: погруженный
погрузиться: погрузится
подарить: подаренная
подвигнуть: подвиг
подводный: подводный
подготовить: подготовленных
подгребин: подгребин
подгребина: подгребина
подгребинов: подгребинов
подгребину: подгребину
поддаваться: поддаются
поддерживать: поддерживает поддерживать
поддержка: поддержки
поджарить: поджарить
подземелье: подземелья
подкинуть: подкинул
подлежать: подлежащие
поднести: поднести
поднимать: поднимали
подножка: подножки
поднять: поднял
подобный: подобные подобную подобными
подобраться: подобрался
подозревать: подозревающим подозревающую подозревая
подойти: подойти
подпушка: подпушкой
подразделение: подразделения подразделение
подразумеваться: подразумевается
подробный: подробнее
подставлять: подставляя
подходить: подходит подходящим подходить
подчинять: подчиняющее
поедание: поедания
поедать: поедает
поезд: поезда
пожаловать: пожалуй
пожертвовать: пожертвовать
пожиратель: пожирателям пожирателей пожирателем пожиратели
пожирать: пожирает
позади: позади
позволить: позволено позволит
позволять: позволяют позволяет позволяющие
позвоночный: позвоночными
поздний: позже
позиция: позиции
познакомить: познакомив
поиск: поисках поиск поиску
поймать: поймавшие поймана поймать
пока: пока
показать: показано
показывать: показывая
покинуть: покинуть
поклон: поклоном
поклониться: поклониться поклонится
поколение: поколения
покорить: покорить
покориться: покорился
покорный: покорным
покровитель: покровитель
покрывать: покрывающая
покрыть: покрыто покрытые покрыт покрытая покрыты
покупать: покупает
пол: пола
полагать: полагали полагают
полдюйма: полдюйма
поле: полях
полевой: полевых
ползать: ползают
ползок: ползком
ползти: ползти
политик: политика политике
полнолуние: полнолуние полнолуния
полностью: полностью
полный: полной полную полная полон
положение: положениям
положительный: положительная
поломка: поломки
полоса: полосами
полотенце: полотенцем
полтергейст: полтергейстах полтергейст
полувеликан: полувеликанов
полувидим: полувидим
полувидима: полувидима
полукровка: полукровка
полулюдям: полулюдям
полумна: полумна
полумны: полумны
получать: получает получать получают получая
получаться: получаются
получить: получил получив получить
полый: полые
польза: пользу
пользоваться: пользуются пользовались пользовался пользуется
поляна: поляну
полянка: полянке
помесь: помесь
помешать: помешал
помещение: помещениях помещений
помочь: помочь
помощь: помощью помощи помощь
понадобиться: понадобиться
поначалу: поначалу
понимание: понимании
понравиться: понравиться
понятный: понятное
понять: понять поняла
попадание: попадания
попадать: попадают
попискивать: попискивающие
попробовать: попробовать
попросту: попросту
попугай: попугай
популярный: популярных популярной
популяция: популяция популяций
попытаться: попытался
попытка: попыткам
пора: пор
поработить: порабощенный
поражать: поражает
порасти: поросшие
порлок: порлок
порлоки: порлоки
порода: порода пород породы
породить: породивший
порождение: порождения
поросенок: поросят
порошок: порошок
портал: портал
порядок: порядка порядке
посадить: посаженные
посвятить: посвящена
поселиться: поселился
поскольку: поскольку
послать: посланных послал
последний: последнее последний последние последним
последствие: последствиями последствия
послушный: послушными
посмешище: посмешищем
посол: после
пост: пост
поставить: поставили
поставка: поставки
постепенно: постепенно
постоянно: постоянно
постоянный: постоянная постоянное
поступать: поступают
поступок: поступок
посылать: посылает
потеря: потеря потерю
поток: потоком
потомство: потомства потомство
потребоваться: потребоваться
потрясать: потрясающее
поттер: поттером поттер поттера поттеру поттере
потусторонний: потусторонние потусторонними
похищение: похищения
похлеба: похлеба
похоже: похоже
похожий: похожее похожий похожую похожи похожие похожих похожими похож похожа
поцеловать: поцелуешь поцеловать
поцелуй: поцелуя
почему: почему
почтить: почти
почувствовать: почувствует
пощипывать: пощипывать
поэтому: поэтому
появиться: появилось появился появиться
появление: появлении
появляться: появляются появляется
пояснять: поясняет
правда: правда правды
правильный: правильное
править: правило править
правка: правок правки
право: праву праве
правый: правой права правая право
практик: практику
практический: практически
пребывать: пребывая
превосходить: превосходят
превратить: превратили превратить превращена
превратиться: превратился превратившись
превращаться: превращаться превращаясь
превращение: превращений превращениями
преданность: преданность
преданный: преданы
предатель: предателя
предать: предал
предел: пределы
предзнаменование: предзнаменование
предложить: предложенный предложить
предмет: предметов предметы предмет предметом
предначертать: предначертанное
предоставляться: предоставляется
предполагаться: предполагается
предположительно: предположительно
предположить: предположит
предпочитать: предпочитает
предрекать: предрекает
предсказывать: предсказывает
представитель: представителей
представить: представить представлен
представиться: представились
представление: представление
представлять: представляют представляющий представляет
предупредить: предупредить
предупреждать: предупреждали
предупреждение: предупреждения
предыстория: предыстория
преждевременный: преждевременно
прежний: прежнему
преимущественный: преимущественно
преимущество: преимущество
прекрасный: прекрасный прекрасную прекрасные прекрасного
прекращать: прекращает
прелюдия: прелюдией
пренебрежительный: пренебрежительного
преподаватель: преподавателя
преподавать: преподавал
преследовать: преследовать
пресмыкаться: пресмыкающимися
преступление: преступлений
преуспеть: преуспели
приближаться: приближающихся приближаться
приближение: приближении
приблизиться: приблизиться
прибыть: прибудет
привезти: привезли привезена
приверженец: приверженцем
привидение: привидениями привидением привидения привидениях привидений
привлекать: привлекают привлекали привлекает
привлечение: привлечения
привлечь: привлечь
приводить: приводят
приворот: привороту
привычка: привычек
привязанность: привязанности
привязчивый: привязчивый
приглашать: приглашают
приготовление: приготовлении приготовления
приделать: приделаны
придира: придира
приезжать: приезжающими
приемлют: приемлют
прижимистый: прижимистые
приз: приз
приземистый: приземистое
признак: признаков признаком
признать: признал
призрак: призрак призраков призраком
прийтись: пришлось
приказ: приказа
приказание: приказание
прикосновение: прикосновении
прикрывать: прикрывают
приманить: приманить
применение: применение
применить: применил применить применено
применять: применять
применяться: применяется
пример: примеру
примереть: пример
примерный: примерно
примечание: примечания
примечательный: примечательна примечательную
примитивный: примитивное примитивной примитивным
принадлежать: принадлежащим принадлежащей принадлежат принадлежащих принадлежит
принимать: принимали принимает принимать принимают
приносить: принося приносят
принц: принц
принцип: принципе
принять: принял принявшей приняли приняты принявшего
приняться: примется
приписка: приписка
приписываться: приписывается
природный: природная
приручение: приручению
приручить: приручить
прислать: пришли
присматривать: присматривают
присмотр: присмотра
присоединяться: присоединяются
присоска: присоски
приставить: приставила
приставка: приставка
пристраиваться: пристраивается
пристрастие: пристрастие
приступ: приступ приступы
присутствие: присутствие
присылать: присылает
притеснять: притесняемого
прихватить: прихватить
приходиться: приходится
причина: причине
причинять: причиняли причинять
причислить: причислены
приятный: приятный
пробивать: пробивают
пробираться: пробираясь
проблема: проблемы
проверить: проверенной
проверка: проверки
проверяться: проверялась
провести: провести
проворный: проворней
провоцировать: провоцировать
прогнать: прогнать
программа: программа
программный: программного
прогрызать: прогрызая
продавать: продаваемых
продаваться: продаются
продажа: продажи продаже продажу
продвигаться: продвигаются
проделывать: проделывать
продолжительный: продолжительный
проект: проектах проекту
проекция: проекция
прозелень: прозеленью
прозрачный: прозрачными
произведение: произведения произведении
производитель: производителей
производить: производящее
производство: производство производства
произнести: произнести
произойти: произойти произошла произошло
происходить: происходит
пройти: прошла пройти прошло
проказа: проказы проказам
проклясть: проклятое
проклятие: проклятий проклятием проклятиям
проливной: проливной
пролиться: пролилось
проникать: проникать
проникнуть: проникнув
проникнуться: проникнувшись
пропеллер: пропеллера
проползать: проползает
пропустить: пропустила пропустил
прорицание: прорицаний
просачиваться: просачиваться
просить: просили
просматриваться: просматривается
просмотр: просмотры
просто: просто
простой: простого проще
простоять: простой
пространство: пространства
просьба: просьбе
против: против
противиться: противились
противник: противник
противный: противную противных
противопоставлять: противопоставляющий
противостоять: противостоять
противоядие: противоядия противоядием противоядие
протыкать: протыкает
протяжение: протяжении
профессия: профессии
профессор: профессором профессор профессору
прохождение: прохождения
процветать: процветала
процесс: процессе
прочий: прочих прочее
прочность: прочностью
прочный: прочную
проявляться: проявляющийся проявляется
пруд: прудах
прыгать: прыгая
прямая: прямым
прямой: прямо прямого
прятаться: прячутся прячется
птенец: птенца
птица: птицами птица птиц птицы
птичий: птичью
публика: публики
пугать: пугать пугающей
пугливый: пугливое
пульсировать: пульсирующий
пунцовый: пунцовые
пурпурный: пурпурные
пускать: пускает
пустой: пустой
пустула: пустула
пустынный: пустынное
путать: путают путать
путеводитель: путеводитель
путник: путников
путь: путь пути
пуффендуя: пуффендуя
пух: пуха
пухлый: пухлым
пушистика: пушистика
пушистики: пушистики
пушистиков: пушистиков
пушистый: пушистым
пшеничный: пшеничных
пылать: пылает
пылесос: пылесос
пыль: пыль
пытаться: пытаются пытался пытается пытались
пьяный: пьяная
пята: пятам пятой
пятилап: пятилап
пятиног: пятиног
пятиногих: пятиногих
пятка: пятки
пятнадцать: пятнадцати
пятнистый: пятнистый пятнистым
пятно: пятнами пятна
пятый: пятом
пять: пять
пятьдесят: пятидесяти
пятьсот: пятисот
р: р
раба: рабы
раболепие: раболепием
работа: работам работы работу
работать: работают работал
рабство: рабстве рабства
ради: ради
радость: радостью
радужный: радужной
раз: разу
разбиться: разбился
разве: разве
разведение: разведению разведения разведение
развитие: развития
развлекаться: развлекается
разводить: разводить
развязать: развяжет
разгадывать: разгадывает
разгневать: разгневанная
разгноминирования: разгноминирования
разговаривать: разговаривать
раздавить: раздавить
раздвоить: раздвоенными раздвоенного раздвоенные
раздражар: раздражар
раздражаров: раздражаров
раздражару: раздражару
раздражары: раздражары
раздразнить: раздразнить
различить: различить
различный: различные различных
размер: размеры размерам размер размером размерах размеров
размножаться: размножаясь
размышление: размышлению
разнаваждения: разнаваждения
разница: разница разницы
разновидность: разновидностей разновидность
разнообразный: разнообразную
разноцветный: разноцветными разноцветные
разный: разных разные
разогнать: разогнать
разработчик: разработчики
разрешение: разрешение разрешения
разрушительный: разрушительными
разрываться: разрывается
разряд: разряду
разум: разумом
разумный: разумен разумные
разъедать: разъедает
разыскивать: разыскивал
район: район
ракообразный: ракообразными
рамора: рамора
раморы: раморы
ран: ран
рана: раны рану
ранее: ранее
раненый: раненом
ранний: раньше
рапорт: рапорту
раса: раса рас расу
раскрутить: раскрутив
раскрывать: раскрывает
раскрыть: раскрыть
располагать: располагающую
расположить: расположенном
распоследняя: распоследняя
расправа: расправу расправы
распределять: распределяющая
распределяться: распределяются
распространить: распространены
распространиться: распространился
распухнуть: распухшие
рассел: рассел
рассердить: рассержен
рассказ: рассказы
рассказывать: рассказывает рассказывал рассказывающие
рассмотрение: рассмотрении
рассориться: рассорились
расспрашивать: расспрашивает
расспрос: расспросы
расстояние: расстояние расстоянии
рассудок: рассудка рассудок
рассыпаться: рассыпается
растение: растения
расти: растущее растут
растительность: растительность
растительный: растительной
растопырник: растопырник
растопырники: растопырники
растянуть: растянутый
расцветка: расцветок расцветка
расценивать: расценивает
расширение: расширение
рачок: рачками
ре: ре
реагировать: реагируют
реакция: реакции
реалистичный: реалистичное
ребенок: детей детям
ребристый: ребристые
ребята: ребятах
ревун: ревуна ревунов ревун ревуном ревуны
регулирование: регулирования
регулярно: регулярно
редактор: редактором
реддл: реддл
редкий: редких редкие редкий редка редкое редкому редкой
редко: редко
резиновый: резиновые
резкий: резкий резко
результат: результат результате
река: реках реки
религиозный: религиозные
ремесленник: ремесленники
реплика: реплик
репутация: репутацию
речной: речном
речь: речь речью
решение: решений решения
решительный: решительным
риддикулус: риддикулус
римус: римус
римуса: римуса
рисковать: рисковать
рисунок: рисунком рисунок
рог: рогом рога рог рогами
рогатый: рогатый
род: рода
родина: родине родиной родина
родины: родины
родиться: родившийся
родом: родом
родственник: родственников родственником
рождаться: рождаются рождается
рождение: рождения рождение рождении
рождественский: рождественские
рожок: рожки
розоватый: розоватые
розовый: розовой
розыгрыш: розыгрышам
роман: романов
рон: рону рон
ронан: ронан
ронана: ронана
ронять: роняет
россия: россии
рост: рост ростом роста
рот: рот ртом
роулинг: роулинг
рубеус: рубеус
рубеусом: рубеусом
рука: руке руку рука руки
румыния: румынии
румынский: румынский
рунослед: рунослед
руноследа: руноследа
руноследов: руноследов
руноследу: руноследу
русалиды: русалиды
русалка: русалка русалки русалками
русалочий: русалочьей
русалы: русалы
русский: русском русскому русский
рута: руты
руфусом: руфусом
ручка: ручки ручек
рыба: рыбой рыбы
рыбий: рыбьими рыбьей
рыбка: рыбка
рыжебородый: рыжебородый
рыжеватый: рыжевато
рыжеволосый: рыжеволосый
рыжий: рыжее
рынок: рынке
рысь: рысь
рычать: рычит
рэйем: рэйем
ряд: ряда рядом
саван: саван
сад: саду садах сада сад
садовый: садовый садовые садовым
салазара: салазара
саламандер: саламандер
саламандра: саламандры саламандра
салат: салат
сам: самого самой самом сами самими сама самое
самец: самцов самцу самцы самца
самка: самок самки самка самку
самовозгораться: самовозгорается
самоисцеляться: самоисцеляться
самоопределение: самоопределением
самостоятельно: самостоятельно
самый: самую самый самым самыми самых самые
сантиметр: сантиметров см
сапфировый: сапфирового
сарай: сараях
саундтрек: саундтрек
сбрасывать: сбрасывает
сварливый: сварливы
сварль: сварль
сведение: сведения
свежий: свежей свежие
сверкающий: сверкающее сверкающий сверкающими сверкающие
свернуться: свернувшимся
сверхъестественный: сверхъестественной
света: свет света свете свету
светло: светло
светящийся: светящимися светящиеся светящихся
свидетель: свидетелем
свинарник: свинарник
свиной: свиней
свиноматка: свиноматке
свирепость: свирепости
свирепый: свирепы свирепые
свободно: свободно
свободный: свободными свободной
сводить: сводит
свое: своих свои своего своим
своеобразный: своеобразным своеобразного
свой: свой своей свою
свойство: свойствами свойство свойства
связанный: связанные
связаться: свяжитесь
связывать: связывает связывают
связь: связь
сгорать: сгорает
сгущение: сгущения
сдать: сдала
сделать: сделает сделан сделанных сделанную сделал
сделка: сделки
себя: собой
северный: северного северной
северус: северус
северуса: северуса
сегодня: сегодня
сегодняшний: сегодняшний
седрик: седрика седрик седрику
седьмой: седьмой
сей: сих
сейф: сейфы
сейчас: сейчас
секрет: секрет
секунда: секунды секунд
селестина: селестины
сельский: сельской
семейный: семейные
семь: семь
семья: семья семьях семье семьи
сердечный: сердечный
сердить: сердит
сердце: сердце
сердцевина: сердцевины
серебристый: серебристое серебристого серебристо
серебро: серебра
серебряный: серебряной серебряный серебряная серебряными
середина: середине
сериал: сериал
серия: серии серию серия
сероватый: серовато
серпентарго: серпентарго
серый: серым серый серая серого серой серо серое
сестра: сестры
сжечь: сожгут
сжиматься: сжиматься
сивилла: сивилла
сидеть: сидели
сила: силу силой сила силами силы
сильнейший: сильнейшее
сильный: сильнее сильная сильно сильному сильную сильный сильна сильными сильное сильных сильные сильны
симпатичный: симпатичный
симпатия: симпатией
симус: симус
симуса: симуса
синий: синего синяя синие
сирена: сирены
сириус: сириуса сириус
сирруш: сирруш
система: системе
сказать: сказано
сказка: сказки
скалистый: скалистых
скандинавия: скандинавии
скандинавский: скандинавские скандинавских
скачать: скачать
сквозь: сквозь
скелет: скелет
складный: складным
склонение: склонению
склонность: склонность
склоняться: склоняется
скользить: скользит
скользкий: скользкого
сколько: сколько
скопидом: скопидомы
скорбеть: скорбящая
скорлупа: скорлупа скорлупу
скоро: скоро
скорость: скоростью скорость
скорпион: скорпиона скорпионов
скорый: скорее скор скорей
скрежет: скрежет
скрещиваться: скрещиваться скрещиваются
скримджером: скримджером
скромный: скромен
скрываться: скрываться скрывается
скрытый: скрытыми скрытый скрытые
скрыться: скрыться
скульптура: скульптуры
скучечерви: скучечерви
слабнуть: слаб
слабоумие: слабоумие
слабый: слабой слабые
слава: славой
сладкорогий: сладкорогий
след: след следа
следовать: следует следуют
следующий: следующему следующим следующих
слизерина: слизерина
слизнорт: слизнорт
слизнорту: слизнорту
слизывать: слизывают
слизь: слизью слизь
слишком: слишком
слово: словам слову слова слово
словом: словом
слог: слог
сложить: сложив
сложно: сложно
сложность: сложностью
сложный: сложные сложная
сломать: сломать
служебный: служебные
служилый: служило
служить: служит
слух: слухам
случай: случая случае случаях случай случаи
случайно: случайно
случайный: случайная
случаться: случается
слушание: слушания
слушатель: слушателя
слушать: слушать
слышать: слыша слышал
слюна: слюны
смачиваться: смачиваются
смеркут: смеркут
смеркутов: смеркутов
смертельный: смертельным
смертоносный: смертоносный
смертофалд: смертофалд
смерть: смертью смерть смерти
смех: смех
смешанный: смешанных
смирный: смирный
сморщенный: сморщенными
смотреть: смотреть
смочь: сможет смогут смог
смуглый: смуглой
смысл: смысле
снадобье: снадобий
сначала: сначала
снег: снег
снегг: снегг
снегга: снегга
снежный: снежная снежных снежного
сниджет: сниджет
сниджета: сниджета
сниджетов: сниджетов
снизу: снизу
снитч: снитч
снова: снова
сносорог: сносорог
снять: сняли
собака: собак собаки
собираться: собираются собирались
собрать: собрать
собственность: собственностью
собственный: собственных собственному собственное собственного
событие: события событий
сова: сова сов совам
совершенно: совершенно
совместный: совместным
современный: современных
согласно: согласно
согласный: согласен
содержание: содержание
содержать: содержавших содержат содержит
содержаться: содержащийся
сожрать: сожрать
созвучный: созвучно
создавать: создают создавать
создание: создания созданиями созданий создание
создатель: создателя
создать: создала создан создавшего создать
сократить: сократила сократить
сократиться: сократилась
сокращать: сокращает
сокровище: сокровищ сокровища
сокровищница: сокровищницы
сокрытие: сокрытия
солнце: солнца
солома: соломе
сомнение: сомнения
сомнительный: сомнительных
сон: сне
сообщать: сообщающая сообщает
сообщение: сообщений сообщения
сообщество: сообщество
сообщить: сообщить
соответственно: соответственно
соплохвост: соплохвост
соплохвостов: соплохвостов
соплохвосты: соплохвосты
сопротивление: сопротивление
сопротивляемость: сопротивляемость
сопротивляться: сопротивляются
сородич: сородич сородичами
сорок: сорока
сосед: соседи
состав: состав составе
составить: составленное
составлять: составляет
состояние: состояние состоянии
состоять: состоящее состоящий состоящая состоит
состязание: состязания
сотня: сотни
сотрудник: сотрудников
сотрудничество: сотрудничества
сотрясение: сотрясением
сохранение: сохранения сохранением
сохранить: сохранили
сохраниться: сохранились
сохранять: сохраняют сохраняет
сочетаться: сочетается
сочный: сочными
союз: союзов
спальня: спальни спальне
спаривание: спариванию
спас: спас
спасать: спасают
спасти: спасший спасти
спать: спящих
спереди: спереди
спесивый: спесивые
специалист: специалистов
специальный: специальную специально специальное
спешить: спеша
спина: спину спине
спинорог: спинорога спинорог спинороге
список: список
сплюснутый: сплюснутые
спокойный: спокойном
сполна: сполна
спора: споры
способ: способом
способность: способностью способностей способности способность способностями
способный: способно способна способные способны способен
способствовать: способствовало
справиться: справиться
справка: справка
спровоцировать: спровоцировать
спрос: спросом
спросонья: спросонья
спустя: спустя
сравнение: сравнению
сражение: сражений
сразу: сразу
среди: среди
средиземный: средиземном
средневековье: средневековья
средний: средних средняя среднее среднем средней
средство: средство
срок: срок
срочный: срочно
ссылка: ссылка ссылки
стадий: стадии
стадо: стадо стада
стальной: стального
стандарт: стандартам
становиться: становятся становится становясь становиться
станция: станции
стараться: старалась стараются стараясь старались
старинный: старинным
старое: старого старых
старость: старости
старческий: старческое
статистика: статистика
стать: стал стать стали
статья: статью статья статьи
ствол: стволы
стеклоп: стеклоп
стен: стены стену
стенка: стенках
степень: степени
сто: ста
стоить: стоят стоит
стойкий: стойкая
столетие: столетий
столь: столь
стон: стоны
сторожевой: сторожевых
сторона: стороны стороне
сторониться: сторонятся
сторонник: сторонник сторонников
стоять: стоял
страдать: страдающий
страна: страны
страница: страницы страница страницу странице
странный: странно странными странный
стратег: стратег
страх: страха страх
страшилище: страшилище
страшно: страшно
страшный: страшным страшного страшны страшное
стрела: стрел стрела стрелы
стрелять: стрелять
стремительный: стремительный
строгий: строгий строгого строго
струить: струю
струйка: струек струйки
струп: струпьями
струя: струй
ступня: ступни ступнями
субстанция: субстанция
судебный: судебного
судилище: судилища
судить: судя
судно: суда
судьба: судьба
суеверие: суеверие
сукохвост: сукохвост
сумасшедший: сумасшедший
сумка: сумку сумки
сумочка: сумочки
сустав: суставам
сутки: суток
сухой: сухую
сухопутный: сухопутных
суша: суше
существенный: существенную
существительное: существительным
существо: существо существ существом существа существам существами
существование: существовании
существовать: существуют существует
сущий: сущего
сущность: сущности сущностью сущность
сфинкс: сфинксы сфинкс сфинкса
сформироваться: сформировавшимися
схватить: схватить
сходить: сходит
сходство: сходство
счастливый: счастливые
счастье: счастья счастью счастьем
счесть: сочла
считаные: считаные
считать: считая считать считают
считаться: считается
съесть: съедят съесть
сыворотка: сывороток
сын: сын
сыпать: сыпь
сырой: сырым
сэр: сэр
сюда: сюда
сюжет: сюжета
табун: табун табунами табуна
тайна: тайнах
тайный: тайная тайны
также: также
таков: такова
таковой: таковой
такой: такой такое таким такого такая таких такие
танец: танцы танца
танцевать: танцует
тарантул: тарантул
тварь: твари тварями тварям тварей
твердолобик: твердолобик
текст: текст
текущий: текущие текущая
телесный: телесного телесные телесных телесный
телец: телец тельца
тело: тела тело телом
тем: тем
тема: тема темой
тематический: тематический
тембу: тембу
темнота: темноту
темный: темные потемнее
темпераментный: темпераментные
тенебрус: тенебрус
теневой: теневая
тень: тени
теодор: теодор
теплый: тепла
тереть: три
терпимый: терпимее
территория: территорию территория территории
терьер: терьер терьера
терять: теряя
тест: теста
течение: течение
тибо: тибо
тихий: тихом
тихомол: тихомол
тихонько: тихонько
товар: товары
товарный: товарный
толкать: толкая
толстый: толстым толстыми толстый толстые толстую
толща: толще
толщина: толщиной
томас: томас
тон: тона
тоненький: тоненьких тоненький
тонкий: тонкие тонких тонкой тонким тонкая
тонкс: тонкс
тонна: тонн
тонный: тонны
топероек: топероек
топеройка: топеройка
топеройки: топеройки
топь: топи
торговля: торговли торговля
торс: торс
торчать: торчащими торчат
тот: том тех те тот тому той
точно: точно
точный: точнее
трава: травы травой травами
травма: травм травму
травоядный: травоядным
традиция: традиции
трансгрессировали: трансгрессировали
трансгрессировать: трансгрессировать
требовать: требующие требуют
требоваться: требуются требуется
трелони: трелони
третий: третий
третье: третьем третьего
тридцать: тридцати
тритон: тритоны
трое: троих
троллей: троллей
тролль: тролль тролля тролли
тропический: тропическим
трубчатый: трубчатого
труд: труда
трудный: трудно
тряпица: тряпицей
трясина: трясину
тул: тул
туловище: туловище туловищем
тупорылый: тупорылого тупорылый
тур: туре
турнир: турнира турнире
тусклый: тусклой
тухлый: тухлой
тщеславный: тщеславными
тьма: тьме
тюрьма: тюрьму
тяжелейшим: тяжелейшим
тяжелый: тяжелее
тяжкий: тягчайшим
убедить: убедить
убежденный: убеждены
убивать: убивают убивающие убивает
убийство: убийства убийство убийств
убийца: убийце
убить: убил убили убить убьют
убогий: убогую
уважение: уважения
увеличиваться: увеличиваются
уверить: уверены
уверовать: уверовал
увести: увести
увидеть: увидев увидеть
углубление: углубление
угодно: угодно
угольный: угольно
угроб: угроб
угроза: угрозы
удаваться: удается
удаленный: удалена
удалить: удалить
удар: удар
удержать: удержать
удивительно: удивительно
удобрить: удобрить
удовольствие: удовольствием удовольствие
ужалить: ужаленные ужалит
уздечка: уздечку
узел: узел
узнаваемый: узнаваемым
узник: узник
уизли: уизли
уильямс: уильямса
уйти: уйти
указание: указанием
указатель: указатель
указать: указан
уклончивый: уклончиво
украдкой: украдкой
украина: украины
украинский: украинский
украсить: украшен
украшение: украшения
укреплять: укрепляющее
укромный: укромное
укус: укуса укус укусе укусы укусов
укусить: укушенного укусит укусить
улитка: улитка улиток
улья: ульи
ум: ума
умение: умением
уменьшаться: уменьшаются
уменьшить: уменьшил
умереть: умереть
умерший: умершего умерших
уметь: умеет умеют
умный: умное умные умнее
умственный: умственного
умывальник: умывальником
уникальный: уникальна
уничтожение: уничтожения
уничтожить: уничтожить
уносить: уносит
уныние: уныние
уорлок: уорлок
упасть: упав
уползать: уползает
упоминание: упоминаний
упоминаться: упоминающееся упоминаются упоминается
упорный: упорно
употребление: употребление
употреблять: употребляет употребляют
управлять: управлять
упырь: упырей упырь упырями
урик: урик
уровень: уровень уровню
урок: уроке уроки
усвоить: усвоил
усиливаться: усиливается
усилие: усилиям
ускользнуть: ускользнуть
условие: условий условия
условный: условного
услышать: услышанных услышаны услышать
успевать: успевает успевают
успешный: успешно
уста: уст
устойчивый: устойчивой
устранение: устранение
устрашать: устрашающей
уступать: уступают
утаскивать: утаскивает
утащить: утащил
утверждать: утверждает
утешить: утешить
утратить: утратив
утрачивать: утрачивает
ухватиться: ухватится
ухмылка: ухмылке
ухо: уши ушами ушах ухо
уход: уходу уход
участие: участие
участник: участниками
учебный: учебного
ученик: учениками
ушко: ушки
уэльский: уэльский
фамилия: фамилии фамилия
фантастика: фантастики
фантастический: фантастические
фасо: фасо
фасти: фасти
фвупер: фвупер
фвуперами: фвуперами
февраль: февраля
федерация: федерация федерацией
феникс: феникса феникс фениксов фениксом фениксы
феномен: феномен
ферма: ферма фермы ферме
фестрал: фестрал
фестрала: фестрала
фестралах: фестралах
фестралов: фестралов
фестралы: фестралы
фея: феи фей феями фея
фигура: фигуры
фиджи: фиджи
физический: физической
философский: философский философскому
фильм: фильм фильме фильмов
финниган: финниган
финнигана: финнигана
финч: финч
фиолетовый: фиолетовые фиолетовых
флетчи: флетчи
флинт: флинта
флоббер: флоббер
флобберчервей: флобберчервей
флобберчервь: флобберчервь
флоренц: флоренц
флэтчер: флэтчер
фокус: фокус
фонарник: фонарник
фонарь: фонарь
фонд: фонд
форма: форме форму формы
формировать: формируют
форум: форум
фоукс: фоукс
фоукса: фоукса
фред: фред фреда
фридвульфы: фридвульфы
функция: функцию
фут: фут фута
футляр: футляре
футовый: футов
фэнтези: фэнтези
х: х
хагрид: хагрид
хагрида: хагрида
хагридом: хагридом
хамелеон: хамелеона
характер: характером
характерный: характерный характерно характерные
хватка: хваткой
хвост: хвост хвоста хвостами хвосты хвостом хвосте
хвостовой: хвостовых
хвосторог: хвосторог
хвосторога: хвосторога
хвосторогу: хвосторогу
хедвиг: хедвиг
хедвига: хедвига
хедвиги: хедвиги
хедвигу: хедвигу
хелицеры: хелицеры
химера: химер химеры химера
хитрость: хитростью
хищник: хищника хищников хищник
хищный: хищные
хлюпнявка: хлюпнявка
хобби: хобби
хогвартс: хогвартс
хогвартса: хогвартса
хогвартсе: хогвартсе
хогсмид: хогсмид
ход: ход
ходьба: ходьбу
хозяин: хозяин хозяевам хозяину хозяина
холм: холмы
холод: холод
холодный: холодный
хорек: хорька
хоркламп: хоркламп
хорклампа: хорклампа
хорклампы: хорклампы
хороший: лучше хорошие лучшие лучшее
хорошо: хорошо
хотеть: хотят
хоть: хоть
хранитель: хранители хранитель хранителем
хранить: хранит
хребет: хребта
хрупкий: хрупкое
художественный: художественном
худой: худая
цвет: цвета цвет цветом
цветочный: цветочные
целиком: целиком
целый: целые
цель: целях цель целью цели
цементный: цементного
цена: цену
цениться: ценятся ценится
ценность: ценность
центр: центре
церемония: церемонию
церемонный: церемонная
цитировать: цитировать
чалый: чалая
чанг: чанг
чар: чары чар
час: час
частить: части чащу
частность: частности
часто: часто
часть: часть
часы: часов
чаща: чаще
чей: чью чьей чей
человек: человек человеку людьми человека людей люди людям
человекообразный: человекообразный человекообразную человекообразные
человечек: человечков человечки
человеческий: человеческой человеческую человеческое человеческий человеческого человеческом человеческие человеческих
человеческо: человеческо
чемпионат: чемпионат
черви: червей черви
червь: червь
чердак: чердаках
через: через
череп: черепом
черепаха: черепаху
чернила: чернилами
чернобородый: чернобородый
черноволосый: черноволосый
черный: черной
черта: чертой черты
чертик: чертики
честь: чести
четверо: четверо
четыре: четырьмя четыре
чешуйчатый: чешуйчатой чешуйчатые
чешуя: чешую чешуя
чжоу: чжоу
чизпафл: чизпафл
чизпафлов: чизпафлов
чизпафлы: чизпафлы
чин: чина
численность: численность
чистокровный: чистокровные
чистопородный: чистопородным
чистота: чистотой
чистый: чистейшего чисто
читатель: читателю
читать: читать
член: членов членами
чрезвычайный: чрезвычайно
чрезмерный: чрезмерное
чтобы: чтобы
чувство: чувства чувств чувство
чувствовать: чувствует чувствовать чувствуют
чудесный: чудесными чудесные
чудище: чудища чудище
чудо: чудо
чудовище: чудовищ чудовище
чудодейственный: чудодейственными
чужак: чужаков
шаблон: шаблонами
шаг: шагов шагом
шар: шар шара
шарада: шарады
шарить: шаря
шармбатон: шармбатон
шведский: шведский шведского
шелки: шелки
шелковистый: шелковистым
шерсть: шерстью шерсть
шестилетнего: шестилетнего
шесть: шесть шести шестью
шея: шеи
шина: шин
шип: шипов шипом шипы
шипение: шипением
шипучка: шипучки
широкий: широко широкий
широкоскулый: широкоскулый
шишковатый: шишковатые
шишуг: шишуг
шишугами: шишугами
шишуги: шишуги
шкаф: шкафу шкафах
школа: школу школы
школьный: школьного
шкура: шкура шкурой шкуру
шкурка: шкурки шкурка
шляпа: шляпу шляпа
шмидт: шмидт шмидта
шотландия: шотландии
шрам: шрамами
штат: штатах штат
штраф: штрафы
штырехвост: штырехвост
штырехвостов: штырехвостов
шум: шумом
шуметь: шумящий
шуршать: шуршать
шустрый: шустрое
шутка: шутки шуткам шутку
щеголять: щеголяют
щетина: щетиной
щит: щиты
щупальце: щупальца
э: э
эванс: эванс
эдип: эдип
экзамен: экзамена экзамены
экзаменатор: экзаменатора
экземпляр: экземпляр экземпляра
экологический: экологической
экспекто: экспекто
экспорт: экспорта
экспресс: экспресс экспрессе
эластичный: эластичного
электрический: электрических
элемент: элемент
элитный: элитным
эльф: эльф эльфа эльфов эльфу эльфам эльфами эльфы
эльфеек: эльфеек
эльфийской: эльфийской
эльфоподобное: эльфоподобное
эм: эм
эма: эма
энциклопедия: энциклопедии
эпоха: эпохи
эрклинг: эрклинг
эрклинга: эрклинга
эрклингами: эрклингами
эрклинги: эрклинги
эрни: эрни
это: этом это этому этим
этот: этой этими этих эта эту
эффект: эффект эффектом
эффективный: эффективным
юго: юго
южный: южной южных
явиться: явится
явление: явление
являться: является являются
явно: явно
яд: яд ядом
ядовитый: ядовиты ядовитые ядовитых ядовитый
ядозуб: ядозубов ядозуб
язык: язык языки языках языке языком
язычок: язычком
яйцо: яйца яйцами яйцо яиц
якорь: якорем
ямка: ямки
январь: января
японский: японский
яркий: яркого яркое ярким яркий яркая
ярко: ярко
яркополз: яркополз
яркополза: яркополза
ярый: ярый
ящерица: ящерицами ящерицу ящерица
ящик: ящике
