август: август августа
австралийский: австралийского
автор: автор
авторитетный: авторитетных
авторство: авторства
агент: агента агенту
агрессивный: агрессивными
адаптация: адаптации адаптацией адаптацию
администрация: администрация
адресовать: адресованные
азкабана: азкабана
айван: айван
академический: академической
актриса: актрисой актриса
акцентировать: акцентировал
алан: алана алан
алник: алник
алфавит: алфавиту
алхимик: алхимик
альбом: альбом
альбус: альбус
альбуса: альбуса
аманда: аманда
амер: амер
америка: америки
американец: американца
американский: американской американская американский американского американское
аналогичный: аналогичного аналогично
англ: англ
английский: английский английских английском
англия: англии
анджела: анджелы
анджелес: анджелесе
аниматроники: аниматроники
анимация: анимации
анна: анны
аннотировать: аннотированный
ансамбль: ансамбль
ансен: ансен
апрель: апреле апреля
аргус: аргус аргусу
арнольд: арнольда
артефакт: артефакт
архивировать: архивировано
архивный: архивная
архитектура: архитектуру архитектуры
архитектурный: архитектурных
аспект: аспектов
ассоциация: ассоциация
атака: атака
аттракцион: аттракционы
афиша: афиши афиша
баг: баг
балбес: балбесы
балл: баллов
банк: банком
бар: бар
барда: барда
бархат: бархата
бауэр: бауэр
бахтин: бахтин
безголовый: безголового безголовый безголовому
безобидный: безобидным
беларуская: беларуская
белла: белл
белые: белые
белый: белого
берардинелли: берардинелли
беседа: беседу
бесперебойность: бесперебойность
бессмертие: бессмертие
бесстрашный: бесстрашный
бесчувственный: бесчувственных
бета: бет
би: би
библиографический: библиографических
библиотека: библиотеке
биггерстафф: биггерстафф
бидля: бидля
билет: билетов
благоговейный: благоговейного
благодарение: благодарения
благодаря: благодаря
благоприятно: благоприятно
блеск: блеска
блестеть: блестящей
близкие: близких близкие близким
боб: боб
богема: богема
богословие: богословия
бодлианский: бодлианской
боев: боевой
бойяр: бойяр
больничный: больничном
больший: большим большая большие большую больше
большинство: большинство
большой: большом большой
бонусный: бонусные
боунс: боунс
брайан: брайан
бракнелле: бракнелле
братство: братство
бригада: бригад
бридж: бриджи
британец: британцу британец британцев
британский: британских британские британская британской британский британским
британско: британско
бритый: брит
бродить: броди
брэд: брэд
брэдли: брэдли
брюс: брюс
будущее: будущим
будущий: будущий
буклет: буклет
букля: буклю
бутылка: бутылок
български: български
быть: были
бюджет: бюджетом бюджет
вариант: вариантов вариант
ввиду: ввиду
вдохновение: вдохновения
вегаса: вегаса
век: века
великан: великан
великобритания: великобритания великобритании
великолепно: великолепно
верить: верящих
вернон: вернон
верноном: верноном
верность: верность
верный: верна верен
версия: версию версия версии
весить: весь
весна: весну
вести: вела ведущих ведущие ведущий вести
вестись: велись
ветер: ветром
вечер: вечером
взгляд: взгляд
взрослый: взрослых взрослые взрослый взрослого взрослыми взрослым
взять: взяв взяла
вид: виду вид виде
видение: видением видение
видеозапись: видеозапись
видеоигра: видеоигра
визуализация: визуализации визуализацией
визуальный: визуальные визуальных визуальной визуальными визуальный
вика: вики
викиданных: викиданных
викимедиа: викимедиа
викиновости: викиновости
википедии: википедии
википедия: википедия
викисклад: викисклад
викискладе: викискладе
викицитатник: викицитатник
викицитатнике: викицитатнике
викторианский: викторианском
вкатываться: вкатывается
вклад: вклад
включать: включая включающей
властелин: властелин
власть: власти
влияние: влияние
вместе: вместе
вне: вне
внешний: внешние внешний
внимание: внимание внимания
внутри: внутри
внучек: внучка
воедино: воедино
военный: военной
возвращаться: возвращается
возвращение: возвращение возвращения
возглавить: возглавить
возлюбить: возлюбленного
возможность: возможность
возможный: возможными
возникать: возникает
возникнуть: возникла
возродиться: возродившаяся
возрождение: возрождения
война: войны войн
войти: вошли войти
вокзал: вокзал вокзале
волан: волан
волос: волосы
волшебник: волшебником волшебника волшебников волшебнике
волшебный: волшебные волшебного волшебном волшебный
волшебство: волшебства
вольфганг: вольфганг
воображение: воображения
воплотить: воплотил
воплощать: воплощает
вопреки: вопреки
вопрос: вопрос вопросом
вор: воров
восемь: восьми
воскресенье: воскресенье
воскрешение: воскрешение
воспоминание: воспоминаниям
воспринять: воспринята воспринял
воссоздать: воссоздать воссоздан
восстановить: восстановить
восторженно: восторженно
восход: восход
впервые: впервые
впечатление: впечатление
впечатлившись: впечатлившись
впечатлились: впечатлились
впечатлять: впечатляющие
впоследствии: впоследствии
вражда: вражда
временами: временами
временить: времени
время: время
вроде: вроде
вручную: вручную
все: всему всех всем
всеять: всей
вследствие: вследствие
вслух: вслух
вспоминать: вспоминал
встретить: встречена
встреча: встречу встречи
встречать: встречает
второе: вторым втором второе второго
второй: второй
второстепенный: второстепенных
вуд: вуд
входить: входит
выбор: выборе выбор выбором
выбрать: выбрать выбрали выбран
выгладить: выглажен
выглядеть: выглядели
выдаваться: выдающийся
выдать: выданный
выдвигаться: выдвигалась
выделить: выделив
выжить: выжил
вызывать: вызывали
выигрывать: выигрывает
выйти: вышло вышел вышли
выкупить: выкупила
вынудить: вынужден
вынужденно: вынужденно
выпестовать: выпестованного
выполнить: выполнено
выпуск: выпуска выпуск
выпустить: выпущен выпущена
выразить: выразил
высказаться: высказался
высокий: высокий высоко
высоковольтный: высоковольтный
выстрел: выстрелы
выступить: выступил
выход: выход выхода
выходить: выходит
вялость: вялость
газета: газете
гайетт: гайетт
гарри: гарри
гейша: гейши
гель: гелями
георгианский: георгианский
гермиона: гермиона гермионы гермионой гермионе гермиону
героизм: героизме
героиня: героини героиню героиней
героический: героические
герой: героя
гигантский: гигантские гигантского гигантский
гиллиам: гиллиам
гиллиама: гиллиама
гильдия: гильдии
главное: главным главного главные главных
главный: главную главной
глаз: глаз
глостерский: глостерском
глянцевый: глянцевой
гоблин: гоблина гоблин гоблинов гоблинами
говард: говарду
год: году лет год годы годом года
голова: голове
голодный: голодных
голубой: голубыми голубые
гонсалес: гонсалес
горный: горный
госпиталь: госпиталя
гостиная: гостиную
готленд: готленд
грандиозность: грандиозностью
график: графики
графика: графикой
грейнджер: грейнджер
греметь: гремят
гремлин: гремлины
грим: грим
гринготтс: гринготтс
гринт: гринт
гринта: гринта
гринте: гринте
гриффиндор: гриффиндор
гриффиндора: гриффиндора
гриффитс: гриффитс
грохотать: грохочущей
грэм: грэм
грэмми: грэмми
гуд: гуд
гэмбон: гэмбон
давать: дающего давать
дадли: дадли
дадмэн: дадмэн
дадмэну: дадмэну
далеко: далеко
даллас: далласе
дальнейший: дальнейшем дальнейшим
дамблдор: дамблдор
дамблдора: дамблдора
дамблдором: дамблдором
дар: даров дары
даремский: даремском
дата: дата даты
датировать: датированы
дать: дали данный дала данного дал
даутфайр: даутфайр
два: два две двух
двадцать: двадцать
двенадцать: двенадцати
двигаться: движущейся двигающиеся
движение: движения движение
двухсотлетний: двухсотлетний
де: де
дебют: дебют
дебютант: дебютант
дебютировать: дебютировал
дебютный: дебютном
девочка: девочке
девять: девять
дейвид: дейвида
действие: действия действие действий
действительно: действительно
действовать: действовать
декабрь: декабря декабре декабрь
декан: деканом
декорация: декорации декораций
делать: делало
дело: деле
демми: демми
демонстрировать: демонстрирует
демонстрироваться: демонстрировался
денерстейн: денерстейн
день: дней дня дни
десять: десяти
деталь: деталей
детская: детской детским
детский: детский детском
деть: день
дж: дж
джанет: джанет
джедай: джедаи джедая
джей: джей
джейми: джейми
джеймс: джеймс
джейн: джейн
джек: джек
джексон: джексон
дженкинс: дженкинс
джеральдин: джеральдин
джим: джим
джин: джин
джоан: джоан
джозеф: джозеф
джон: джон джона
джонатан: джонатан
джонс: джонс
джордж: джордж
джоэл: джоэлом
джудианна: джудианна
джудианну: джудианну
джули: джули
диалог: диалоги
диана: дианы
дизайн: дизайн
дизайнер: дизайнера дизайнер
дилогия: дилогия
директор: директора
дистрибьютор: дистрибьютор
дитя: дитя
длительность: длительность
длиться: длилось длился
добавлять: добавлял
добрый: добрый
добыть: добыть
доверие: доверия
док: док
документальный: документальный
долгопупс: долгопупс
долгопупса: долгопупса
должен: должны должна должен
доллар: долларов
дом: дом
дома: дома
дополнение: дополнением дополнение
дополнительный: дополнительные
дополнить: дополнены
дополняться: дополнялись
дорогостоящий: дорогостоящей
дорожный: дорожных
доставлять: доставляет доставлять доставляют
достаточно: достаточно
достаться: достался достаться
достижение: достижение достижениям
достоинство: достоинством
достойный: достойным
доступный: доступен
дочь: дочь
др: др
драко: драко
дракон: дракона драконом
драма: драма
древность: древности
друг: другом
другой: другой другими другому другие других другого
дубль: дубли
думать: думаю думала
дурмстранг: дурмстранг
дурслей: дурслей
дурсли: дурсли
дурсль: дурсль
дурслям: дурслям
дурслями: дурслями
дух: духу дух
душ: душа
дуэль: дуэли
дырявый: дырявый
дьявольский: дьявольские
дэвид: дэвид
дэвис: дэвис
дэниел: дэниела дэниел
дядя: дядей
единица: единиц
единожды: единожды
единообразный: единообразный
единорог: единорога единороги
единственный: единственным
екатерина: екатерина
елизавета: елизаветы
естественный: естественное
жанр: жанры жанр жанра
желание: желании
железнодорожный: железнодорожной
женский: женском
жизнь: жизни жизнь
жуткий: жуткими
завершение: завершение
зависимость: зависимости
заглавный: заглавная
задаться: задался
задача: задачи
задействовать: задействовано задействован
заклинание: заклинанием заклинаний заклинание
заключаться: заключающуюся
заключительный: заключительной
заключить: заключили
законодательство: законодательства
закончить: закончена
зало: зал зале
заменить: заменит
заметить: заметил заметила заметив
замечательный: замечательном
замечать: замечает
замок: замке замок замка
занимать: занимал занимает
заниматься: занимавшихся занимались занималась
занятие: занятий занятии
занять: заняв
заняться: заняться
запираться: запирается
записать: записал
запись: запись записи
запланировать: запланированный
запоминаться: запоминающимся
запретный: запретный запретном
заприметить: заприметил
запустить: запущен
заработать: заработала заработал заработав
заранее: заранее
зарегистрировать: зарегистрированный
зарубежный: зарубежных
заслуга: заслугу
заслуживать: заслуживают
затем: затем
затерянный: затерянный
заткнуться: заткнуться
затылок: затылке
затянутый: затянута
захват: захвата
захватить: захватить
захватывать: захватывают
заходить: заходят
захотеть: захотел
зачисление: зачислении
зачислять: зачисляет
зачитать: зачитать
защита: защиты защите
защитный: защитных
защищать: защищал
заявить: заявив заявил
заявка: заявок
заявление: заявление
звезда: звезда
зверь: звери
звук: звука звук
здание: здание
зелье: зельями
зельеварению: зельеварению
злодей: злодеев
змея: змеи
знак: знак
знакомиться: знакомится
знаменитый: знаменитым
знание: знания
значение: значения
значимость: значимость
золото: золото
золотой: золотой
зоопарк: зоопарке
зоя: зои
зрение: зрения
зритель: зрители зрителя
зум: зум
иван: иван
игра: игра игр игрой игры
играть: игравших
игрок: игроков
игрушка: игрушек
идеально: идеально
идеальный: идеальным
идея: идеи
избранный: избранные
известный: известны известен известному
изготовить: изготовленный
издание: издания изданий
издать: изданном
изложить: изложил
изменение: изменения изменении
изменить: изменены
изменять: изменяющие
изначально: изначально
изображение: изображения изображение изображении
изобразить: изобразил
изучать: изучать
именно: именно
иметь: имел имела имеет
империя: империя
инвераилорт: инвераилорт
индиана: индиана
индивидуальность: индивидуальности
индий: индии
инопланетянин: инопланетянин
иностранный: иностранные иностранный иностранном
институт: института
инструмент: инструменты
инструментальный: инструментальная
интерес: интереса интерес
интересный: интересен
интернат: интернатов
инфракрасный: инфракрасных
ирландец: ирландцем
исключение: исключением исключениями
исключительно: исключительно
искусственный: искусственных искусственного искусственный
искусство: искусств искусства
исп: исп
исполнение: исполнением
исполнитель: исполнители исполнителей
исполнить: исполнил исполнили
исполниться: исполнилось
исполнять: исполнял
использование: использовании использования
использовать: использовал использовать использующие
использоваться: использовалась использовалось использовались
испускать: испускающий
испытание: испытании испытания
испытать: испытал
история: историей историю история истории
источник: источниками источнику источник
исходный: исходного
итог: итоге
иэн: иэн
июль: июля июле
июнь: июня июнь
йорк: йорке
йоркшир: йоркшире
йоханссон: йоханссон
кадр: кадр
кадровый: кадров
кадры: кадрах кадрами кадры
каждый: каждому каждого каждая
кажется: кажется
казаться: казался казаться
камень: камень камня
камера: камер камерами камерой
канада: канаде
кандидат: кандидатом кандидатами
кандидатка: кандидаток
кандидатура: кандидатуру кандидатуре
каникулы: каникулы
кантуэлл: кантуэлл
капать: капающей
кардинальный: кардинально
каро: каро
картина: картинах
карточка: карточки
карточный: карточная
карьер: карьера карьеру
кассир: кассир
кассовый: кассовыми кассовым кассовые
каста: касте
кастинг: кастинг
кастинга: кастинга
кастинге: кастинге
кастингов: кастингов
кастингом: кастингом
кастингу: кастингу
каталог: каталог каталогах
категория: категории категория
качество: качество качестве
квиддич: квиддич
квиддича: квиддича
квиддиче: квиддиче
квиддичем: квиддичем
квиддичу: квиддичу
квиррелл: квиррелл
квиррелла: квиррелла
квирреллом: квирреллом
квирреллу: квирреллу
кеннеди: кеннеди
кеннет: кеннет
кентавр: кентавром кентавры кентавр
кентерберийский: кентерберийский
километр: км
кинг: кинг
кингс: кингс
кинематограф: кинематографе
кинематографический: кинематографический кинематографической
кино: кино
киноадаптации: киноадаптации
киноакадемии: киноакадемии
киноверсии: киноверсии
киноиндустрии: киноиндустрии
киноискусство: киноискусства
кинокартина: кинокартины кинокартине кинокартина
кинокомпания: кинокомпании
кинокритик: кинокритик кинокритиков
кинолента: кинолента киноленты кинолент
кинопроба: кинопробами
кинотеатр: кинотеатре кинотеатрах
кинофраншиза: кинофраншиза
кирк: кирк
классический: классическую
клаудия: клаудия
клиз: клиз
клинтон: клинтон
кличка: кличке
кловис: кловис
кловиса: кловиса
кловису: кловису
клон: клонов
клоуз: клоуз
клуб: клуб
ключ: ключами ключе
ключевой: ключевых
книга: книг книги книгу книгой книгам книге книга
книжный: книжным книжного
ковчег: ковчега
когтевран: когтевран
код: код
кодекс: кодекс
коламбус: коламбус
коламбуса: коламбуса
коламбусом: коламбусом
коламбусу: коламбусу
колесо: колесо
колин: колин
количество: количество количестве
коллега: коллеге
коллекционный: коллекционная
колтрейн: колтрейн
колтрейна: колтрейна
кольцо: колец кольца
команда: команды команде
комедиантка: комедиантка
комедия: комедия
коммерциализация: коммерциализации
коммерческий: коммерческого коммерческий
комната: комнате комнат комната комнатой
компания: компания компанию компанией компаний компании
комплект: комплект
композитор: композитор композитором
композиция: композиция композиции композиций
компьютер: компьютере
компьютерный: компьютерного компьютерной
конец: конце
конечный: конечную конечном
конкурировать: конкурировала
коннери: коннери
консоль: консолей
конструктор: конструктор
консультант: консультанта
консультация: консультации
контакт: контактов контакты
контактный: контактные
контракт: контракт
контролировать: контролировала
контроль: контроль
конфиденциальность: конфиденциальности
конь: конь
копия: копии копия
копперфильд: копперфильд
коппингер: коппингер
коппингера: коппингера
копье: копий
коридор: коридоров коридор
корлисс: корлисс
королев: королевы
королевство: королевство
короткий: короткие короткий короткого
корпорация: корпорацией
космомагии: космомагии
косой: косой косом
костюм: костюм костюмам костюмов костюмы
кот: кот
который: которым которое которой которого которые которых которая котором который
кошка: кошки
крайний: крайней
крестовый: крестовый
крис: крис криса
критик: критиков
критика: критики критик критика критиками
кричать: кричащая
кровь: кровь
кроме: кроме
кросс: кросс
крупный: крупных
крыло: крыле
крэйг: крэйг
крэйга: крэйга
крюкохват: крюкохват
крюкохвата: крюкохвата
кто: кем
кубок: кубок
кузен: кузеном
кук: куки
кулир: кулир
купер: купер
кыргызча: кыргызча
кэмпбелл: кэмпбелл
кэти: кэти
лайонс: лайонс
ламберт: ламберт
ласа: лас
легато: легато
легто: легто
леди: леди
лейблы: лейблы
лейтмотив: лейтмотивы
лес: лесу лес
лесничий: лесничим
лестер: лестер
лестница: лестницей
летать: летающими летающих
летний: летние
лиама: лиама
либо: либо
ливрея: ливрее
лиза: лиза
лили: лили
лина: лина
линдер: линдер
линза: линзы
линия: линий
линкольн: линкольн
литературный: литературному
лицензия: лицензии
лицо: лица
лично: лично
личной: личную
лишение: лишениях
лишь: лишь
лоб: лбу
ловец: ловцом
ловить: ловит
логический: логической
лодка: лодках
локация: локаций локации
лондон: лондоне лондона
лондонский: лондонском лондонских
лос: лос
лоу: лоу
льюис: льюис
лэйн: лэйн
лэмонт: лэмонт
любимейший: любимейших
любить: любимая любимый
любой: любой
людоед: людоед
люк: люк
люпин: люпина
лягушка: лягушка
лязгать: лязгающей
м: м
магический: магического магических
магия: магия магию магии
маглами: маглами
магловском: магловском
магловскому: магловскому
маглы: маглы
мадам: мадам
мадлен: мадлен
майалл: майалл
майк: майк
майкл: майкл
макгонагалл: макгонагалл
макгуэн: макгуэн
макдональд: макдональд
македонский: македонски
макет: макетом
маккарти: маккарти
макмиллан: макмиллан
маковски: маковски
максимально: максимально
маленький: маленький маленькая
малфоем: малфоем
малфой: малфой
малфоя: малфоя
мальчик: мальчике мальчик мальчика мальчику
мамма: мамма
мантия: мантию мантии мантий
марк: марк
маркер: маркеров
маркетинг: маркетинг
марта: марта март марте марту
мартин: мартин
материал: материал материала
матч: матче
мать: мать матери
мачеха: мачеха
мая: мая
медиа: медиа
медиафайлы: медиафайлы
международный: международная
межфакультетский: межфакультетском
меллинг: меллинг
мелодия: мелодия
мемуары: мемуары
менее: менее
мера: мере мер
место: место местах места местом мест месте
месть: месть
месяц: месяцев месяцем
металл: металла металл
меткий: меток
метла: метлой метле
метод: методом метод
метр: метров
механический: механических
миллиард: млрд
миллион: млн
мина: мин
минерва: минерва
минервы: минервы
министерство: министерство
минута: минут
минутный: минутной
мир: мира миру мир мире
мировой: мировая
мисс: мисс
миссис: миссис
мистер: мистер
митчелл: митчелл
мифический: мифических мифическими
младенец: младенца
мнение: мнению мнения мнение
многие: многие многих
многий: многом
много: более
многообещающий: многообещающий
многочисленный: многочисленных
множество: множество множества
мобильный: мобильная
модель: моделей
модифицировались: модифицировались
мозг: мозг
мойра: мойра
молли: молли
молния: молний молнии
молодая: молодая молодыми молодых молодой
момент: момент
монгол: монгол
монтаж: монтаж
монти: монти
морт: морт
морта: морта
мортом: мортом
морту: морту
мотив: мотивам
моусли: моусли
мочь: мог могут могла
мощный: мощной
мрачный: мрачными мрачнее
мужской: мужская
музыка: музыке музыкой музыку музыка
музыкальный: музыкальной музыкальная
мультсериал: мультсериал
мультфильм: мультфильма
мы: нами нас
мэгги: мэгги
мэттью: мэттью
мюзикл: мюзикл
мюнхен: мюнхен
навигация: навигации навигация
навредить: навредить
навсегда: навсегда
награда: наград награда награды
награждаться: награждаются
над: над
надежда: надежды надежда
назад: назад
название: названия названием название
назвать: назвал
назначать: назначает
назначить: назначена назначила назначили
назойливый: назойливых назойливая
найт: найт
найти: найти
найтись: нашлись
наказывать: наказывая
наконец: наконец
наложить: наложенное наложенных
намереваться: намеревается
наметить: намеченное
наносить: наносит
нападать: нападает
написать: написав написал написавшего написать написанных
напоминалку: напоминалку
например: например
напротив: напротив
наравне: наравне
нарукавник: нарукавники
наряд: наряду
настаивать: настаивал
настойчивый: настойчива
настоящий: настоящий
настроение: настроения
натурный: натурные
научный: научной
находить: находят находит
находиться: находились находился
нахождение: нахождение
начало: начале начала
начальный: начальной
начаться: началась начались
начинать: начинают начинает начиная
начинаться: начинается
наш: наших
неблагоприятный: неблагоприятно
невидимка: невидимок
невилл: невилл
невилла: невилла
невиллу: невиллу
негативный: негативный
недавно: недавно
неделя: недель
недостаток: недостаток недостатком
недостоверный: недостоверный
независимость: независимости
незадолго: незадолго
неизвестный: неизвестным
неизгладимый: неизгладимое
неизменно: неизменно
некий: некий
некоммерческий: некоммерческой
некоторые: некоторыми некоторых некоторые
некоторый: некоторое
немой: нем немо
необходимо: необходимо
необходимость: необходимость
неоднозначный: неоднозначно
неодобрительно: неодобрительно
неопр: неопр
неполный: неполный
неприязненный: неприязненно неприязненные
нераспознанный: нераспознанным
нереализованный: нереализованными
неряшливый: неряшливым
несколько: нескольких несколько
несмотря: несмотря
неудачник: неудачниками
неудачный: неудачных
неуклюжий: неуклюжей
неуместный: неуместной
ника: нику ника
никак: никак
никнуть: ник
никогда: никогда
николас: николас николаса
нил: нил
новичок: новички новичок
новый: новая новый новой новые
нога: ног
нокаутировать: нокаутирует
номинанты: номинанты
номинация: номинация номинаций номинации
номинирован: номинирован
норберт: норберта норбертом
норрис: норрис
норт: норт
носитель: носителях
нохчийн: нохчийн
ночь: ночь ночью
ноябрь: ноября ноябрь
нужный: нужное нужном
нью: нью
ньюман: ньюман
ньюэлл: ньюэлл
няня: няни
об: об
обаятельный: обаятельного
обезьяна: обезьян
обеспечивать: обеспечивать
обитание: обитания
область: области
обложка: обложке
обмен: обмен
обмолвиться: обмолвился
обнаруживать: обнаруживают
обнаруживаться: обнаруживается
обогнать: обогнав
образ: образом образы образе
образец: образец
обратить: обратил
обращение: обращения
обсуждение: обсуждение
обучение: обучения
общение: общение
общество: общество
общий: общую общих общая общей общими
объединить: объединила
объектив: объективами
объявить: объявлено объявили объявлен
объяснить: объяснила
объяснять: объясняет
обязанность: обязанности
огонь: огня
огромный: огромное
одежда: одежду
одеон: одеон
одеть: одев
один: одной одного один
одинаковый: одинаковыми
одиннадцатый: одиннадцатого
одинокий: одинокий
однажды: однажды
однако: однако
одновременно: одновременно
одобрение: одобрения
одобрить: одобренный одобрила
оживление: оживлению
ожидание: ожидания
ожог: ожоги
озвучкой: озвучкой
означать: означает
оказать: оказала
оказаться: оказался оказалась оказавшимся
оклэнд: оклэнд
окно: окна окон
около: около
окончательно: окончательно
оксфордский: оксфордского
октябрь: октября
оливер: оливер
олливандер: олливандер
он: нему
она: ею
они: им них
онлайн: онлайн
оно: оно
опасный: опасных
оператор: оператор
операторский: операторскую
операция: операцией
описание: описание
описать: описал
описывать: описывал
определить: определить
определять: определяла
опросить: опрошенные
опубликовать: опубликован
опыт: опыт
организация: организации
организовать: организовать
орден: орден
осветлять: осветляющими
освещение: освещения освещение
осенить: осени
осиротеть: осиротевшего
оскар: оскар
оскорблять: оскорбляет
ослабить: ослабленный
осментом: осментом
оснастить: оснащена
основа: основе
основать: основанные основавший
основное: основном основное
основной: основных основные основная
основываться: основывалась
особенно: особенно
особняк: особняках
особый: особый особой
оставить: оставил оставить оставив
остальное: остальное
остальной: остальной
остановить: остановить
остаться: остались
остров: остров
остроумный: остроумного
отбираться: отбираются
отвергнуть: отверг
отвести: отвели
ответ: ответа
ответный: ответный
ответственность: ответственности
ответственный: ответственной
отводиться: отводилось
отвозить: отвозит
отдавать: отдавала
отделка: отделкой
отдельный: отдельных отдельные
отель: отель
отец: отец
отзыв: отзывов отзывы отзыв
отзываться: отзывался
отказ: отказа отказ
отказаться: отказался отказалась
отклонить: отклонены отклонил
открыть: открытого открыть
отличный: отличные
отметить: отметила отметил
отнестись: отнеслась
относительно: относительно
относиться: относятся
отношение: отношения
отозвать: отозвано
отозваться: отозвался
отправить: отправила
отправляться: отправляется
отражатель: отражателей
отразиться: отразилось
отреагировать: отреагировали
отредактировать: отредактирована отредактированными
отрицательный: отрицательные отрицательной
отрывок: отрывков
отряд: отряд
отснятия: отснятия
отставка: отставке
отсутствие: отсутствие отсутствии отсутствия
отсутствовать: отсутствуют
отчасти: отчасти
отчитать: отчитал
официально: официально
официальный: официальное официальный официальном официальной
оформить: оформленного
охарактеризовать: охарактеризовал охарактеризовала
охватывать: охватывать
охранять: охраняемый охраняет
оценить: оценил оценены
оценка: оценку оценкам оценкой
очередь: очередь
очки: очки очками
ошеломлять: ошеломляющие
ошибка: ошибке
ощущение: ощущение
павильон: павильонах павильона
пайтона: пайтона
парить: парящие
парк: парк
паркер: паркер паркера
паркий: парка
пародия: пародии
партитура: партитура партитуру
патрик: патрик
патриот: патриот
паук: паук
пепел: пепел
первое: первым первого первое первых первые первом
первокурсник: первокурсники
первоначально: первоначально
первоначальный: первоначальному
первый: первой первую первый
переговоры: переговоры
перед: перед
передать: переданной переданная
переделываться: переделывались
пережить: переживший
переиздать: переиздан
перейти: перейти
перекликаться: перекликаются
переработать: переработанной
переселяться: переселяются
переснять: пересняты
переть: при
переулок: переулке переулок
период: периода период
перси: перси
персонаж: персонаж персонажам персонажа персонажами персонажи персонажей
персональный: персональные
пес: пса
песня: песню
петерсен: петерсен
петуньей: петуньей
петунья: петунья
печать: печатью печати
пивза: пивза
пикет: пикет
пиксель: пиксели
писательница: писательницей писательница
писать: писав
письмо: письмо письма
питер: питер
пить: пьющим
план: планы плана
планет: планете
планировать: планировала
пластический: пластический
платформа: платформ
плащ: плащ
плосковатость: плосковатость
площадка: площадке
победа: победу победа
победить: победить
побить: побит побив
поведение: поведения
повествование: повествование повествованию
повествовать: повествует
повлиять: повлиял
повод: поводу
повседневный: повседневные
повторно: повторно
повторный: повторных
подавлять: подавляющую подавляющее
подарить: подаренной
подбора: подбор
подготовить: подготовила
поддаваться: поддающейся
поддержание: поддержания
поддержать: поддержала
поддерживать: поддерживает
поджигать: поджигая
подписать: подписала
подписывать: подписывал
подрасти: подросшим
подробный: подробнее
подряд: подряд
подходить: подходит подходящую
поезд: поезд поезде поезда
пожертвовать: пожертвовать
пожиратель: пожиратели
позволить: позволило позволят
позволять: позволяют позволяло позволяет
позвонить: позвонил
поздний: позднее поздним
позиция: позиции
поиск: поисках поиски поиск поиском поиску
поймать: поймай
пока: пока
показ: показом
показать: показал показаны
покидать: покидало
покинуть: покинула
поклонник: поклонником
пол: пол
полагаться: полагался
политик: политика политике
полнометражный: полнометражный полнометражных
полностью: полностью
полноценный: полноценной
полный: полны
положительно: положительно
положительный: положительной положительный положительном положительных положительные
полтергейст: полтергейстах полтергейста
полукровка: полукровка
полуночный: полуночной
получать: получает
получение: получении
получить: получил получили получивший получить
получиться: получиться
польза: пользу
помимо: помимо
помощь: помощью помощь
понимать: понимает
понять: понял
попадать: попадают
попасть: попавшим
пополнить: пополнили
поправляться: поправляется
попросить: попросил
популярный: популярному популярной
попытка: попытку
поразительно: поразительно
порекомендовать: порекомендовала
порожний: порожней
портал: портал
поручить: поручено
посетовать: посетовал
посещать: посещают
посещение: посещение
поскольку: поскольку
последний: последними последнюю последняя последний последнего последние последнем последнему последней
последующий: последующих последующие
послужить: послужило послужившей
посоветовать: посоветовала
посол: после
посредство: посредством
пост: пост
поставить: поставив
постановка: постановка постановку
постановщик: постановщик постановщиков постановщика
постер: постер
постоянный: постоянная
постпроизводство: постпроизводства
построить: построил построенной
поступок: поступки
посчитать: посчитал посчитав
потеряться: потерявшийся
потрясать: потрясающий
поттер: поттер поттера поттеры поттере
поттерианы: поттерианы
похвалить: похвалила похвалил
похититель: похититель
поход: походом поход
походить: походившее
похожий: похожей похожим
почему: почему
почтить: почти
появиться: появились появился появиться
появление: появления
пр: пр
править: правила править
правка: правки
правый: права прав
празднество: празднество
праздник: праздник
практический: практически
прах: прах
превращать: превращающего
превращаться: превращается
предварительный: предварительные
предел: пределами
предлагаться: предлагалось
предложение: предложению предложение
предложить: предложил предложили предложенную
предмет: предметы
предоставление: предоставлении
предполагаться: предполагалось
предпочтение: предпочтение
представитель: представителя
представительство: представительства
представить: представлены представлен
представиться: представились
предыдущий: предыдущий
предыстория: предыстория
прекратить: прекратить
премия: премии премия премию
премьер: премьера
премьерный: премьерный
преобразить: преобразила
преподаватель: преподаватель преподавателя
преппи: преппи
пресный: пресного
претендент: претендентов претендентами
претендовать: претендовала претендовавшему
претерпевать: претерпевали
прибегать: прибегал
прибывать: прибывает
прибытие: прибытия прибытии
привести: привело
привет: привет
привлекательный: привлекательной
пригласить: пригласила
пригрозить: пригрозила
придумать: придумала
приз: приз
признание: признанию
признанный: признан
признаться: признавшись
призрак: призрак призрака
прийтись: пришлось
приключение: приключения
приложить: приложили
применение: применения
примечание: примечания
принадлежать: принадлежал
принадлежность: принадлежностями
принести: принести
принц: принц
принять: приняло приняв
приняться: приняться
приобретение: приобретении
прислать: прислав присланного
присоединиться: присоединились присоединилась
присуждать: присуждает
присутствовать: присутствующие присутствует
приходить: приходят приходящей
причина: причины
про: про
проба: пробы пробах
проблема: проблемой
пробоваться: пробовалась пробовался
пробуждение: пробуждение
проведение: проведении
проверить: проверенная
проводить: проводила
продажа: продажи
продать: продала продан продано проданный
продвижение: продвижения
продлиться: продлились
продолжение: продолжения продолжений
продолжительность: продолжительностью
продолжительный: продолжительное
продолжить: продолжила
продюсер: продюсера продюсером продюсерами продюсеров продюсер продюсеры
проект: проект проектах проекте проекту проекта
проживать: проживающий
прозвучать: прозвучали
проиграть: проиграл
произведенье: произведений
произвести: произвести
производиться: производились
производственный: производственного
производство: производство производства
произносить: произносили
произойти: произошедшем
происходить: происходят происходивших происходящих
происхождение: происхождения
пройти: пройдя прошла пройти
прокат: проката прокат
проклясть: проклятое
промоматериал: промоматериал
прорыть: прорыв
прослушивание: прослушивания прослушиваниях прослушивание прослушивании прослушиваний прослушиваниям
просмотр: просмотры
просмотреть: просмотренных
пространство: пространства
противоположный: противоположную
протяжение: протяжении
профессор: профессором профессора профессор
профессорский: профессорскую
проходить: проходили проходит проходящем
процесс: процесс процесса
прочесть: прочесть
прочий: прочее
прочитать: прочитать
прочтение: прочтения
прошлый: прошлом
прощание: прощания
прощеный: прощена
проявлять: проявлял
птица: птицы
публика: публике
пуиг: пуиг
пустой: пустого
путеводитель: путеводитель
путь: пути
пуффендуй: пуффендуй
пушок: пушком пушок пушка
пытаться: пытался пытались
пята: пятой
пятидневные: пятидневные
пятница: пятницы
пятый: пятом
пять: пять пяти
работа: работе работы работа работу
работать: работал работавшего работать работала работавшей
разбить: разбитых
развитие: развития
разговор: разговора
раздвоить: раздвоенный
разделить: разделена
раздеть: раздела
раздражение: раздражение
различный: различным
разметка: разметкой
разновидность: разновидность
разногласие: разногласий
разный: разные разными
разочарование: разочарование
разочаровывающе: разочаровывающе
разработать: разработать разработала
разработка: разработке разработка
разработчик: разработчики
разрешение: разрешения
разряд: разряд
разум: разума разум
райана: райана
райнер: райнер
райтман: райтман
ранее: ранее
ранний: раньше
раскрасить: раскрасила
раскритиковать: раскритиковал
раскрыть: раскрыть
расположить: расположенных
распределять: распределяющей распределяющая
рассказ: рассказы
рассказывать: рассказывает рассказываем
рассматривать: рассматривает рассматривали
рассматриваться: рассматривался рассматривались
рассмотреть: рассмотрено
расстроить: расстроенная
растение: растения
расцвет: расцвет
расширить: расширенная
реализация: реализации
реалистичный: реалистичными
ребенок: детей детям дети
ребята: ребятами
результат: результате результат результатов
рейтинг: рейтинг
реквизит: реквизитов
рекорд: рекорд
рекс: рекс
религиозный: религиозные
релиз: релиза релиз релизов
ресурс: ресурсы
рецензент: рецензентов
рецензия: рецензии рецензий
речь: речью
решать: решают
решаться: решалась
решающий: решающими
решение: решения
решительный: решительный
решить: решили решил
рид: рид
рика: рик
рикман: рикман
рикмана: рикмана
римуса: римуса
ричард: ричарда ричард
ричардсон: ричардсон
ричи: ричи
роба: роб
робби: робби
роббинс: роббинс
роберт: роберт
робин: робин
робинсон: робинсон
роджер: роджер
родитель: родителей родителях родители
родом: родом
родственник: родственникам
родственный: родственных
рождение: рождения
рождественский: рождественские
рождество: рождество
розенбаум: розенбаум
рози: рози
рок: рок
ролик: ролик
роль: роль ролей ролях роли ролью
роман: романов романами романе романа роман романы
рон: рону роном рона рон
российский: российские
рот: рот
роуд: роуд
роулинг: роулинг
рубеус: рубеус
рубеусом: рубеусом
ругать: ругал
рука: руки
руководитель: руководителями
руководство: руководство
руперт: руперт
русский: русский
русскоязычный: русскоязычного
русый: рус
рыжий: рыжие
рынок: рынок
рэдклифф: рэдклифф
рэдклиффа: рэдклиффа
рэдклиффе: рэдклиффе
рэнкин: рэнкин
рэп: рэп
ряд: рядом ряде
рядовой: рядового
сайт: сайта сайте сайт сайты сайтом
сам: самого самой самом самому
самоуверенность: самоуверенностью
самый: самую самый самая самым самых
сангстер: сангстер
сантиметр: см
сатурн: сатурн
саундтрек: саундтрек саундтреки
сахарный: сахарной
сбор: сборами сборам сборы
сборная: сборной
сведение: сведения
свежий: свежие
свеча: свечи
свидетель: свидетелем
свитер: свитера
свободный: свободной
свое: своих свои своему своим
свой: свой своей свою
связанный: связанные
связаться: связались свяжитесь
связь: связи
сделать: сделавшая сделать
сделка: сделку
сдержанный: сдержанную сдержанно
сдерживать: сдерживает
сеанс: сеансы
северус: северус
северуса: северуса
северусом: северусом
сегачян: сегачян
секрет: секрет секретов
семейный: семейных семейные семейный
семейство: семейству
семь: семь
семья: семьи
сентябрь: сентябрь сентябре сентября
сердце: сердцем сердец
середина: середине середины
сериал: сериал
серия: серии серий серией серию серия
сертификат: сертификаты
сеть: сети
си: си
сиквеле: сиквеле
сила: сил силы
силберлинг: силберлинг
силберлинга: силберлинга
силок: силки
сильный: сильным сильно сильное
система: систему системе
ситхов: ситхов
сказать: сказал
сказка: сказки
скайуокер: скайуокер
скала: скалах
скарлетт: скарлетт
скачать: скачать
сквер: сквере
сквозь: сквозь
складываться: складываются
скорректировать: скорректировать
скорый: скорее
скроить: скроила
скрытый: скрытая скрытые
скучный: скучный
слабый: слабую
слава: славы
следующий: следующий
слежение: слежения
слизерин: слизерин
слизерина: слизерина
слишком: слишком
словарь: словари
слово: словам слово
сложность: сложности
сложный: сложную
служебный: служебные
случай: случаю случае случаях
случайно: случайно
случайный: случайная
слюна: слюны
смертельный: смертельное смертельные
смерть: смерти
сместить: сместил
сми: сми
смит: смит
смотреться: смотрелись
смочь: смогли смог сможешь
смысл: смысла
снаружи: снаружи
сначала: сначала
снегг: снегг
снегга: снегга
снеггом: снеггом
снимать: снимает снимать
сниматься: сниматься снималась снимался снимались
снитч: снитч
снова: снова
сноу: сноу
снять: сняты снятых снял снята
сняться: снявшийся
собеседование: собеседовании собеседований собеседования
собираться: собираются
собор: соборе соборов собор
собрать: собрала собрал
собственный: собственный собственного
событие: событию события событий
сова: сову совы
совместно: совместно
согласие: согласию согласие
согласный: согласен
согласование: согласовании
соглашение: соглашение
содержание: содержание
создаваться: создавался
создание: создания созданию создание
создатель: создателей создателем создатели
создать: создала создана создано создан создал создать
сознание: сознание
сокол: сокол
сократить: сократить
сократиться: сократилось
солнце: солнца
сомервилль: сомервилль
сон: снов
сообщать: сообщает
сообщение: сообщениям
сообщество: сообщество
сообщить: сообщить
соответственно: соответственно
соответствие: соответствии
соответствовать: соответствовать
соперничество: соперничество
сопоставить: сопоставил
соревнование: соревновании
сорокин: сорокин
состав: состава состав
составлять: составляет
состоять: состоял
состояться: состоялся состоялось
сотрудница: сотрудница
сотрудничать: сотрудничавший
сохранение: сохранением
сочинить: сочинил
спасать: спасал спасает
спасти: спасти
специалист: специалистов специалисты
специальный: специальная специальный
спецэффект: спецэффекты спецэффектами спецэффектам
спилберг: спилбергом спилберг спилберга
список: списка список
спланировать: спланированной
спора: споры
спорт: спорта
спот: спот
справка: справка
спроектировать: спроектировать
спуститься: спустившись
спустя: спустя
спутник: спутник
спутниковый: спутниковой
сравнивать: сравнивали
сравнить: сравнил
сразу: сразу
среда: среды
среди: среди
средневековье: средневековья
средний: среднюю средней
српски: српски
српскохрватски: српскохрватски
ссылка: ссылка ссылками ссылки
стабильный: стабильная
стадий: стадии
сталкиваться: сталкиваются сталкивается
стандартный: стандартный
становиться: становятся становится
станция: станции
стартовать: стартовали
статистика: статистика
статус: статус
стать: стал стала став стали станет
статья: статью статей статья статьи
степень: степени
стерлинг: стерлингов
стефени: стефени
стив: стива стив стиву
стивен: стивен
стиль: стиле стили стиль стилям стиля
стонать: стонут
сторона: стороны сторону
стоять: стоявшей
страна: страны стране страна стран
страница: страницы страница страницу странице
страничный: страничный страничную
страстный: страстной
стремиться: стремилась стремящейся
строение: строениях
строчок: строчку
струиться: струилась
студент: студентов студента
студия: студиях студия студии
стычка: стычки
стюарт: стюарт стюарта
суббота: субботы
судейский: судейскую
судьба: судьбы
супер: супер
супермен: супермен
существо: существ существа существом
существовать: существуют существующую
сцена: сценами сцен сцену сценах сцены
сценарий: сценария сценарию сценарии сценарий
сценарист: сценаристом сценариста сценарист
счесть: сочтя сочло сочла
считать: считал считавшая
считаться: считается
сша: сша
сшить: сшитых
сыграть: сыграла сыграть сыграли
сымпровизировать: сымпровизировать
сын: сын
сырой: сырую
сьюзен: сьюзен
сюда: сюда
сюжет: сюжет сюжета
сюжетный: сюжетных
сюзи: сюзи
тайный: тайная тайна тайны
также: также
такой: таким такими такие
талант: талант
таня: таня
тарханова: тарханова
татара: татара
тв: тв
тварь: твари
твист: твист
творческий: творческим
театральный: театральный театральная
текст: текст
текущий: текущие
телеадаптации: телеадаптации
телеведущая: телеведущей
телефильм: телефильм
тело: тело
тем: тем
тема: тема темы темой
тематический: тематический тематические
темп: темп
тереть: три
термин: термина
терри: терри
терять: теряет
технический: техническое
технология: технология
течение: течение
тизерный: тизерный
тим: тима тим
тинтина: тинтина
тисовый: тисовой
титан: титан
титаник: титаника
ткань: ткани
товарный: товарный
тодд: тодд
томас: томас
тонкость: тонкости
тоновый: тонов
тоскливый: тоскливыми
тот: том те тот тому той
точка: точки точку
традиционный: традиционной
трансформация: трансформации
трафаретный: трафаретной
требовать: требует
трейлер: трейлер трейлера
трекинг: трекинга
третий: третьей
третье: третьем третьего
трибун: трибуне
трио: трио
троица: троицу троица
тройера: тройера
тролль: тролль тролля
труд: труде
трудиться: трудилась
трэверс: трэверс
трюк: трюк
туалет: туалете
туда: туда
туран: туран
тщательно: тщательно
тысяча: тысяч
тьюлис: тьюлис
тэнглвуде: тэнглвуде
тюрбан: тюрбан
уайтхолл: уайтхолл
убедить: убедить
убийство: убийств
убить: убить убиты
уведомить: уведомила
уверенность: уверенность
увидеть: увидев
увлекательный: увлекателен
угодить: угодить
угрожать: угрожает
угроза: угроза
удаление: удалении
удар: удар
уделить: уделить
удерживать: удерживала
удовольствие: удовольствие
удостоить: удостоена удостоен
ужасный: ужасных
узнавать: узнавать
узник: узник
уизли: уизли
уик: уик
уильям: уильям уильяма
уильямс: уильямс уильямса
уинн: уинн
уир: уир
указание: указанием
указать: указала
украсть: украсть
улица: улицу улицы
университет: университета
уникальный: уникальными
униформа: униформы униформой
уничтожить: уничтожив уничтожили
уолтерс: уолтерс
уонамейкер: уонамейкер
уорик: уорик
уотсон: уотсон
упоминание: упоминанием
упорство: упорство
управление: управление
упростить: упростить
урок: уроке уроки урока
усилие: усилий
условие: условий условии условие условием условия
успех: успех
успешный: успешных успешной успешным
усталость: усталости
установить: установленными
устранить: устранить
устройство: устройств
утвердить: утверждена утвердили утвердить
утверждать: утверждала
утрата: утрату
утратить: утраченного
уход: ухода
участвовать: участвовала
участие: участие участием участии
учебный: учебных
ученик: учениками учеников ученики
ученица: ученицу
учитель: учителей учителем
учитываться: учитывалась
ф: ф
фабельманы: фабельманы
фаворитка: фаворитку
факел: факелы
фактор: факторами
факультет: факультета
фантастический: фантастических фантастические фантастический
февраль: февраля феврале
фелпс: фелпс
фелтон: фелтон
фелтону: фелтону
феникс: феникса
феннел: феннел
феноменальный: феноменально
фестиваль: фестивале
фехтование: фехтования
фиггис: фиггис
фигура: фигура
физический: физической
филипп: филипп
филиус: филиус
философский: философский философского
филч: филч
филчу: филчу
фильм: фильму фильм фильме фильмов фильмах фильма фильмы фильмом
фильтр: фильтрами
финальный: финальные
фиона: фиона
фичуретки: фичуретки
фламеля: фламеля
флитвик: флитвик
фонд: фонд
форма: формы
форман: форман
формат: формате
форум: форум
фрагмент: фрагментов фрагменты фрагментах
франшиза: франшизе франшизу франшизой франшиза франшизы
фред: фред
фрэнсис: фрэнсис
фунт: фунтов
фэнтези: фэнтези
фэнтезийный: фэнтезийный
х: х
хагрид: хагрид
хагрида: хагрида
хагридом: хагридом
ханикатт: ханикатт
ханикатта: ханикатта
характерный: характерные
харизма: харизмы
харизматичный: харизматичным
харрис: харриса харрис
харт: харт
хвалебный: хвалебно
хватать: хватает
хейман: хейман
хейманом: хейманом
хейману: хейману
хижина: хижина хижины
хиршенсон: хиршенсон
хискок: хискок
хобби: хобби
хоберман: хоберман
хогвартс: хогвартс
хогвартса: хогвартса
хогвартсе: хогвартсе
ход: ходе
холмс: холмс
холодное: холодным холодных
холт: холт
хорн: хорн
хороший: хорошие хороших наилучшим лучшую лучшие лучшая хорошим лучшее лучший лучшего
хотеть: хотели хочет хотят хотел
хоть: хоть
храм: храм
хромакея: хромакея
хроник: хроники
хронология: хронология хронологии
хрустальный: хрустального
художник: художник художников художника
художница: художницей художница
хьюго: хьюго
хэйли: хэйли
хэллоуина: хэллоуина
хэнниган: хэнниган
хэтти: хэтти
цвет: цвета цвет
цветной: цветную
целый: целом
цитата: цитаты
цитировать: цитировать
цифровой: цифровой
чар: чар
чародейство: чародейства
чарте: чарте
час: часа
частить: части
частично: частично
частность: частности
часть: частью частей частях часть
часы: часов
чей: чья
человек: человек
челюсть: челюсти
чемпионат: чемпионат
через: через
череп: черепа
четверг: четвергам
четыре: четырьмя четыре
число: число чисел числу числе
читать: читать
чрезмерный: чрезмерно
чтобы: чтобы
чудо: чудом
чуть: чуть
шанс: шанс
шар: шар
шармбатон: шармбатон
шахматный: шахматная
шахматы: шахматы
шварцбаум: шварцбаум
шептать: шепчущего
шерлок: шерлок
шестиминутный: шестиминутный
шесть: шесть шести
шиндлера: шиндлера
широкий: широкой
шкала: шкале
шкатулка: шкатулкой
школа: школа школе школой школы школ
школьный: школьном школьных школьными
шкура: шкур
шлейф: шлейф
шляпа: шляпы шляпа
шоколадный: шоколадная
шон: шон
шору: шору
шотландия: шотландии шотландию
шоу: шоу
шрам: шрам
шьямалан: шьямалан
эбби: эбби
эберт: эберт
эда: эд
эдди: эдди
эдриан: эдриан
эдуард: эдуарда
эйкена: эйкена
экленд: экленд
экран: экранами
экранизация: экранизацией экранизация экранизации экранизаций
экспресс: экспресс
элвис: элвис
электричество: электричества
элемент: элемент элементами
элинор: элинор
эмма: эмму эмма
энд: энд
эндрю: эндрю
энергичный: энергичное
эния: эния
энна: энн
энтони: энтони
энциклопедия: энциклопедии
энья: энья
эпизод: эпизодами эпизоды эпизод
эпизодический: эпизодических
эплебаум: эплебаум
эпоха: эпоху эпохи
этаж: этаже
это: этом это этому этим
этот: этой эта
эффект: эффектов эффекты эффектами
ю: ю
юный: юном юные юного
юрский: юрского
являться: являлся является являвшимися являлись
язык: язык языках языке языком
языческий: языческой
январь: январе января
яп: яп
япония: японии
японский: японской
