абсолютно: абсолютно
авад: авада
аварийный: аварийном аварийные
август: августа
августус: августус
аврор: аврора
австралийский: австралийских
авторство: авторство авторства
адский: адского
азкабан: азкабан
азкабана: азкабана
академический: академическая академические
академия: академию
акромантулов: акромантулов
акромантулы: акромантулы
акцио: акцио
алекто: алекто
аллея: аллея
алмаз: алмазы
алфавит: алфавиту
алый: ало
альбус: альбус
альбуса: альбуса
альбусу: альбусу
альпина: альпина
амбридж: амбридж
амикус: амикус
амикуса: амикуса
аналогичный: аналогичные аналогичного аналогично
англ: англ
английский: английском
андреа: андреа
антон: антон
антонин: антонин
апартамент: апартаменты
апельсиновый: апельсиновый
аплодисменты: аплодисментами
аппарация: аппарация
аппарирование: аппарирование
апрель: апреля
арагога: арагога
аргус: аргус аргуса
арестовать: арестовать
армандо: армандо
армия: армии
арнольд: арнольда
аромат: аромат
арсений: арсений
артур: артуром артура артур
архив: архив
архивировать: архивировано
астрология: астрология
астрономический: астрономическую астрономической
астрономия: астрономии астрономия
атака: атаки
атаковать: атакуют атакована атаковать
аттестация: аттестация
аудитория: аудиторию
бабблинг: бабблинг
бал: бала бал балу
балдахин: балдахинами балдахином
балет: балету
балл: баллы баллу баллов
балльный: балльной
банкетный: банкетный
бар: бар бары бара
барда: барда
барон: барон
барсук: барсук барсуки
барти: барти
барьер: барьер барьере
бассейн: бассейн
бастион: бастионом
батшеда: батшеда
башня: башню башня башне башен башни
бдительный: бдительное
бежать: бежал
безголовый: безголовый
безобидный: безобидных
безоблачный: безоблачный
безобразие: безобразие
безобразничать: безобразничать
безопасность: безопасность безопасности
беларуская: беларуская
белла: беллой
беллатриса: беллатриса
беллатрисой: беллатрисой
беллатрису: беллатрису
бербидж: бербидж
беседа: беседы
бесплатный: бесплатное
беспокойство: беспокойства
беспрепятственно: беспрепятственно
бестолковый: бестолкового
бешеный: бешеный
библиографический: библиографических
библиотека: библиотеки библиотеку библиотека библиотеке
библиотекарь: библиотекарь
бидля: бидля
бинс: бинс
битва: битва битве битву битвы
битье: битье
биться: бьющаяся
благородный: благородных
благородство: благородство
бланманже: бланманже
блеск: блеска
блестеть: блестящие блестящая
ближний: ближайшей ближайшим
близнец: близнецы
блуждать: блуждает
блэк: блэк
блэка: блэка
блэком: блэком
блюдо: блюд блюда
боггартов: боггартов
боевой: боевые
бойкот: бойкот
болотное: болотных болотное
боль: боль
больница: больницу
больничный: больничное
больший: большим большие больших большего больше
большинство: большинство
большой: велик большого большому большом большой наибольшее большое
борис: борис бориса
боттлингер: боттлингер
бочок: бочки бочках
бразилия: бразилии
брат: братом
брать: брать
браун: браун
британский: британских британские британским
бронзовый: бронзовый бронзовым
бруствер: бруствер
будущее: будущего
бузинный: бузинной бузинную бузинная
буйабес: буйабес
буква: букв
бунт: бунта бунт
бутылка: бутылки
буфет: буфетами
български: български
бывать: бывали бывает
быт: быт
быть: будучи бывший бывших бывшего были
бэнгз: бэнгз
бэрк: бэрк
бэркс: бэркс
вагон: вагоне
важный: важны важной важно
валентин: валентина
вампир: вампиров
ванный: ванная ванную ванной
вариант: варианты вариантах
варнавы: варнавы
василиск: василиском василиска василиск василиску
вблизи: вблизи
вверить: вверенных
вверх: вверх
вдоль: вдоль
вдохновение: вдохновение
ведьма: ведьм ведьмы
вежливо: вежливо
вейн: вейн
век: века веку век
вектор: вектор
великан: великаны великан великанов
великанша: великанша
великий: величайшим
великобритания: великобритании
велита: велит
величина: величину
венчать: венчают
вепрь: вепрь вепрей вепри
верить: верит
верность: верность
вернуться: вернуться
верный: верный верной верен
вероятно: вероятно
версия: версия версии
верхний: верхней верхнюю верхняя верхних
вершина: вершины
весить: весь
вести: вела ведшая ведущая ведет ведущих ведут вели ведущим ведущей ведущий ведущего вести
вестибюль: вестибюле вестибюль вестибюля
весы: весы
весьма: весьма
вечер: вечерам вечером вечера
вечерний: вечерних
вещица: вещицы
вещь: вещей вещи
вздрючить: вздрюченного
взрослый: взрослых
взять: взят взять
вид: виду вид виде
видеть: видели видят виден
видимо: видимо
видимость: видимости
видоизменение: видоизменение
видоизменяться: видоизменяется
визжать: визжащей визжащую
викиданных: викиданных
викимедиа: викимедиа
википедии: википедии
википедия: википедия
викисклад: викисклад
викискладе: викискладе
викия: викия
винки: винки
винтовой: винтовой винтовая
висеть: висят висит
вклад: вклад
включать: включает включая
вкус: вкусом
владелец: владельцу
власть: власти
влияние: влияние
влиять: влияющих
вместе: вместе
вместо: вместо
вмешаться: вмешаться
вмешиваться: вмешиваться
внезапно: внезапно
внести: внесло
внеурочный: внеурочное
внеучебный: внеучебное
внешний: внешние внешний внешнего
вниз: вниз
внимание: внимание
вновь: вновь
внутренний: внутренний внутреннем внутреннего внутренних внутреннее
внутри: внутри
внутрь: внутрь
водиться: водятся
воды: воды
водяной: водяных
возвращение: возвращение возвращении
возглавлять: возглавляемые
воздух: воздуха воздухе
возлюбить: возлюбленную
возможно: возможно
возможность: возможность
возможный: возможный возможен
возникать: возникает
возобновляться: возобновляются
возраст: возраста возрастов
возрождение: возрождение
война: войны война
войско: войско
войти: войти
вокзал: вокзала вокзал
вокруг: вокруг
волан: волан
волкодав: волкодава
волшебник: волшебника волшебников волшебник волшебники
волшебница: волшебницей волшебницы волшебницами
волшебный: волшебной волшебную волшебные волшебных волшебного волшебная волшебный волшебное волшебному
волшебство: волшебства волшебству волшебство
вообще: вообще
вопрос: вопрос
ворот: ворота
восемь: восемью
воскрешать: воскрешающего
воспитание: воспитание
воспользоваться: воспользовавшись
воспоминание: воспоминания
воспроизведение: воспроизведения
восстановить: восстановлена
восток: востоке востоку
восточный: восточная восточного восточной
восьмой: восьмого восьмом
впадать: впадает
впервые: впервые
впереди: впереди
вперемешку: вперемешку
вплотную: вплотную
вполне: вполне
впоследствии: впоследствии
впрочем: впрочем
враг: врагов
врач: врачом
вредилки: вредилки
вредноскопы: вредноскопы
временить: времени
временно: временно
временной: временного временным
время: времена временем время
вроде: вроде
все: всему всех всего всем всеми
всевозможный: всевозможными всевозможные
вселенная: вселенная вселенной
всеять: всей
вспомнить: вспомнили
вспыхивать: вспыхивает
встреча: встречи
встречать: встречают встречает
вступать: вступает вступают
вступить: вступивших
всякий: всякие
второе: втором второго вторых
второй: вторая второй
вход: вход входе входа
входить: входят входит входить входящему
выбирать: выбирать выбирает
выбираться: выбираются
выбор: выбор выбора
выбрасывать: выбрасывает
выбрать: выбрать выбран
вывешиваться: вывешиваются
выглядеть: выглядит
выговор: выговор
выгравировать: выгравирована
выдавать: выдавал
выдаваться: выдающимися
выдать: выдать выданная
выдача: выдачу
выдвигаться: выдвигается
выдержать: выдержанная
выдерживать: выдерживавшие
выдувать: выдувают
выдумывать: выдумывают
вызвать: вызвал вызвав вызванного
вызваться: вызвался
вызывать: вызывает
выигрывать: выигрывают выигрывает
выйти: вышли
выкрикнуть: выкрикнула
вылупиться: вылупившегося
вымыслить: вымышленные
выносить: выносят
вынудить: вынуждены вынудив вынужден
выписывать: выписывая
выползать: выползающий
выполнение: выполнения
выполнить: выполнено выполнена
выполнять: выполняющий выполняет
выполняться: выполняется
выпросить: выпросил
выпускать: выпускает выпускали
выпускник: выпускники
вырастить: вырастили
выращивание: выращивания
выращивать: выращивает
выручать: выручай
высечь: высеченными
высокий: высоком высокая высоких высокие высок высоко высоким высокой выше
высота: высоте высоты
выставлять: выставляемые
выступать: выступали выступал
выступить: выступили
выучить: выучили
выхаживать: выхаживал
выходить: выходит выходят
выходной: выходные
гадание: гадания гадание
газета: газет
газон: газоном
галеон: галеонов
галерея: галереи галерею
ганхильда: ганхильда
гардина: гардинами
гарри: гарри
гаснуть: гаснет
герб: гербами
гермиона: гермиона гермионы гермионой гермионе
героизм: героизме
героически: героически
герой: героя герои
гибель: гибели гибель
гигантский: гигантских
гимн: гимны гимн
гиппогриф: гиппогрифа гиппогрифом гиппогрифе гиппогриф
гл: гл
глава: главе глава
главное: главным главного главные главное
главный: главная главный
гладкий: гладким
глаз: глаз глаза глазах
гласить: гласит
глиссео: глиссео
глубина: глубине
глубокий: глубокой глубокие
глубоко: глубоко
гнев: гнева
го: го
гобелен: гобелены
говорить: говорит говорил говоря
год: году лет год годы годом года
годовой: годовым
годрик: годрик
годрика: годрика
годриком: годриком
годрику: годрику
гойла: гойла
гойлом: гойлом
голова: голову голова
голубой: голубыми
гонсмура: гонсмура
гора: горах горами
гораций: гораций
горб: горб горбом
горбина: горбин
горгулья: горгулья
гореть: горящими горели
гористый: гористой
горка: горку горки
горный: горной горное
горшков: горшков
гостевой: гостевые
гостеприимный: гостеприимная
гостиная: гостиным гостиная гостиную гостиной гостиные гостиных
гость: гостей гостями гости
готовить: готовит готовящие готовить готовят
готовиться: готовятся готовясь
готовность: готовность
граббли: граббли
гражданство: гражданство
граммофон: граммофон
грамота: грамоты
граница: границах
грейнджер: грейнджер
гремучий: гремучей гремучую
гриндилоу: гриндилоу
грифон: грифон грифона
гриффиндор: гриффиндор
гриффиндора: гриффиндора
гриффиндоре: гриффиндоре
гриффиндором: гриффиндором
гриффиндорская: гриффиндорская
гриффиндорских: гриффиндорских
гриффиндорской: гриффиндорской
гриффиндору: гриффиндору
гриффиндорцев: гриффиндорцев
гриффиндорцы: гриффиндорцы
грозный: грозный грозного
громадный: громадный
грохх: грохх
грубый: груб
группа: группа группы групп
групповой: групповые
груша: груша грушу
грюм: грюм
грюма: грюма
грязнокровок: грязнокровок
густой: густо гуще
гэмпа: гэмпа
д: д
давать: дают
давний: давнее
давность: давности
далее: далее
дальнейший: дальнейшем дальнейшая
дальний: дальнем дальней
дама: дамы дама
дамблдор: дамблдор
дамблдора: дамблдора
дамблдором: дамблдором
дамблдору: дамблдору
дань: дань
дар: дары
дата: дата
дать: дали даст данные дала данному дать
два: два две двух двумя
дверной: дверную
дверь: дверь дверям двери дверями
двигаться: двигались
движение: движения
двое: двое
двойной: двойным
двор: дворе двор
двукрест: двукрест
де: де
девиз: девизы девиз
девочка: девочки девочек
девушка: девушку
действие: действия действие действиями
действительно: действительно
действовать: действовать
декабрь: декабря
декан: декан
декорация: декорации
декрет: декреты
делать: делает делал делать делают
делаться: делаются
деление: делению
делиться: делится
дело: деле
дементора: дементора
дементоров: дементоров
дементоры: дементоры
демонстрировать: демонстрирует
день: дней
деньга: деньги
деревня: деревни деревня деревню
дерево: деревьях деревья деревьями
деревушка: деревушка
держаться: держатся
детектор: детекторы
детский: детский
деть: день дело
дж: дж
джеймс: джеймс
джинни: джинни
джоан: джоан
джордж: джордж джорджа
диадема: диадемы диадеме диадему диадема
диван: диваны диванами
диггори: диггори
дилогия: дилогия
динозавр: динозавров динозавр
диппет: диппет
директор: директором директоров директора директор
директорский: директорском
директриса: директрисы директрис
дирекция: дирекции
диссендиум: диссендиум
дисциплина: дисциплины дисциплина
дисциплинарный: дисциплинарные
дитя: дитя
длинный: длинная длинные длинный
длиться: длится
дмитрий: дмитрий
дневник: дневник
днище: днище
добавить: добавил
добавлять: добавлять
добавляться: добавляется добавляются
добби: добби
добраться: добраться добрались
добровольно: добровольно
добыть: добыли
доверие: доверия
довольный: довольно
догадаться: догадаться
догнать: догнать
договориться: договорился
док: док
документ: документов
долгий: долго
долгопупс: долгопупс
долгопупса: долгопупса
должен: должны должно должен
должность: должности должностей должность
долорес: долорес
долохов: долохов
дом: дом домом
дома: дома
домашние: домашних домашние
домашний: домашняя домашнее
домик: домик
домовик: домовики домовиков
домовладелец: домовладельцев
домовой: домового домовых домовые
домовый: домов
донесение: донесение
дополнительный: дополнительные
допуск: допуск
дорогой: дорога дороже
доска: доска
дословный: дословно
доспех: доспехи доспехов
доставить: доставят
достаточно: достаточно
достигнуть: достигшие
достижение: достижения
достоверный: достоверных
достопримечательность: достопримечательностью
доступный: доступен
дочь: дочь дочерью
драгоценный: драгоценные драгоценными
драко: драко
дракон: дракона драконами
драконий: драконью
дракончика: дракончика
древние: древние
древний: древнего
древность: древности
друг: друге друзья друзьями друг друзей другом друзьям друга другу
другой: другое другим другой другими другому другая другие других
дружина: дружины
дубовый: дубовым дубовых
дурманить: дурманящий дурманящими
дурмстранг: дурмстранг
дурслей: дурслей
дух: духе дух
душ: души душа
душный: душная
дуэль: дуэлей дуэли
дым: дыма
дырявый: дырявый
дьявольский: дьявольские
дэрвиш: дэрвиш
егерь: егеря егерей
еда: еда еду еды
единорог: единороги
единственный: единственным единственная единственный единственной единственные
ежегодно: ежегодно
ежегодный: ежегодного
ежедневный: ежедневного ежедневном
еле: еле
елена: елена
естественно: естественно
есть: едят
ехать: едут
жаба: жаба жабу
жажда: жажда
желание: желание желанию желании
железнодорожный: железнодорожной
жениться: женился
живой: живых живые живой
животное: животных животном
жизнь: жизни жизнь жизнью
жила: жил
жилище: жилищем
житель: жители
жить: жившему живут живущих
журнал: журнал журналов журнале
жуткий: жутко
забирать: забирают
заболеть: заболевшие
забывать: забывают
завалить: завален
заведение: заведение заведений
завершить: завершит
завещать: завещанную
зависеть: зависит зависело
зависимость: зависимости
завтрак: завтрака
завхоз: завхозом завхоз
загадка: загадку
загадочный: загадочной
заглавный: заглавная
задавать: задают
задание: заданий задания заданию
задворки: задворках
задержать: задержать
задрапировать: задрапированы
зажимание: зажимание
зайцев: зайцев
заканчивать: заканчивать
заканчиваться: заканчивается
заклинание: заклинанием заклинанию заклинания заклинаниям заклинаний заклинание
заключать: заключавший
заключаться: заключаются
заклятие: заклятие заклятиям заклятий заклятию заклятием заклятиями заклятия
заколдованный: заколдованный заколдованные заколдованной
заколдовать: заколдована заколдованы
заколдовывать: заколдовывают
закон: законам законов
закрытый: закрытой
залежь: залежи
залить: залита
зало: зал зала зале залу
залом: залом
заманить: заманил
замена: замене
заменить: заменить заменены
заместитель: заместителем заместитель
заметить: заметил заметить заметили
замечание: замечание
замковый: замковые
замок: замку замке замок замка замком замки
занавес: занавесами
занимать: занимает
заниматься: занимается
занятие: занятия занятий занятие занятиях
занять: занял
запад: западе
западный: западной западная
запас: запас
запасть: западу
записывать: записывает
запись: запись записи
запланировать: запланированная
заполнить: заполнен
запрашивать: запрашивая
запрет: запрет запрету
запретить: запрещено
запретный: запретной запретную запретного запретным запретном запретный запретная
запуск: запуск
запутанный: запутанные
зарегистрировать: зарегистрированный
заросль: зарослей
засада: засаду
заслуга: заслуги
заслуживать: заслуживают
заставлять: заставлял
затащить: затащили
затем: затем
заточить: заточил
заходить: заходит заходить
захотеть: захотят захотела
защемлять: защемляя
защита: защиты защита защите защиту
защитник: защитникам защитниками защитники защитников
защитный: защитную защитных
защищать: защищал защищают
заявка: заявку
заявление: заявление
заявлять: заявляет
звание: звания
зверь: зверя звери
звук: звук
звякать: звякали
здание: здание
здоровье: здоровья
зелье: зелий зельем зелье зелья
зельеварение: зельеварение
зельеварению: зельеварению
зельеварения: зельеварения
земля: земли
зеркало: зеркалом
зимний: зимний
злата: злата
златопуст: златопуст
зло: зла
зловещий: зловещей
злой: злые злой
злотницкий: злотницкий
змеиный: змеиный змеином
змея: змей змею змея змеями
знак: знак
знаменовать: знаменующие
знание: знания знание
знать: знает знают зная
значимый: значимым
значит: значит
значительно: значительно
значок: значки
золотой: золотых золотой
зонко: зонко
зрение: зрения
зритель: зрители
ив: ивы иву
игра: игра играх игре игры
играть: игравший
избивать: избиваемого
избранный: избранные
избушка: избушка
извергать: извергающих
известно: известно
известный: известным известен
изворотливый: изворотливых
изгнать: изгнана
издавать: издавала
излучать: излучающими
изначально: изначально
изнурять: изнуряющий
изо: изо
изображение: изображением изображение
изумруд: изумруды изумрудами
изучать: изучаемых изучаемым изучающая
изучаться: изучаются
изучение: изучению изучения изучение изучении
именно: именно
иметь: имел имеющие имеют имевший имеет имели
империус: империус
имя: имена имя имени
инвентарь: инвентаря инвентарь
индианаполиса: индианаполиса
иногда: иногда
иной: иных иное
иностранный: иностранные
инспекционный: инспекционной
институт: институт
инструктор: инструктор
инструмент: инструменты
интервью: интервью
интересно: интересно
интересный: интересных
информация: информация информации
искать: искать
исключение: исключения исключениями исключение
исключенье: исключений
исключительный: исключительным
исключить: исключить
ископаемое: ископаемого
искусный: искусными искусным
искусство: искусств искусствам искусства
исп: исп
исполнитель: исполнителем
исполниться: исполнится исполнилось
использование: использование использования
использовать: используя использовал использует использующие использованы используют
использоваться: используются использовалось используется
испытание: испытании испытание испытания
истечение: истечением
истинный: истинному истинного
история: история историй истории
источник: источник
исходить: исходит
исчезательные: исчезательные
исчезательный: исчезательный
исчезательными: исчезательными
исчезать: исчезает
исчезновение: исчезновение
итог: итог
июль: июля
июнь: июня июне
й: й
кабаний: кабанья
каббалистика: каббалистика
кабинет: кабинет кабинета кабинету кабинете
кадр: кадр
каждый: каждому каждой каждого каждый каждая
казнить: казни
какой: каких какое
каменный: каменной каменные каменных каменная
камень: камней камень камни камнями камня
камешек: камешек
камин: камине камину камины камин
каминный: каминная каминной
канареечный: канареечно
кандалы: кандалами
кандида: кандида
кандидат: кандидатам
кандидой: кандидой
кандиды: кандиды
каникулы: каникулы каникул каникулами
капитан: капитаны
карачарова: карачарова
карелин: карелин
карета: каретах
карликовый: карликового
карта: картах карт карты карте карту
картина: картинами картины картине
карточный: карточная
касаться: касающимися
кастрюля: кастрюли
каталог: каталогах
катберт: катберт
категория: категории
каф: кафе
качество: качества качестве качеств
квартира: квартира
квиддич: квиддич
квиддича: квиддича
квиддичу: квиддичу
квирелл: квирелл
квиринус: квиринус
квиррелл: квиррелл
квиррелла: квиррелла
кедавра: кедавра
кентавр: кентавра кентаврами кентавров кентавры кентавр
керосиновый: керосиновой
кеттлберн: кеттлберн
кикимера: кикимера
кикимером: кикимером
кингс: кингс
кингсли: кингсли
кинокомпания: кинокомпании
кирпичный: кирпичный
кислотный: кислотные
кладовая: кладовой
класс: класса класс классе классы
классный: классных классная
класть: кладет
клаудиа: клаудиа
клетка: клетку
клуб: клубов
клык: клык клыка
клювокрыл: клювокрыл
клювокрыла: клювокрыла
клювокрыле: клювокрыле
клювокрылом: клювокрылом
книга: книг книгами книгах книги книгу книгам книге книга
книжный: книжные
коварный: коварный
когтевран: когтевран
когтеврана: когтеврана
когтевранских: когтевранских
когтевранцев: когтевранцев
код: код
кодекс: кодекс
кожа: кожи
кожаный: кожаными
колба: колбы
колдун: колдуна
колин: колин
количество: количество количестве
колледж: колледжах колледжа
коллективный: коллективный
коллекционный: коллекционная
коллекция: коллекцией
колода: колоды
колокол: колокол
колония: колонии колонию
колонна: колоннах колонны колоннам
колоссальный: колоссальная колоссальных
колпак: колпаков
кольцо: кольцами
команда: командами команду команд
командующий: командующие
комментарий: комментарии
комната: комнате комнату комнат комната комнаты
комплект: комплект
конвертироваться: конвертируются
кондитерский: кондитерская
конец: конце конец конца
конкретный: конкретный
конструктор: конструктор
контрабандный: контрабандного
конфета: конфетах
конфиденциальность: конфиденциальности
конфисковать: конфисковано
конфликт: конфликт
кончиться: кончился
корень: корней корни
коридор: коридорам коридоре коридора коридоры коридор
кормак: кормак
кормление: кормления
корнелиус: корнелиус корнелиусу
коробка: коробка
королевство: королевстве королевство
короста: коросту
короткий: короткие коротким короткий
корректив: коррективы
коснуться: коснуться
косой: косом
который: которым которое которой которую которого которые которых которая котором который
кофе: кофе
кофейный: кофейной
кошка: кошку
край: краю
крайний: крайнее крайней
крайст: крайст
кран: кране крану
крановый: кранов
красивый: красивый
красноватый: красноватый
красный: красных красный красным красно
крауч: крауч
крауча: крауча
кресло: кресел креслами креслах кресло кресла
крестраж: крестраж
крестража: крестража
крестражей: крестражей
крестражем: крестражем
крестражи: крестражи
кривить: криви
крик: криком
кристалл: кристаллы
кровавый: кровавый
кровать: кроватью кроватями кровать
кровь: крови кровь
кроме: кроме
кросс: кросс
круглый: круглая круглый круглую круглых круглые круглое
крупный: крупный
круциатус: круциатус
крылатый: крылатых крылатые
крымов: крымов
крыса: крысу
крыть: крыла крыло
крэбб: крэбб
крэбба: крэбба
крэббом: крэббом
кто: кем кому
кубок: кубки кубок
кувшин: кувшином
куда: куда
кук: куки
кульминация: кульминации
культура: культуре
купить: купить купленного
куполообразный: куполообразным
курс: курсе курс курсов курсах курса курсы
кусок: кусок
кухня: кухня кухню кухни кухне
кэдогана: кэдогана
кэрроу: кэрроу
лабиринт: лабиринт
лаванда: лавандой лаванда
лавгуд: лавгуд
лавка: лавка лавке
лазарет: лазарета
лампа: лампой лампами
латинский: латинские
латунный: латунный
латынь: латыни
левый: лев
леденец: леденцы
лежать: лежали
лес: лесу лесом леса лес
лесник: лесник
лесничий: лесничий лесничего
лесной: лесная
лестница: лестницы лестницам лестниц лестница лестнице
лестрейндж: лестрейндж
летать: летающем летать
летний: летние
летучий: летучая
лечебный: лечебные
лечение: лечения
либо: либо
ливздене: ливздене
лидер: лидер
лили: лили
лимонный: лимонный
лист: листья
литература: литература
литературный: литературных
лицензия: лицензии
лицо: лица
лично: лично
личной: личных личную
лишение: лишениях лишению лишение
лишиться: лишился
лишь: лишь
ловушка: ловушку ловушки
лодка: лодках
ложный: ложным
ложь: лжи
лозунг: лозунга
локация: локациях локации
локонс: локонс
ломать: ломает
лондон: лондона
лорд: лорда лордом лорду лорд
лукотрусы: лукотрусы
луна: лун
любимец: любимце
любительница: любительница
любить: любил любимых любит любимое
любовный: любовное
любой: любых любого любую любой любым любом
любопытный: любопытный
люк: люк
люпин: люпин люпином люпина
лютном: лютном
м: м
маг: магов маги магами
магазин: магазином магазине магазин магазина
магически: магически
магический: магической магическую магические магических магическом магическая магический магическим магическому магическими
магия: магия магии
магл: магл
магла: магла
маглов: маглов
магловедение: магловедение
магловедению: магловедению
магловедения: магловедения
магловских: магловских
маглы: маглы
мадам: мадам
макгонагалл: макгонагалл
македонский: македонски
маклагген: маклагген
максим: максим
маленький: маленькие меньше мало
малоимущий: малоимущим
малфой: малфой
малфоя: малфоя
мальчик: мальчикам мальчик мальчики мальчиков
мальчишка: мальчишек
мандрагора: мандрагора
мансарда: мансардой
мантия: мантией мантию мантии
марта: марта
масса: массу
массивный: массивное
масштаб: масштаб масштаба
материал: материал материала
матч: матчах
мать: мать матери
махаон: махаон
машина: машине
мая: мая
мгновенный: мгновенное
медиафайлы: медиафайлы
медный: медные
медсестра: медсестра
международный: международное
мелкий: мелкий
менее: менее
менять: меняя меняют
мера: мере меры
мерзавка: мерзавка
местность: местности
место: место местах места местом месте
местонахождение: местонахождении местонахождение
местоположение: местоположение местоположения
месяц: месяцев
метать: меча
метка: метке
метла: метле
мех: меху
меч: мечом
мечтать: мечтал
мешок: мешках
миловаться: миловался
мимо: мимо
минерва: минерва
минервой: минервой
минерву: минерву
министерство: министерства министерство министерстве
министр: министр
минута: минуты
мир: мира мир миром миры мире
миртл: миртл
миссис: миссис
миссия: миссию
мистер: мистера
мистический: мистическое
михаил: михаил
младенец: младенца
младший: младший
мнение: мнение
многие: многие многих
много: более много
многоуровневый: многоуровневого
многочисленный: многочисленные
множество: множеством множество
мобильный: мобильная
могила: могилу
можно: можно
мой: мою
молли: молли
молоко: молоко
молоток: молоток молотком
моль: молью
момент: моменту момент
монах: монах
монгол: монгол
монотонный: монотонно
монументальный: монументальными
морт: морт
морта: морта
мортом: мортом
морту: морту
москва: москва
мотив: мотив
мочь: мог можешь могли могут
мракоборцев: мракоборцев
мракоборцы: мракоборцы
мракоборческую: мракоборческую
мраморный: мраморная мраморные
мрачить: мрачен
мрачный: мрачная
мудрость: мудрость
музей: музей
мультиконфессиональной: мультиконфессиональной
мунго: мунго
мучить: мучила
мы: нами нам
мыльный: мыльные
мыслить: мыслимых
мышиный: мышиными
мягкий: мягких мягкие мягко мягкими
набирать: набирая
наблюдать: наблюдать
наблюдение: наблюдения наблюдением
набор: наборе
набрать: набранные набравший
наверх: наверх
навигация: навигации навигация
навык: навыкам
нагайна: нагайна
нагайне: нагайне
нагайной: нагайной
нагайну: нагайну
нагайны: нагайны
награда: наград награда награды
над: над
надевать: надевают надевает
надежда: надежду
надеть: надеть
надеяться: надеясь
надпись: надписью
назад: назад
название: названия названий название
названый: названы названа назван
назвать: назвать
назначать: назначают
назначить: назначил назначен назначить назначены
назойливый: назойливое назойливых
называть: называемый называет называемых
называться: называются называется
наизусть: наизусть
наитемнейшего: наитемнейшего
найджелус: найджелус
найти: нашли найти
наказание: наказаниях наказанием наказания наказаний наказание
наказать: наказаны
наказывать: наказывать
наклеить: наклеены
наконец: наконец
накрываться: накрывается
наложить: наложенных наложил
наоборот: наоборот
нападать: нападают нападавшим
нападение: нападения
напирать: напирают
написать: написаны написанную
напиток: напитками
наполнить: наполнены
наполняться: наполняется
напоминать: напоминают напоминающий
направиться: направились
направление: направление направлению
направо: направо
например: например
напротив: напротив
напускать: напускает
нарисовать: нарисовала нарисовано
нарушение: нарушении нарушение
нарушить: нарушили
насест: насестах
насильственный: насильственной
наследник: наследником
настолько: настолько
настроить: настрой
насущный: насущная
насчитывать: насчитывают
натворить: натворил
наткнуться: наткнувшись
натуральный: натуральную
натянутый: натянутые
наука: науки
научить: научил
научиться: научиться научилась
находить: находят находит
находиться: находящиеся находиться находящаяся находится находящейся находятся находящееся
находчивость: находчивость
начало: начало начале началу началом начала
начальный: начальных начальной
начинать: начиная
начинаться: начинаются начинается
начисление: начислении
начислить: начисленные начислены
начислять: начисляют
начистить: начищенные
наш: наших
небо: небом небес небо неба
небольшой: небольших небольшой небольшая
невезучий: невезучего
невербальный: невербальным
невидимка: невидимкой невидимку
невидимый: невидимого
невилл: невилл
невилла: невилла
невиллу: невиллу
невозможно: невозможно
невозможность: невозможность
невозможный: невозможной невозможна невозможным
невский: невский
невыдержанный: невыдержан
невыполнение: невыполнение
недалекий: недалеко
недельный: недельные
неделя: неделю недель
недовольство: недовольства недовольство
недостоверный: недостоверный
недоступный: недоступны
неживой: неживые
незаконно: незаконно
незнакомый: незнакомой
неизвестно: неизвестно
неизвестный: неизвестна
неиспользуемый: неиспользуемых
нейтрализация: нейтрализации
нейтрализовать: нейтрализуют
нейтралитет: нейтралитет
некий: некое некоего
некоммерческий: некоммерческой
некоторые: некоторыми некоторых некоторые
нелегко: нелегко
нельзя: нельзя
нелюбимый: нелюбимый нелюбимым
немедленно: немедленно
немногие: немногих
немного: немного
немыслимый: немыслимых
ненавидеть: ненавидимый
необходимо: необходимо
необходимость: необходимость
необходимый: необходимых необходима необходим
необычайный: необычайные
необязательный: необязательный необязательные
неожиданно: неожиданно
неожиданность: неожиданностью
неопр: неопр
неофициальный: неофициальных
неписаный: неписаных
неполный: неполный
непосредственно: непосредственно
неправильный: неправильный
неприязнь: неприязнь
непростительный: непростительным
непроходной: непроходные
несколько: нескольких несколько
несовершеннолетний: несовершеннолетним несовершеннолетних
несправедливый: несправедливо
нестабильный: нестабильна
нести: неся нести
несчастие: несчастьями
неудобно: неудобно
неукоснительный: неукоснительно
неуничтоженный: неуничтоженный
нечистокровный: нечистокровные
нечисть: нечисти
нижний: нижнюю
низкий: низких низкие низкая ниже низкого низкими низким
никак: никак
никнуть: ник
никогда: никогда
никто: никто никому
нимфадора: нимфадора
нимфадоре: нимфадоре
ница: ница
ниша: ниши
новичок: новичок
новоприбывший: новоприбывший
новый: новый новую новой новые
нога: ног ноги ногу
ножка: ножками
норберт: норберта
норвегия: норвегии
норрис: норрис
нос: носа
носить: носила
ночное: ночных
ночь: ночью
ноябрь: ноября
нравиться: нравится
нуждаться: нуждался нуждающимся нуждающегося
нужно: нужно
нужный: нужен нужные нужное
нумерологии: нумерологии
нумерология: нумерология
нынешний: нынешнего нынешнее нынешний
об: об
оба: обеим
обвалиться: обвалился
обвинение: обвинение
обед: обеда обедов
обеденный: обеденный
обездвиживает: обездвиживает
обезоруживать: обезоруживающему
обеспечить: обеспечить
обещать: обещая
обжалование: обжалованию
обзавестись: обзавелись
обивка: обивкой
обиталище: обиталищем
обитание: обитания
обитатель: обитателями
обитать: обитает обитают
обладать: обладает
область: область
обливать: обливает
облик: облике
обмен: обмен
обнаружить: обнаружил
обо: обо
обогрев: обогрева
обозначать: обозначают
обозначить: обозначена
оборотень: оборотень оборотней оборотни
оборотный: оборотного оборотным
оборудовать: оборудована
образ: образом
образование: образовании
обратный: обратно
обращение: обращения
обставить: обставленная обставленной обставлены
обсуждение: обсуждение
обустраивать: обустраивал
обустроить: обустроен
обучать: обучал
обучаться: обучаются
обучение: обучения обучение
обучить: обучить
общаться: общаться
общежитие: общежитиям
общественный: общественные
общешкольный: общешкольного
общий: общие общая общей общими
объект: объектов объекты
объявление: объявления объявлений
объявлять: объявляют объявляя
объяснить: объяснил объяснила
объяснять: объясняет
объясняться: объясняется
обычно: обычно
обычный: обычными обычных обычные обычный обычным
обязательно: обязательно
обязательный: обязательным
обязать: обязаны
овальный: овальную
овощ: овощи
огарок: огарки
огг: огг
оглашать: оглашает
огонь: огонь огня огней
огород: огород
огорчать: огорчает
ограждать: ограждающие
ограничить: ограниченном ограниченное
огромный: огромный огромная огромные огромных огромную огромное
огурец: огурец
ода: од
одежда: одежда
один: одну одной одна одном одних одного один одному одно одним одни
однажды: однажды
однако: однако
одновременный: одновременным
одноглазый: одноглазой
одолевать: одолевают
ожидать: ожидаемого ожидает
ожить: ожившие
озеро: озеро озером озера
означать: означает означающего
оказать: оказать
оказаться: оказался оказавшееся оказавшегося оказались
оказывать: оказывает
оказываться: оказываются оказывается
окно: окнами окна окно окнах окон
около: около
окончание: окончании
окончательный: окончательный
окончить: окончила
окошко: окошки
окрестность: окрестности
окружать: окружающих окружают
оксфордский: оксфордского
октябрь: октября
оловянный: оловянный
омут: омут омуте
он: нему
они: им них ними
онлайн: онлайн
оно: оно
опасно: опасно
опасный: опасных опасные опасным опасны
опекун: опекунов опекуны опекунами
операция: операции
опечатать: опечатаны
описание: описания описание
описать: описано
описываться: описывается описывался
оповещать: оповещает
опоясывать: опоясывающих
определять: определял
опровержение: опровержение
опускать: опускает
опушка: опушке опушка
опытный: опытными
оранжерея: оранжереи
организация: организации
организоваться: организуются
орден: ордена орден
орел: орла
оригинал: оригинала оригинале
оригинальный: оригинальный
освещать: освещают
освещаться: освещаются
освободить: освободило
освободиться: освободилась
оскорбление: оскорблений
основание: основания
основатель: основателя основателей основатели основатель
основать: основанные основан
основное: основном
основной: основной основная
особенно: особенно
особенность: особенность особенностью особенности
особо: особо
особый: особом особая особых особые
осознать: осознав
оставаться: остаются
оставить: оставленных оставленном оставив
оставлять: оставлять оставляет
остальное: остальные остальных остальными остальным
остаться: оставшимся оставшиеся остаться осталась
осторожно: осторожно
остроконечный: остроконечная
остролист: остролиста
остроумие: остроумие
осуждать: осуждала
отбивать: отбивавший
отбирать: отбирали
отбор: отборе отбора
отбрасывать: отбрасывает
отбывать: отбывают
отвергнуть: отвергнуто
отвести: отведена
ответ: ответ
ответить: ответив
ответственность: ответственности
отвечать: отвечает
отвратительно: отвратительно
отдать: отдать отдана
отдельный: отдельный отдельном отдельных отдельные отдельное
отдых: отдыха
отдыхать: отдыхать
отец: отца отцом
отказ: отказ
отказать: отказал
отказаться: отказаться
отключать: отключали
откровенно: откровенно
открывать: открывала открывают открывая открывает
открываться: открывается открываются
открытие: открытия
открыть: открыл открытый открытая открыт открыть открыта
открыться: откройся
откуда: откуда
отличаться: отличаться отличается
отличительный: отличительные
отмена: отмены
отменить: отменить отменены
отмерять: отмеряют
отметить: отметили отметить
отметка: отметки
отмечать: отмечали отмечают
относиться: относятся
отношение: отношения
отныне: отныне
отображать: отображать
отобрать: отобранные
отпор: отпор
отправить: отправлены отправлена
отправиться: отправившись отправился отправиться
отправлять: отправляет
отправляться: отправляются отправляется
отпровляются: отпровляются
отпускать: отпускают
отражать: отражавший
отредактировать: отредактирована
отрубать: отрубает
отряд: отряда отряд отряду отрядов
отсидка: отсидки
отставка: отставку
отстранение: отстранение
отступить: отступить
отсюда: отсюда
оттуда: оттуда
отходить: отходящий
отчасти: отчасти
отчисление: отчисления
отчитываться: отчитывается
отъехать: отъедет
оформить: оформленное
охарактерилизавала: охарактерилизавала
охранять: охраняет охраняющая
охраняться: охраняются охраняется
оцениваться: оцениваются
оценка: оценка оценку оценок оценки
очаг: очаг
очевидно: очевидно
очень: очень
очередной: очередном очередного
очередь: очередь
очистить: очистить
очки: очки очков
очутиться: очутился
ошибка: ошибке ошибки
п: п
паблишер: паблишер
павильон: павильоне
падать: падает падают
паддифут: паддифут
пазлвуд: пазлвуд
палата: палата палате
палец: пальцев
палка: палкой
палочка: палочку палочка палочки палочкой
памятный: памятна
память: памяти память
пар: пара
парадное: парадного
парадный: парадная
параллельный: параллельные
парить: парят
парк: парк
пародия: пародии
пароль: паролем пароль пароли
парочка: парочек
парта: парты
пасха: пасху пасха
пасхальный: пасхальными пасхальные
патронуса: патронуса
патронусу: патронусу
паук: паук пауков пауки пауками
пахнуть: пахнет
пенелопа: пенелопой пенелопа пенелопы
первое: первого первое первых первые первыми первом
первокурсник: первокурсников первокурсник первокурсникам первокурсники
первостепенный: первостепенных
первый: первой первую первая первый
пергамент: пергамента
перевод: переводах переводе переводом перевода
переводиться: переводится
перед: перед
передать: передать
перейти: перейти перешедший
перекусить: перекусить
перемещение: перемещение
перемирие: перемирие
перенаправить: перенаправлено
переноситься: переносится
перепрыгивать: перепрыгивая
перерастать: перерастает
перерыв: перерывом
пересекать: пересекала пересекают
пересечение: пересечения
перестать: перестал
переть: при
переулок: переулке
переход: перехода
переходить: переходит
периметр: периметру периметр
перо: перья перо
перпендикулярный: перпендикулярно
перси: перси
персонаж: персонажи
персонал: персонал персонала
персональный: персональные
перчатка: перчаток
песнь: песни
песня: песню
песочный: песочные
песчинка: песчинок
петтигрю: петтигрю
петь: пела пели
печать: печати
пещера: пещеру
пивз: пивз
пиво: пиво
пинс: пинс
пир: пир пира
писательница: писательницы
письменный: письменный письменное письменные
письмо: письмом письму писем
питаться: питающихся
питер: питер питера
питомец: питомцы
пить: пить
плакса: плаксу плаксы плакса
плаксивый: плаксивое
пламя: пламени
план: планы план
планет: планету планет
планировка: планировке
платный: платные
платформа: платформами платформы платформу
платье: платье
плащ: плащ
плен: плен
пленный: пленному
плечо: плечах
плод: плоды
площадка: площадка площадке площадку площадки
площадь: площадь
победа: победу победы
победить: победил
побеждать: побеждает
побить: побитое
побывать: побывала
повар: поваром поварами
поведение: поведение поведения
поверженный: повержен
повернуть: повернув
повествование: повествовании повествования
повиноваться: повинуется
повод: поводу
погиб: погиб
погибать: погибает
поговорить: поговорить
погода: погоды погоду
погодный: погодных
погодя: погодя
подать: подал подано поданы
подвал: подвал
подвешивание: подвешивание
подготовка: подготовки
поддерживать: поддерживают поддерживать
поддержка: поддержку
поджигать: поджигает
подземелье: подземелья подземельях подземелье
подлежать: подлежит
подниматься: поднимаются поднимающихся поднимается
поднос: поднос
подобие: подобие
подобно: подобно
подобный: подобные подобном
подойти: подойти
подоспеть: подоспевшим
подразделение: подразделения
подразделить: подразделить
подробный: подробнее
подсказка: подсказку
подтвердить: подтвердила
подтягиваться: подтягиваются
подумать: подумал
подушка: подушками подушки
подходить: подходящую
подчиняться: подчиняется
подъездной: подъездная
поевляется: поевляется
поединок: поединок
поезд: поезд поезде
пожертвование: пожертвований
пожертвовать: пожертвовать
пожизненный: пожизненному
пожиратель: пожирателям пожирателей пожиратель пожирателем пожиратели
позаботиться: позаботилась
позади: позади
позаниматься: позаниматься
позволять: позволяла позволяя позволяет позволяющим
поздний: позже
позор: позором
поиск: поисках поиск поиску
пока: пока
показательный: показательной
показать: показан
показывать: показывают показывал
покатый: покатую
покидать: покидают
покинуть: покинуть покинул
покончить: покончил
покорить: покоривший
покупать: покупают
покупка: покупки покупкой
пол: поле полу пол
полагать: полагали полагая
полдень: полдень
полезность: полезности
полезный: полезным полезной
ползучий: ползучих
политик: политика политике
полномочие: полномочий
полностью: полностью
полночь: полночь
полный: полной полном полный полная
половина: половину половина
полок: полке полки полках
полтергейст: полтергейстах полтергейст
полувеликан: полувеликана
полукровка: полукровка
полумна: полумна
полумной: полумной
полумрак: полумрак
полуночь: полуночи
получать: получают
получить: получила полученные получили получит получив получить получившие
получиться: получилось
полчаса: полчаса
полчище: полчища
пользоваться: пользуются пользуясь пользовался пользуется
поляна: поляна
полянка: полянка
помещение: помещения помещение помещений помещении
помимо: помимо
помона: помона
помочь: помочь
помощь: помощью помощь
помфри: помфри
поначалу: поначалу
понимать: понимает
понравиться: понравился
понятие: понятия
понятно: понятно
пообщаться: пообщаться
поощрение: поощрения
поп: попов
попадание: попадание
попадать: попадали попадает попадать попадают
попасть: попав попал попасть
попасться: попалась
попечитель: попечителей
попечительский: попечительский
поправка: поправки
попросить: попросить
популярность: популярностью
популярный: популярны
попытаться: попытавшуюся попытаться
попытка: попыток
пора: пор
поражать: поражает
поразить: поразить
порка: порка
порог: порог
порода: пород
порождать: порождают
портал: портал порталы порталов
портрет: портрета портретом портрет портреты
портус: портус
поручение: поручений
поручить: порученного
порыв: порыве
порядком: порядком
порядочный: порядочными
посетитель: посетителя
посещать: посещать посещают
посещение: посещения
поскольку: поскольку
последний: последнее последний последние последней последним
последующий: последующего
послушный: послушными
посол: после
посредство: посредством
пост: посту пост
поставить: поставленная поставленный поставить
постепенно: постепенно
постоянно: постоянно
постоянный: постоянная
поступить: поступил поступить поступит
поступление: поступление поступления
поступок: поступка
постучать: постучать
посылать: посылает
посылаться: посылается посылаются
посылка: посылок
потайной: потайной потайном потайных потайные потайного
потенциал: потенциалом
потеря: потери потерю потере
потерять: потеряло
потолок: потолка потолке потолку потолком потолок
потомство: потомство
потребность: потребностями
потрясать: потрясающий
поттер: поттером поттер поттера поттеров поттеру поттере
поттеромания: поттеромания
похитить: похитил
похмелие: похмельем
похоже: похоже
похожий: похожее похож
поцеловаться: поцеловался
поцелуй: поцелуй
починить: починить
почитать: почитать
почта: почту
почтить: почти
пощада: пощаду
пощекотать: пощекотать
поэтому: поэтому
появиться: появится
появление: появление
появляться: появляются появлялись появляется
правда: правду
правильно: правильно
правильный: правильных правильный правильное
править: правило править правил
правка: правок правки
правый: права право
праздник: праздник праздников праздники
практиковать: практиковать
практический: практическим практически практические
пребывание: пребывания
превосходный: превосходно превосходной
превратиться: превратилась превратится
превращать: превращать
превращаться: превращается
превращение: превращения
предать: предали
предел: пределах
предлагать: предлагает
предложить: предложил
предмет: предметов предмета предметы предметам предмете предмет предметом предмету
предназначаться: предназначался
предназначить: предназначены предназначена
предоставится: предоставится
предположительно: предположительно
предположить: предположить
предпоследний: предпоследнего
предпочитать: предпочитают
предсказание: предсказание предсказания
представиться: представились
представлять: представляют представляет
предугадывание: предугадывания
предшественник: предшественника предшественник
предшествовать: предшествовавшие
предыдущий: предыдущих
предыстория: предыстория
преемник: преемник
преемственность: преемственность
прекрасный: прекрасный
прекратить: прекратить
премиальный: премиальные
пренебрежение: пренебрежением
преображение: преображение
преобразиться: преобразиться
преподавание: преподавания
преподаватель: преподаватель преподавателей преподавателями преподавателя преподаватели преподавателем
преподавательский: преподавательский
преподавать: преподавала преподаваемой преподавал преподававший
претруднейшая: претруднейшая
преувеличение: преувеличением
прибежище: прибежище
прибор: приборы
прибывать: прибывают прибывать прибывает
прибытие: прибытием
привезти: привезти привезла
привести: привести
привидение: привидение привидения
привилегия: привилегиями
привлечь: привлекли
приводить: приводили
приводиться: приводится
привозить: привозил
приглашение: приглашение приглашения
приговорить: приговорены
пригодиться: пригодилась
пригород: пригороде
придвинуть: придвинуть
придира: придира
придирка: придирок
приезжать: приезжает
прием: приеме
призрак: призрак призраков
призывать: призывает
прийти: придя пришедшие
приказ: приказу
приказать: приказал
прикосновение: прикосновения
прикоснуться: прикоснуться
прикроватный: прикроватный
прилегать: прилегающую
приманить: приманив
применительно: применительно
пример: примеров
примерный: примерно
примечание: примечания
примыкать: примыкающая примыкает
принадлежать: принадлежавших принадлежат
принимать: принимавшие принимать
приниматься: принимаются принимается
приносить: приносят
принц: принц
принципиальный: принципиальных
принять: принято
приостанавливать: приостанавливает
приравнять: приравненные
природа: природой
прислушаться: прислушавшись
присмотреться: присмотреться
пристальный: пристальней
пристанище: пристанищем
присутствовать: присутствует
притворяться: притворяется
прихватить: прихватив
приход: прихода
приходиться: приходится
причем: причем
причина: причине причина
причинять: причинять
приют: приют
приятный: приятной
про: про
пробираться: пробирается пробираются
пробраться: пробрался
проваливаться: проваливается
проведение: проведение проведения
проверить: проверенной
проверка: проверки
проверяться: проверялась
провиниться: провинившихся
проводить: проводит проводил проводят проводили
проводиться: проводятся проводилось проводились
программа: программе
прогулка: прогулки
продажа: продаже продажу
продержаться: продержаться
продолжать: продолжала продолжают продолжает
продолжаться: продолжаются
продолжение: продолжение продолжения
продукция: продукции
проезжать: проезжая
проект: проектах
проживать: проживает
прозрачный: прозрачный
произведение: произведениях
произведенье: произведений
произвести: произведены
производство: производство
произнесение: произнесением
произносить: произносит
произношение: произношение
произойти: произошло
произрастание: произрастания
происходить: происходит
происхождение: происхождение
пройти: пройдя пройти прошло прошли
пройтись: пройтись
проклясть: проклятое
проклятие: проклятии проклятия проклятие
промах: промахи
проникать: проникает
проникнуть: проникнуть
пропадать: пропадал
прорвать: прорвали
прорицание: прорицания
пророк: пророке пророка
пророчество: пророчество пророчества
прорываться: прорывается
просидеть: просидел
просить: просил просит
просматривать: просматривал
просмотр: просмотры
просмотреть: просмотрев
просто: просто
простой: простая простых
просторный: просторные просторная просторную
пространство: пространстве пространства
проступок: проступки проступок
простучать: простучать
просьба: просьбе
протекать: протекают
против: против
противник: противники
противоречивый: противоречивы
прототип: прототип
протяжение: протяжении
профессия: профессия профессий
профессор: профессором профессора профессор профессору профессорами профессоров
проход: проходе проходу прохода проход
проходить: проходили проходит проходила
проходная: проходные
процесс: процессом
прочесть: прочесть
прочий: прочей прочее
прочитать: прочитал
прошлый: прошлом
проявитель: проявитель
проявлять: проявлял
прямая: прямой
прямик: прямиком
прямой: прямо
прятать: прятала
психически: психически
психолог: психологов
психологический: психологический
психотерапевт: психотерапевта
птица: птиц
птичий: птичьи
публиковать: публикует
пузырь: пузыри
пункт: пункты пунктом
пустой: пустые
путеводитель: путеводитель
пуфик: пуфиках пуфики
пуффендуй: пуффендуй
пуффендуйских: пуффендуйских
пуффендуйцы: пуффендуйцы
пуффендуя: пуффендуя
пухлый: пухлые
пушистика: пушистика
пыльный: пыльные
пытать: пытать
пытаться: пытался пыталась пытается
пыхтеть: пыхтели
пьеса: пьесе
пята: пятой
пятидесятифутовой: пятидесятифутовой
пятикурсник: пятикурсники
пятница: пятницу
пятый: пятом пятый
пять: пять
работа: работе работы работа работу
работать: работают работал работает работающее
работник: работниках
рабочий: рабочих рабочего
равный: равна
ради: ради
радио: радио
раз: раза
развалина: развалины
разве: разве
развесить: развешены
развешать: развешаны
развиваться: развиваются
разводить: разводят
разгадать: разгадать
разгласить: разгласил
разговор: разговора
разгром: разгром
разгромить: разгромил
раздевалка: раздевалки
раздел: разделам
разделительный: разделительный
разделить: разделив
раздражение: раздражение
различный: различными различные различных
размер: размерам размер размеру размерах размеров
разместиться: разместиться
размещение: размещением
разнообразный: разнообразными разнообразные разнообразных
разный: разной разных разные
разработчик: разработчики
разрешать: разрешали
разрешаться: разрешается
разрешение: разрешение
разрешить: разрешенным разрешены
разъяснять: разъясняет
раковина: раковине раковин
раненый: ранены
ранний: раньше
рано: рано
раскаяться: раскаялся
распахиваться: распахивается
расписание: расписание расписания
располагаться: располагаются располагается
расположить: расположенный расположена расположен расположены
расположиться: расположился
распорядок: распорядка
распределение: распределение распределении распределением распределения
распределительный: распределительная
распределять: распределяющей распределяющая распределяет распределяющую
распределяться: распределяется распределяются
распространять: распространяет
рассвет: рассвет
рассеять: рассеян
рассказ: рассказы
рассказать: рассказал рассказала
рассказывать: рассказывает рассказывал
рассказываться: рассказывается
расслабиться: расслабиться
рассмотреть: рассмотреть
расставить: расставлены
расстановка: расстановка
расстояние: расстояние
растение: растениям растения
растенье: растений
расти: растут
растительность: растительность
растить: растил
раструбить: раструбила
расходиться: расходятся
расширение: расширения расширение
реагирование: реагирование
реально: реально
реальный: реальный реальной
ребенок: детей детям дети
ребята: ребята ребятам
регистрировать: регистрирует
регулус: регулус
реддл: реддл
реддла: реддла
реддлом: реддлом
редкий: редкими
редко: редко
резной: резными
результат: результат результате результаты
реклама: рекламу
религиозный: религиозные
ренегат: ренегат
репутация: репутацией
ресурс: ресурсы
рецепт: рецептам
речь: речь
решать: решаемый решает
решение: решение
решительность: решительность
решить: решено решил
риктусемпра: риктусемпра
римус: римус
римуса: римуса
римусом: римусом
рита: рита
ритм: ритме ритм
ровный: ровным ровно
родитель: родителями родителей родителях родители
родные: родным
родственник: родственники
рождение: рождение
рождественский: рождественские рождественскими
рождество: рождество
розга: розгами
розовый: розовом
ролинг: ролинг
роль: роль
роман: романов романе
ромильда: ромильда
рон: рону роном рона рон
рот: рта
роулинг: роулинг
рубеус: рубеус
рубеуса: рубеуса
рубин: рубины
руквуд: руквуд
руководить: руководит
руководство: руководстве руководства
рукопись: рукописи
рукопожатие: рукопожатиями
румыния: румынии
руна: руны
руно: рунами рун
русалка: русалки
русская: русскими
русский: русский
русскоязычный: русскоязычным
русый: рус
ручка: ручку
ряд: рядом
сад: сад
садиться: садятся
сайт: сайте
салазар: салазар
салазара: салазара
салазаром: салазаром
салемский: салемских
сам: самого самой самом сами самому саму сама самое
самопожертвование: самопожертвование
самый: самый самая самым самых самые
сантиметр: см
сапфир: сапфиры
саундтрек: саундтрек
сбежать: сбежала
сбор: сбора
сборная: сборной
сбрасывать: сбрасывает
сбываться: сбываются
св: св
сведение: сведения сведений
свежесть: свежесть
свежий: свежие
сверх: сверх
сверху: сверху
свет: светом
светило: светил
светильник: светильники
светлана: светлана
свеча: свечей
свечение: свечение
свидетель: свидетелями
свисать: свисающей
свиток: свиток
свобода: свободы
свободно: свободно
свободный: свободное свободной
свое: своих свои своему своего своим своими
своеобразный: своеобразной
свой: свой своей своя свою
свойство: свойствам свойство
связанный: связанные связана связан связаны
связаться: свяжитесь
связь: связи
святой: святого
святочный: святочный святочном святочного
сгореть: сгорела
сдавать: сдают сдававшие сдаваемые
сдаваться: сдаются
сдать: сдаст сдать
сдача: сдачи
сделать: сделает сделанные сделала сделана
себя: собой
север: север севере северу
северный: северная
северо: северо
северус: северус
северуса: северуса
северусом: северусом
сегодня: сегодня
седрик: седрика
седьмой: седьмым седьмом седьмой
сей: сих
секрет: секрету
секретный: секретную
секция: секции секцию секция
селвин: селвин
селить: селит
семейство: семейство семейства
семестр: семестра семестры
семикурсники: семикурсники
семиэтажный: семиэтажный
семнадцатилетний: семнадцатилетнего
семь: семь семи
семья: семей семьи
сентябрь: сентября
септима: септима
серебристый: серебристый серебристая
серебряный: серебряные серебряный серебряная
сериал: сериал
серия: серию серия
серый: серая
сеть: сеть сетью
сжечь: сожгло сожжена
сзади: сзади
сивилла: сивиллу сивилла
сивый: сивый
сидение: сидения
сидеть: сидит сидят сидя
сила: силу сил силы
силок: силки
сильный: сильно сильное
синий: синий
синистра: синистра
сипуха: сипухи
сирена: сирену
сириус: сириуса сириус сириусе сириусом
система: системе система
ситуация: ситуациях ситуация ситуации
ситцевый: ситцевых
сказать: сказать сказано сказал сказала
сказка: сказок сказки
сказочный: сказочную
скамейка: скамейки
скамья: скамьи скамьям
скатываться: скатываются
скачать: скачать
сквозить: сквозит
сквозь: сквозь
скелет: скелетами
скитер: скитер
сковородка: сковородки
скорпиус: скорпиус
скорый: скорее
скрываться: скрывается
скрытый: скрытые
скулить: скулящее
скучный: скучны
слабый: слабо
сладкое: сладком сладкое
сладость: сладостей
слева: слева
следить: следит следить
следовать: следует следуют
следующий: следующем следующие
сливочный: сливочное
слизерин: слизерин
слизерина: слизерина
слизерине: слизерине
слизерином: слизерином
слизеринских: слизеринских
слизеринцев: слизеринцев
слизеринцы: слизеринцы
слизнорт: слизнорт
слизнортом: слизнортом
словарь: словари
слово: слов словам слова слово
сложно: сложно
сломать: сломанную
сломить: сломлено
служебный: служебные
служилый: служил
служить: служивший служит служить
случай: случая случае случаях случаями
случайный: случайная
случаться: случается
слушать: слушает
смена: смене
смертельный: смертельную смертельно
смертный: смертной смертным
смертоносный: смертоносное
смерть: смертью смерть смерти
сместить: сместить
сметливый: сметливых
смотровой: смотровую смотровая
смочь: сможет смог
смутить: смутил
смысл: смысл
снегг: снегг
снегга: снегга
снеггом: снеггом
снейп: снейп
снейпа: снейпа
снести: снесли
снизу: снизу
снимать: снимать снимают
сниматься: снимается снимаются
снитче: снитче
снятие: снятие снятии
снять: снято снят сняты снял
собирать: собирали
собираться: собирался собиралась собираются собирается
соблазнить: соблазнить
соборный: соборные
собрание: собрания
собрать: собраны
собственный: собственной собственные собственному собственная собственным
событие: события событий событие событиях
сова: сову сов совы совам
совершенно: совершенно
совершеннолетний: совершеннолетним
совет: советом совет
совиный: совиным
совятник: совятник
совятню: совятню
совятня: совятня
согласно: согласно
содержание: содержание
созвездие: созвездий
создавать: создавать
создание: создания создании создание
создатель: создатели создателям
создать: создана созданных созданной создать
сознание: сознание
соискатель: соискателя
сок: соки
сокровище: сокровищем
солнечный: солнечный солнечным
солома: соломой
сон: снов сны
сообщать: сообщают
сообщество: сообщество
сообщить: сообщить
соответственно: соответственно
соответствие: соответствии
соответствовать: соответствует
соответствующий: соответствующей соответствующих
соперник: соперников
соперничество: соперничество
сопровождать: сопровождавшие
сопровождение: сопровождения
сопротивление: сопротивление сопротивлению
соратница: соратницы
соревнование: соревнованиях соревнования соревнование
соревноваться: соревнуются
сослаться: сошлись
сосновый: сосновая
сосредоточиться: сосредоточившись
состав: составе
составить: составили составившие
составление: составление
состояние: состояние состоянии состоянием
состоять: состоящим состоит состоящую
сотня: сотни
сотоварищ: сотоварищи
сохранение: сохранением
сочинение: сочинение
спальная: спальных
спальный: спален
спальня: спальня спальням спальни спальне
спать: спящего спят
сперва: сперва
спереди: спереди
специализироваться: специализируется
специальный: специальная специальный специальную специальное
специфический: специфические
спина: спине
список: список
сплошной: сплошной
спокойный: спокойно
спонджифай: спонджифай
спора: споры
спорт: спорта
способ: способа способам способ способом способы способах
способный: способном способно
справа: справа
справиться: справиться
справка: справка
спрятать: спрятанных спрятан спрятал
спрятаться: спрятаться
спуск: спуску
спускаться: спускается
спустя: спустя
сражаться: сражавшиеся сражается сражающихся сражающийся сражаться
сражение: сражениях сражения сражение
сразу: сразу
среда: сред
среди: среди
средиземья: средиземья
средневековье: средневековье
средний: среднее среднего
средство: средства
срок: срока
српски: српски
српскохрватски: српскохрватски
ссылка: ссылка ссылками ссылки
ставить: ставит
стадион: стадиона
стадо: стада
стакан: стаканами
сталкиваться: сталкиваются
стандартизированный: стандартизированные
стандартный: стандартный стандартное стандартным
становиться: становящаяся становились
станция: станция станции
старенький: старенький
старинный: старинный старинной
старичок: старичков
старое: старыми
старомодный: старомодной
староста: старосту староста старосты старост старостой старостами
старшеклассник: старшеклассниками старшеклассников
старшекурсник: старшекурсники
старший: старших старшие
статистика: статистика
статуэтка: статуэтки
статуя: статуе статуей статуями статуя статую статуи
стать: стал стало стала ставший стали станет
статья: статью статья статьи
стебель: стебли
стебль: стебль
стеклянный: стеклянный стеклянных
стеллаж: стеллажей стеллаже
стен: стенам стены стен стена стенах стенами стене
стена: стеной
стенд: стенды стенд стенде
стервовизоры: стервовизоры
стереть: стереть
стиль: стиле
стихийный: стихийного
стихия: стихии
стоимость: стоимость
стоить: стоят стоит
стол: столам стол стола столами столом столов столы
столб: столбами столба
столетие: столетий
столик: столиками столик столиков
столь: столь
столько: столько
сторона: стороны сторонам стороне сторон сторону
сторонник: сторонников
стоять: стояли
стр: стр
страж: стражем стража
страна: странах стране
страница: страницы страница страницу странице страницам
странный: странные
страшный: пострашнее
стремительно: стремительно
стремиться: стремись
строгий: строго
строчок: строчку
струйка: струйки
структурированный: структурирован
студент: студентам студент студентом студенты студентов студента студентами студенту
студенческий: студенческим студенческая
стул: стулья стульями стульев
ступенька: ступеньки ступенек ступенька ступенькам
стучать: стучать стучащего
судить: судя судить
судьба: судьба
суматоха: суматохой
суметь: сумела
суперотменное: суперотменное
существо: существо существ существа существами
существование: существовании существования
существовать: существуют существовал существует существующий
схватка: схватку схватки
сходство: сходство сходства
считать: считая считает считал считавшие считала считают
считаться: считается
сын: сына сын сыну
сэр: сэра
сюда: сюда
сюжет: сюжета
сяк: сяк
т: т
табличка: таблички табличкой табличка
табурет: табурет
тайный: тайная тайные тайных тайную тайны
также: также
таки: таки
таков: такова
таковой: таковыми
такой: такой такое таким такая такие
талантливый: талантливейшей
талисман: талисман
тараканий: тараканьи
татарча: татарча
тварь: твари тварей
твердить: твердил
творчество: творчество
текст: текст текста
текущий: текущие текущего текущая
телепортируют: телепортируют
телескоп: телескопами телескоп
телесный: телесные телесных телесным
тело: тело
тем: тем
тематический: тематический
темный: темно темный
теплица: теплицы
тереть: три
термин: термина
территория: территорию территории
терять: теряет теряя
теснить: теснимые
тесноватый: тесновата
тест: тест
течение: течение
тип: тип
типичный: типично типичное
тиски: тиски
тлеть: тлеющее
товарный: товарный
толкиену: толкиену
толкование: толкование
толстый: толстыми толстый толстой
том: томом тома
тон: тонах
тонкс: тонкс
тоннель: тоннель
тот: том ту тех те тот тому той та
точка: точки
точно: точно
точный: точная
трава: травами
травологией: травологией
травологии: травологии
травология: травология
традиция: традицией традиции традиций
трактир: трактира трактир
трансгрессировать: трансгрессировать
трансгрессия: трансгрессия трансгрессию трансгрессии
транспортироваться: транспортируются
трансфигурации: трансфигурации
трансфигурацию: трансфигурацию
трансфигурация: трансфигурация
трапезный: трапезная
тратить: тратя
требование: требования
требовать: требует требующими требуют
требоваться: требуется
трелони: трелони
тренировать: тренировать
тренировка: тренировки
треснуть: треснутый
третий: третьей
третье: третьем третьи третьего
трещать: трещали
трибун: трибуны трибунах
триместр: триместра
трит: трит
тролль: тролль троллями
тронуть: тронь
трофей: трофеев
трофейный: трофейная трофейную
труба: трубы
трудолюбие: трудолюбие
трюк: трюк
туалет: туалет туалете туалета туалетов
туда: туда
туннель: туннель
тупиковый: тупиковым
тупой: туп
турнир: турниры турнира турниру турнире
тыква: тыквы
тыквенный: тыквенный
тыл: тыл
тысяча: тысячи
тюленевый: тюленев
тяжелый: тяжело
тяжесть: тяжести
тянуться: тянулись
убежище: убежищем
убивать: убивает
убийство: убийстве убийства убийство
убийца: убийцей убийца
убирать: убирает
убить: убитой убил убить убиты убит
убранство: убранство
уважение: уважением
уверить: уверен
увешать: увешан
увидеть: увидеть
уволиться: уволился
уворачиваться: уворачивается
угрожать: угрожать
угроза: угрозу
удар: ударов
ударять: ударяют
удаться: удалось
уделяться: уделяется
удобно: удобно
удовлетворительный: удовлетворительно
удовольствие: удовольствием
ужин: ужинов
ужинать: ужинают
узкий: узкие
узнать: узнают узнала узнать узнал
узник: узник
уизли: уизли
уилки: уилки
уйзли: уйзли
указание: указанием
указать: указан
указываться: указывается
украсить: украшенный украшенной
украсть: украсть
украшение: украшение
укрыться: укрыться
уксус: уксусом
укус: укусов
улетать: улетают
улица: улице
ультиматум: ультиматума ультиматум
ум: ума ум
умение: умений
уменьшаться: уменьшается
уметь: умеют
умещаться: умещались
умирать: умирать
умный: умных
уничтожать: уничтожать уничтожает
уничтожение: уничтожения
уничтожить: уничтожить уничтожен
уотфорда: уотфорда
упоминать: упоминает
упоминаться: упоминаются упоминается
упомянуть: упомянутые
упорный: упорных
управлять: управляют
уровень: уровне уровень уровня
уродливый: уродливое
урок: уроке уроки уроков уроках урок урока
ус: усы
условие: условий условия
условно: условно
условный: условным
успевать: успевает
успеть: успел
успех: успехи
успешный: успешный успешно
успокоить: успокоить
установить: установлены установили
устлать: устлан
устраиваться: устраиваются устраивается
устрашать: устрашающий
устройство: устройством
уступать: уступает
утренний: утренняя
утро: утром утра
ухаживание: ухаживания
уход: уходу ухода уход
уходить: уходя
участвовать: участвует участвуют
участие: участие
участник: участниками
учащийся: учащиеся учащийся
учебник: учебник учебников
учебный: учебный учебного учебных учебное
ученик: учениках учеников ученики ученик ученику ученикам ученика
ученица: ученицы
учесть: учесть
учитель: учителям учителя учителей
учительская: учительской
учить: учат учил учила учит
учиться: учиться учатся учившийся учились учившегося учился училась
уютный: уютные уютная уютное
фадж: фадж
фаджу: фаджу
фаза: фаза
факел: факелов факелами факелы
факт: фактов
фактически: фактически
фактор: фактор
факультатив: факультативов
факультативный: факультативные
факультет: факультету факультетов факультетах факультете факультеты факультетам факультетами факультетом факультета факультет
факультетский: факультетские факультетских факультетской факультетского факультетский факультетскими
фальшивый: фальшивые
фамилия: фамилии
фан: фан
фантастика: фантастики
фантастический: фантастические
фасад: фасадом
фасадный: фасадной
февраль: февраля
фейерверк: фейерверка
феникс: феникса феникс фениксом
фенрир: фенрир
фестралами: фестралами
фестралах: фестралах
фестралы: фестралы
фея: феи
филиус: филиус
философский: философский
филч: филч
филча: филча
фильм: фильму фильм фильме фильмов фильмах фильма
финальный: финальная финальной финальный финальное
финеас: финеас
флакон: флаконов
флитвик: флитвик
флитвиком: флитвиком
флоренц: флоренц
флоренца: флоренца
фолиант: фолианты
фолиантовый: фолиантов
фонарников: фонарников
фонд: фонд
фонтан: фонтана фонтан
форма: форме форму формы
формальный: формально
формула: формулы
форум: форум
фоукс: фоукс
фоуксом: фоуксом
франция: франции
французский: французского
фред: фред фреда
фрукт: фруктами
функционировать: функционировать
функция: функций
х: х
хагрид: хагрид
хагрида: хагрида
хагриду: хагриду
характер: характером характера
характеризовать: характеризуют
характерный: характерна
херес: хересом хереса
хижина: хижине хижину хижина хижины
хиромантия: хиромантия
хитрость: хитрость
хитрый: хитрых
хобби: хобби
хогвартс: хогвартс
хогвартса: хогвартса
хогвартсе: хогвартсе
хогвартские: хогвартские
хогвартский: хогвартский
хогвартским: хогвартским
хогвартсом: хогвартсом
хогвартсу: хогвартсу
хогсмид: хогсмид
хогсмида: хогсмида
хогсмиде: хогсмиде
ход: ходом ходы хода ходов ход ходе
ходить: ходить ходят
хозяин: хозяин хозяином
хозяйничать: хозяйничает
холл: холле холла
холодное: холодное
хороший: хорошую хорошими хорошим
хорошо: хорошо
хотеть: хочет хотел
хотеться: хотелось
хохбрунн: хохбрунн
храбрость: храбрость
храбрый: храбрых храброе
хранение: хранения
хранительница: хранительнице
хранить: хранить
храниться: хранятся
хрупкий: хрупкие
хрустальный: хрустальных хрустальный
хук: хук
хэллоуин: хэллоуин
хэллоуину: хэллоуину
царить: царит
цвет: цвета цвет
целиком: целиком
целитель: целителя
цель: целях цель целью
ценить: ценит
центр: центре
центральный: центральной центральная
цепь: цепи
церемония: церемония церемонии
цикл: цикла
цитата: цитаты
цитировать: цитировать
цокольный: цокольный
чаинка: чаинкам
чай: чай
чайный: чайной чайных
чар: чары чарам
чарити: чарити
чарли: чарли
чародейство: чародейства
час: час
часами: часами
часовой: часовое часовых
частить: части
частица: частицу
частично: частично
частное: частными
частность: частности
часто: часто
часть: частей часть
часы: часы часов часах
чаша: чашу
чашка: чашек
чаща: чаще
чей: чьи чьей
человек: человек человеку человека людей
чемпионат: чемпионат
через: через
честность: честность
честный: честных
честолюбие: честолюбие
честь: честь
четверг: четверг
четыре: четырьмя четыре
четырнадцать: четырнадцать
чинить: чинит
число: число числа числам числе
чистить: чистящие
чистокровный: чистокровными чистокровных
чистота: чистоте чистоту
чистый: чистой чистая
читальный: читальный
читать: читает читать
читаться: читается
член: члены членами
чтение: чтению
что: чему
чтобы: чтобы
чулан: чулан
шаг: шагов
шар: шар
шарлатан: шарлатаном
шармбатон: шармбатон
шаткий: шаткие
шербет: шербет
шест: шесты шестом шеста
шестая: шестой
шестикурсников: шестикурсников
шипучка: шипучка
широкий: широкую широкие широкая
шкаф: шкаф шкафы шкафами шкафов
школа: школа школу школе школой школах школы
школьник: школьники
школьный: школьный школьного школьные школьных
шляпа: шляпу шляпе шляпы шляпа
шоколадный: шоколадные
шотландия: шотландии шотландия
штаб: штаб
штат: штат
шутка: шуток
щекотать: щекочи
щит: щиты
щитовой: щитовые
эвакуация: эвакуация
эквивалент: эквивалент эквивалентами
экзамен: экзамене экзаменам экзамен экзамены экзаменах экзаменов
экземпляр: экземпляру
эклер: эклеры
экскурсия: экскурсию
экспеллиармус: экспеллиармус
экспресс: экспресс экспресса
экстренный: экстренных
электричество: электричестве
электронный: электронные
элемент: элемент
элементальной: элементальной
эльф: эльфах эльфа эльфов эльфы
эмблема: эмблема
энциклопедия: энциклопедии
эпилог: эпилоге
эпический: эпические
этаж: этаже этажами этажах этажа этаж
это: этом это этому
этот: этой этих эта эту
юго: юго
юноша: юношу
явление: явление
являться: являясь является являющиеся являются
язык: язык языках языка языке
яйцо: яйца яйцо
январь: января
янтарный: янтарный
ярость: ярость
ящик: ящике ящик ящиками ящиках
