август: августа
авторский: авторским
авторство: авторства
агрессивный: агрессивными
ад: ад ада
азербайджан: азербайджана
азкабан: азкабан
азкабана: азкабана
аида: аида
акромантул: акромантул
акромантула: акромантула
акромантулами: акромантулами
акромантулов: акромантулов
акромантулы: акромантулы
активно: активно
актриса: актриса
акцент: акцент
александр: александра
алистер: алистера
алфавит: алфавиту
альбус: альбус
амбридж: амбридж
американский: американской
аналог: аналогом
ангел: ангел
англ: англ
английский: английскому английского
англия: англия англии
андроид: андроида
анимированных: анимированных
апрель: апреля
арагог: арагог
арагога: арагога
арагогом: арагогом
армандо: армандо
артур: артура
архив: архив
архивировать: архивировано
архивный: архивная
бак: бака
бар: баре
барда: барда
беларуская: беларуская
беседа: беседы
библиотека: библиотеке
бидля: бидля
билл: билла
биография: биография
битва: битве
благодаря: благодаря
блестеть: блестели
блэков: блэков
блэком: блэком
болезнь: болезнь болезни
больший: больших больше
большинство: большинству
большой: большому большой
борисенко: борисенко
борода: борода бороды бородой
бояться: боялись
брат: братом брат
брать: берут
бросить: бросил
буйство: буйством
букля: буклю
булочка: булочка
бунт: бунт
български: български
бывать: бывает
быстро: быстро
быть: были
валлийский: валлийских
василиск: василиске
вд: вд
великан: великаны великаном великанами великан великанов
великанша: великанша
великобритания: великобритания
вернуться: вернулся
версия: версия версии
вечер: вечером
взаимодействовать: взаимодействуя
взвалить: взвалив
взгляд: взгляд
взрослением: взрослением
взрослый: взрослыми
взять: взят взято
вигилант: вигилант
вид: вида
видеть: видел
видимый: видим
викиданных: викиданных
викимедиа: викимедиа
википедии: википедии
википедия: википедия
викисклад: викисклад
викискладе: викискладе
вклад: вклад
включать: включая
властный: властную
власть: власти
влияние: влияние
вместе: вместе
внешний: внешние внешнего
внешность: внешность
возвращение: возвращение
возглавлять: возглавлял
возиться: возился
возможность: возможностью
вой: вой
войти: войти
волан: волан
волкодав: волкодавом
волос: волосы волос
волосяной: волосяным
волшебник: волшебником волшебников волшебник волшебниками
волшебный: волшебную волшебные волшебного волшебная волшебный волшебными волшебное
волшебство: волшебства
воплощение: воплощение
воспитывать: воспитывать
воспользоваться: воспользовавшись воспользовался
воспоминание: воспоминаниях
впервые: впервые
впечатлительный: впечатлителен
впечатлять: впечатляющую
временить: времени
временно: временно
время: временем время
все: всему всех всего всем
вселенная: вселенная
всеять: всей
вспоминать: вспоминает
вставить: вставил
вставлять: вставляли
встретить: встреченный
встреча: встречу встрече
встречать: встречает
встроить: встроены
всякий: всякий
второе: втором второго
второй: второй
выбалтывать: выбалтывает
выбрать: выбрано
выведение: выведению
вывести: выведенный вывел
выглядеть: выглядел выглядит
вызывать: вызывают
выиграть: выигранное выиграл
выйти: вышла
вылазка: вылазки вылазках
вылечить: вылечить
вылупляться: вылупляется
вымыслить: вымышленные
вынудить: вынужден
выпустить: выпущенной
высокий: выше
выходить: выходил
выясниться: выяснилось
гарри: гарри
гера: герой
гермиона: гермиона гермионой гермионе гермиону
героизм: героизме
герой: героев
гея: гея
гибрид: гибрид гибриды
гигант: гиганты
гигантский: гигантским
гиппогриф: гиппогриф
главарь: главаря
главый: главой
глаз: глаза
гловер: гловер
говорить: говорит
говорящий: говорящий
год: году лет годы года
голова: голову голове
голос: голос
гораций: гораций
горацио: горацио
горбатый: горбатого
гореть: горящий
горинг: горинг
город: город
горшок: горшок
грейнджер: грейнджер
греческий: греческих
грива: гривой
гриммо: гриммо
гриффиндор: гриффиндор
гриффиндорская: гриффиндорская
грохх: грохх
гроххом: гроххом
грубый: грубо
густой: густой
давний: давнем
давно: давно
дальвина: дальвин
дальнейший: дальнейших
дамблдор: дамблдор
дамблдора: дамблдора
дамблдору: дамблдору
дар: дары
дата: дата
два: два
де: де
действовать: действовать действует
декабрь: декабря
делакур: делакур
делать: делает
дело: деле
дельфинят: дельфинят
дементором: дементором
демонстрировать: демонстрировать
день: дней
дерево: деревьям
держать: держит
деть: день
дж: дж
джо: джо
джоан: джоан
джордан: джордан
джулиан: джулиан
диалект: диалектов
диалектный: диалектного
дикий: диким
дилогия: дилогия
дина: дина
диппета: диппета
директор: директора
дитя: дитя
длинный: длинные длинной
добрый: доброй
добыть: добыть
доверие: доверие
доверять: доверяет
док: док
долгий: долгой
должность: должности
долорес: долорес
дом: доме
домашние: домашним
домашний: домашнем
донос: доноса
дополнительный: дополнительные
допускать: допускал
допустимый: допустимого
доселе: доселе
доступный: доступен
драко: драко
дракон: дракона драконов драконах дракон
драконихи: драконихи
дракончик: дракончик
древнегреческий: древнегреческой
древность: древности
друг: друзья друг друзей другом друга
другой: другими другие других
дружить: дружит
дуб: дуб
дубляж: дубляж
дубовый: дубовую
дурмстранг: дурмстранг
дышать: дышат
дюйм: дюймов
единорог: единорогом единорога
единоутробный: единоутробным единоутробный
единственный: единственным единственный
желать: желавшей
животное: животным животное животных животными
жила: жил жилах
жук: жука
заботиться: заботятся
забрать: забрали
заведомо: заведомо
заглавный: заглавная
задание: задание
заинтересовать: заинтересованную
заклинание: заклинания
заклятие: заклятий заклятием
законодательство: законодательство
закрывать: закрывали
заменить: заменить
заменять: заменяет
замок: замке замка
занятие: занятий занятие
занять: занял
западноукраинских: западноукраинских
западный: западной
запереть: запертый
запинаться: запинается
записка: запиской
запись: запись
запретить: запретило запретили запрещено
запретный: запретном запретный
зарегистрировать: зарегистрированный
засадить: засадить
засыпать: засыпал засыпать
затем: затем
затылок: затылке
заходить: заходят
защита: защите
защитить: защитил
защищать: защищает
заявить: заявив
заявление: заявление
звать: зовут
зверек: зверьке
зверь: звери
звук: звуки
зелье: зелий зелье
знак: знак
знакомить: знакомит
знаменательный: знаменательное
знать: знают
значительно: значительно
зонт: зонт
зонтик: зонтик
зоолог: зоолог
зритель: зрителей зрителя
зря: зря
зуб: зубы
игра: игра игрой игры
играть: играет играл играла
избить: избить
избранный: избранные
извергать: извергать
известно: известно
известный: известный известен
изгнание: изгнания
издеваться: издеваются
изучить: изучил изучить
иметь: имел имеют
иметься: имеется
имя: имя
иногда: иногда
инструкция: инструкциям
инструмент: инструмента инструменты
интересный: интересных
исключение: исключения
исключить: исключило
искренне: искренне
исполнение: исполнения
использование: использовании использования
использовать: используя использует использовать использовали
испытание: испытании
испытывать: испытывает
история: историю история историй истории
источник: источниками источник
итог: итоге
июль: июля
июнь: июня
кабаний: кабаньей
кабинет: кабинет
кадр: кадр
казаться: казался
казнить: казни
казнь: казнь
какой: каком какими
камень: камню камень
камин: камин
карта: карты
карточный: карточная
категория: категории
квалифицированный: квалифицированным
квиддич: квиддич
квиддичу: квиддичу
квирелл: квирелл
квиррелл: квиррелл
кино: кино
кинуться: кинулся
клык: клыка клык
клювокрыл: клювокрыл
ключ: ключей
книга: книг книги книге
книжный: книжному
код: код
кодекс: кодекс
кожаный: кожаных
колдовать: колдовать колдует
коллекционный: коллекционная
колония: колонию колония
колтрейн: колтрейн
колтрейна: колтрейна
колтрейном: колтрейном
комбинированный: комбинированными
комедийный: комедийная
комната: комнату комната комнаты
компонент: компонент
конец: конца
конспирация: конспирации
конструктор: конструктор
контроль: контроля
конфиденциальность: конфиденциальности
конфисковать: конфискована
копия: копия
корбетт: корбетт
коробка: коробке
короткий: короткие короткий
косматый: косматая
костюм: костюме костюма
который: которого которые которых которая котором который
краб: краба
крайний: крайней
кратенький: кратенькой
крепкий: крепким
критик: критиков
кровь: крови кровь
кроме: кроме
крупный: крупный крупными
крышка: крышку
кубок: кубок
кук: куки
кукольный: кукольной
культура: культуре
курс: курсе
кустистый: кустистых
ладонь: ладони
легко: легко
лес: лесу леса лес
лесничий: лесничий лесничим лесничего
летать: летающая
линдсей: линдсей
лира: лире
лицензия: лицензии
лицо: лицо лицом
личность: личность
лишение: лишениях
ложный: ложного
локация: локации
лохан: лохан
лохмы: лохмы
лояльность: лояльность
лояльный: лояльного
луи: луи
любимец: любимце любимцем
любить: любимого
любопытный: любопытному
м: м
маг: маги
магический: магические магическими
магия: магия магию магии магией
маглы: маглы
мадам: мадам
макгована: макгована
македонский: македонски
максим: максим
маловажный: маловажных
малфоем: малфоем
малфой: малфой
малфоя: малфоя
малыш: малыша
мантикоры: мантикоры
марта: марта
мастиф: мастиф
материал: материал
мать: мать матери
махаон: махаона
машина: машина
мая: мая
медиафайлы: медиафайлы
мера: мере
мертвый: мертвых
местечко: местечка
место: место места
механизировать: механизировали
мечтать: мечтал
мимоходом: мимоходом
министерский: министерской
министерство: министерство
мир: мира мир мире
миссис: миссис
миссия: миссия
миф: мифов
мифология: мифологии
много: более много
мобильный: мобильная
можно: можно
момент: моменты
морт: морт
морта: морта
морту: морту
мочь: могут
мракоборцев: мракоборцев
мужской: мужской
мужчина: мужчины
музыка: музыку
музыкальный: музыкального
мусорный: мусорного
мы: нами
мысль: мысль
наблюдать: наблюдая
навигация: навигации навигация
навык: навыки
надвое: надвое
название: названием название
назвать: назвал
назначить: назначен
назойливый: назойливых
называть: называют
наиболее: наиболее
наивный: наивен
намек: намек
намного: намного
нападать: нападал
напасть: напавшими напасть напали
написание: написания
наполовину: наполовину
напоминать: напоминали
например: например
нарушение: нарушения
нарушить: нарушив
настоящий: настоящий
начало: начал
наш: наших
неаполитанский: неаполитанский
небольшой: небольшие
невозможно: невозможно
недалекий: недалеко
недоказанный: недоказанном
недостаток: недостатков
недостоверный: недостоверный
недоступный: недоступная
нездоровый: нездоровую
незнакомец: незнакомец
неизвестно: неизвестно
неизвестный: неизвестными
некоммерческий: некоммерческой
некоторые: некоторые
немного: немного
необходимый: необходимую
неоднократно: неоднократно
неопр: неопр
неполный: неполный
непосредственно: непосредственно
неприятный: неприятный
нерабочий: нерабочими
нередко: нередко
неряшливый: неряшливой
несколько: несколько
несчастный: несчастное
неумелый: неумелым
неуязвимый: неуязвимым
неэнциклопедический: неэнциклопедическим
неэнциклопедичных: неэнциклопедичных
никуда: никуда
нил: нила
новый: новые
нога: ноги
норберт: норберт норберту норберта
норвежский: норвежского
норрис: норрис
носить: носят
ночь: ночь ночей
ноябрь: ноября
нравиться: нравится
нуждаться: нуждается
нюхлера: нюхлера
об: об
обернуть: обернутым
обитание: обитания
обитать: обитающем
обладать: обладал
обломок: обломки
обмануть: обмануть
обмен: обмен
оборотный: оборотное
обрадоваться: обрадовался
образ: образу образ
обратить: обратить
обращение: обращения
обсуждение: обсуждение
обучение: обучение
обходиться: обходилось
объедаться: объедаются
обычный: обычного обычных
оглушить: оглушили
огненный: огненного
огонь: огня
огромный: огромным огромный огромная огромных огромны
один: одной одном одно одним
одичать: одичавшая
однако: однако
ожоговый: ожогов
озвучивать: озвучивает
означать: означает
оказаться: оказался
окончание: окончаний
окружать: окружающих
олицетворение: олицетворением
он: нему
они: им них
опасный: опасных опасным опасны
описание: описание
описываться: описывается
опытный: опытными
организация: организации
орден: ордену орден
оригинал: оригинала
орфей: орфей
ослеплять: ослеплял
особенно: особенно
особенность: особенностью
оставить: оставить
остановиться: остановились
остаться: остался
ответственность: ответственности ответственностью
отдельный: отдельных отдельные
отец: отца отец
отказ: отказ
открыть: открыл открыть
отличаться: отличаться
отличительный: отличительной
отметить: отметил
отмечать: отмечает
относиться: относящееся
отношение: отношения
отправить: отправить
отражение: отражение
отредактировать: отредактирована
отряд: отряд
отчаянно: отчаянно
охранять: охранял
очаровательный: очаровательными
очень: очень
очерк: очерке
ошибка: ошибке
палочка: палочку палочка палочки
памятный: памятные
память: памяти память
парк: парк
пародийный: пародийной
пародия: пародиях пародии
паук: пауком паук пауками
первое: первым первое первом
первокурсник: первокурсников
первый: первой первый
перевод: переводах переводе перевода
передача: передаче
переименовать: переименован переименованный
перейти: перейти
переломить: переломлена
переросток: переростков
переть: при
персонаж: персонаж персонажа персонажами персонажем персонажи персонажей
персональный: персональные
пес: пса
печать: печати
печение: печенье
питомец: питомцы
пить: пивший
пламя: пламя пламенем
план: планами
плохой: плохая плохих
площадь: площадь
победа: победе
поведение: поведение поведения
повествование: повествовании
повторять: повторяет
погиб: погиб
погибнуть: погибли
поговорить: поговорить
подарок: подарок
подвижной: подвижная
поддерживать: поддерживая
подняться: поднялся
подобный: подобных подобные
подробность: подробностей
подробный: подробнее
подсказка: подсказкой
подсунуть: подсунул
пожалуйста: пожалуйста
пожертвовать: пожертвовать
пожиратель: пожирателями пожирателей пожиратели
поздний: позже
поиск: поиск поиску
пока: пока
показать: показан
показаться: показалась
покинуть: покинула
пол: пол
политик: политика политике
полностью: полностью
половинка: половинки
положить: положил
полтергейст: полтергейстах
полувеликан: полувеликана
полукровка: полукровка
получеловек: получеловек
получить: получил получить
пользоваться: пользуется
поместить: поместил
помогать: помогали
популярный: популярной
порой: порой
портал: портал
поселиться: поселившаяся
поскольку: поскольку
последний: последнее последний последней
послужить: послужило
посол: после
постановка: постановке
постоянный: постоянная
поттер: поттер поттера поттеру поттере
поход: походе
похожий: похожее
похоронить: похоронил
похороны: похоронах
почтить: почти
поэтому: поэтому
появиться: появившийся
появление: появление
появляться: появлялся появляется
правило: правилами
править: править
правка: правок правки
правый: правом
практический: практически
преданный: предан
предмет: предметы
предполагаться: предполагается
предпочитать: предпочитает
представиться: представились
представлять: представляют
предстоять: предстояло
предыдущий: предыдущего
предыстория: предыстория
преодолеть: преодолеть
преподавание: преподавания
преподаватель: преподаватель преподаватели преподавателем
препятствие: препятствий
преследователь: преследователей
преступление: преступлении
привязать: привязал
пригласить: приглашены
придумать: придумала
признаться: признаться
прийтись: пришлось
примечание: примечания
принадлежать: принадлежащий
принадлежность: принадлежность
принц: принц
принять: приняла
приручить: приручить
прислать: пришли
присудить: присудил
причина: причин
про: про
пробовать: пробовать
проверить: проверенной
проверка: проверки
проверяться: проверялась
проглатывание: проглатывание
программа: программе
проект: проектах
проиграть: проиграл
произведенье: произведений
производство: производство
происходить: происходит
происхождение: происхождение
проклясть: проклятое
просмотр: просмотры
просто: просто
простой: простые
пространство: пространства
противник: противники
прототип: прототипом
профессор: профессор
прочий: прочее
прямой: прямом
прятаться: прятался
пугать: пугая
путаться: путается
путеводитель: путеводитель
путь: путь пути
пушок: пушок пушка
пытаться: пытается
пьяница: пьяница
пять: пять
работа: работы работа работу
работать: работает
раз: раза
разведение: разведению разведение
раздеть: раздела
раздражать: раздражают
различный: различных
размер: размером
разный: разными
разработчик: разработчики
раненый: раненым
ранимый: раним
ранний: ранних
распределять: распределяющая
распространяться: распространялась
рассказ: рассказы рассказах
рассказать: рассказал
рассказывать: рассказывает
рассмотреть: рассмотреть
расстаться: расстаться
расстроить: расстроен
расти: рос расти
реакция: реакция
регбист: регбистом
реддла: реддла
реддлом: реддлом
результат: результате
рейтинг: рейтинге
реквизит: реквизитом
религиозный: религиозные
репутация: репутацию
ресурс: ресурсы
робби: робби
рогволд: рогволд
род: род
родиться: родился
родной: родной
рождение: рождения
розмари: розмари
розовый: розовый
роль: роль роли
роман: романов романе
рон: рону роном рона рон
ронни: ронни
рост: ростом росте
роулинг: роулинг
рубеус: рубеус
рубеуса: рубеуса
руководство: руководством
румыния: румынию
русский: русский
русый: русые
сайт: сайт сайты
сам: самого самой самом самому самим
самка: самкой
самый: самый самыми самым
санс: санс
сантиметр: см
сапог: сапогах
саундтрек: саундтрек
сбежать: сбежал
свадьба: свадьбе
сведение: сведения
свежий: свежие
света: света
свободный: свободной
свое: своих своему своего своим
свой: своей свою
свойственный: свойственное
свойство: свойство
связанный: связанные
связаться: свяжитесь
сделать: сделал
себя: собой
северус: северус
седьмой: седьмого
сезон: сезона
секрет: секреты секрете
семья: семья
сентябрь: сентября
сериал: сериал сериала
серия: серию серия
сила: силу силах
сириус: сириуса сириусом
сисериги: сисериги
система: системе
сказать: сказала сказал
сказка: сказки
скачать: скачать
скорпионоподобный: скорпионоподобными
скорый: скорее
скрывать: скрывать
скрываться: скрывалась
скрытно: скрытно
скрытый: скрытые
скрыться: скрылся
скулить: скулил
слава: слава
следовать: следуя следует
слизеринцы: слизеринцы
слизнорт: слизнорт
слово: слов словам слова
сломать: сломали сломать сломало
служебный: служебные
случай: случаях случай
случайно: случайно
случайный: случайная
смерть: смерти
смочь: смог
сначала: сначала
снегг: снегг
снегга: снегга
собака: собаку собаке собака
собутыльник: собутыльнику
событие: события событие
сова: сову
совет: советом
совладать: совладать
соглашение: соглашением
содержание: содержание содержанием
содержать: содержит
содержимое: содержимое
создание: создания создание
создатель: создатель
создать: создан создать
сообщество: сообщество
сообщить: сообщить сообщил
соответствие: соответствии
соответствовать: соответствует
соплохвост: соплохвост
соплохвостами: соплохвостами
соплохвостов: соплохвостов
соплохвосты: соплохвосты
сопровождать: сопровождает
сохранение: сохранением
социальный: социальный
спародировала: спародировала
спародирован: спародирован
спасать: спасать
спасение: спасения
спасти: спасла
специальный: специальном
спина: спину
список: список
спора: споры
способ: способами
способность: способности
способный: способными
справка: справка
спросить: спросить
спустя: спустя
спутать: спутанных
сравнение: сравнению
среди: среди
српски: српски
српскохрватски: српскохрватски
ссылка: ссылка ссылками ссылки
становиться: становясь
старое: старого
старость: старости
статистика: статистика
статус: статус
стать: стал стало стали
статья: статью статей статья статье статьи
стая: стаи
стенограмма: стенограмма
сторона: стороне сторону
сторонник: сторонник
стр: стр
страница: страницы страница страницу странице
страсть: страстью страсть
стремительно: стремительно
стряпня: стряпню
студент: студентам студентов
субботний: субботним
судить: судя
суметь: сумел
суровый: суровее
суть: сути
суховерко: суховерко
существенный: существенную
существо: существо существа существе существами
сформулировать: сформулировать
сцена: сцены
считать: считающую считает считал
съезжаться: съезжаются
сыгранный: сыгран
сюда: сюда
тайный: тайный тайная тайной тайную
также: также
таки: таки
такой: такое таком
тварь: тварями
текст: текст
текущий: текущие текущая
телосложение: телосложению
тем: тем
тема: теме
тематический: тематический тематические
температура: температуру
территория: территорию
течь: течет
товарный: товарный
толща: толще
том: томом тома
топ: топ
торт: торт
тот: том тот тому
травма: травм
требовать: требуют
трейси: трейси
третий: третьей
трехглавый: трехглавый
тринадцатый: тринадцатое
троица: троице троица
трудность: трудности
тупой: тупых
турнир: турнира
тюрбан: тюрбан
убедить: убедить
убивать: убивая
убийца: убийц
убить: убили
увенчаться: увенчалась
уговорить: уговорить
удивление: удивлению
удивлять: удивляет
узнать: узнал
узник: узник
уизли: уизли
указание: указанием
указать: указан
украинский: украинском
улучшаться: улучшаются
улучшить: улучшите
ульман: ульман
умение: умения
уменьшить: уменьшенным
умереть: умер
упоминаться: упоминается
урок: уроки уроках
условие: условий условия
услышать: услышав
успех: успехом
устареть: устаревших
усыпить: усыпив усыпить
утичи: утичи
уход: ухода
участвовать: участвовали участвовал
участие: участие
участник: участниками
ученик: учеников
учитель: учитель
учить: учить
учиться: учился
факультет: факультете
фамилия: фамилия
фантастический: фантастические
февраль: февраля
феникс: феникса
фестралов: фестралов
физиология: физиологию
физиономия: физиономия
философский: философский философская философскому
фильм: фильм фильме фильмов фильмах фильма фильмы
финальный: финальном
фонд: фонд
форд: форд
форум: форум
фраза: фраза
фридвульфа: фридвульфа
хагрид: хагрид
хагрида: хагрида
хагридом: хагридом
хагриду: хагриду
характеристика: характеристики характеристика
хвост: хвоста
хижина: хижине хижины
хищный: хищными
хобби: хобби
хобо: хобо
хогвартс: хогвартс
хогвартса: хогвартса
хогвартсе: хогвартсе
хогвартской: хогвартской
ходуля: ходулях
хозяин: хозяина
хороший: лучше лучшей хороший
хотеть: хочешь
хранитель: хранитель
худой: хуже
царство: царства
целовать: целую
ценить: ценит
ценный: ценный
цербер: цербера цербер
цитировать: цитировать
чай: чай
чарли: чарли
чародейство: чародейства
частность: частности
часто: часто
человек: человек человеку человека людей
чемпионат: чемпионат
чепстоу: чепстоу
черный: черных
четверо: четверо
чистка: чистке
чистота: чистота
читать: читать
член: членов
что: чему
чтобы: чтобы
чувство: чувство
чудовище: чудовищам
чуть: чуть
шаблон: шаблонами
шармбатон: шармбатон
школа: школе школы
школьный: школьный
шляпа: шляпа
шоу: шоу
щербак: щербаков
элемент: элемент
эмоция: эмоциями
энциклопедия: энциклопедии
эпизод: эпизоде
этап: этапе
это: этом это этим
этот: этой эта
эфир: эфире
юго: юго
юмористический: юмористической
являться: является
яд: яд
язык: язык языках языку
яйцо: яйца яйцо
якоб: якобы
январь: января
