аберфорт: аберфорт
абсолютно: абсолютно
август: август
августус: августус
автомобиль: автомобиле
автоответчик: автоответчиком
автор: автору
авторство: авторства
адрес: адресу
азкабан: азкабан
азкабана: азкабана
азкабане: азкабане
академия: академии академия
аластора: аластора
алиса: алиса
аллея: аллея
альбус: альбус
альбуса: альбуса
альбусом: альбусом
амброзиус: амброзиус
амнезия: амнезией
амфора: амфора
англ: англ
английский: английской английского
англия: англия англии
анимаг: анимаг
антонин: антонин
аптека: аптека аптеке
аргус: аргусом
арест: аресте
ариан: ариана ариану
аристотель: аристотель
арк: арке арку
армия: армией
артефакт: артефактами артефакты артефактов
артур: артуром артура артур
ассортимент: ассортимент
афишировать: афишировать
африканский: африканский
б: б
бак: баком
банк: банке банк банка
бар: бар бара
барда: барда
бармен: бармен
барти: барти
батильда: батильда
батончик: батончики
башня: башней
бедный: бедном бедный бедно бедным
безголовый: безголовая
безопасность: безопасности
безопасный: безопасного
безрадостный: безрадостной
безумный: безумном
белла: белл
беллатриса: беллатриса
белые: белыми
белый: бела белое белого белой
бельгия: бельгии
бенсон: бенсон
беременная: беременной
беременность: беременности
беречь: берегу
берти: берти
бесплатный: бесплатное
беспрекословно: беспрекословно
бидля: бидля
билл: билла билл
битва: битвой битве битвы
бишоп: бишопа
благой: блага
блевальные: блевальные
блеск: блеска
ближний: ближайшем ближайших
близиться: близящиеся
близкий: близко
близлежащий: близлежащими
близнец: близнецов
блоттс: блоттс
блэк: блэк
блэке: блэке
блэков: блэков
блэком: блэком
бок: бок
болгарский: болгарские
болезнь: болезнь
болото: болото
больница: больницу больница больницы больнице
больничный: больничная
больной: больными
больший: большим большее большая большие большую
большой: большого большой большое
бомба: бомб
бонэм: бонэм
бородавочник: бородавочник
боттс: боттс
боуд: боуд
брат: братьев брат брату братья
брать: брать брала
бродерик: бродерик
бронза: бронзы
бронзовый: бронзовые бронзовых
бросать: бросаемой
бросить: бросил
брошюра: брошюра
будущее: будущего будущему
буква: буквами
булыжник: булыжником
буря: буря
буфет: буфет
български: български
быстро: быстро
быть: суть будучи бывший были
бэггет: бэггет
бэгшот: бэгшот
бэрк: бэрк
важный: важны
вальд: вальд
вальда: вальда
вальдом: вальдом
валюта: валюта
вариант: вариант
ведомый: ведомых
ведуния: ведуний
ведьма: ведьма ведьм
век: века веке
великий: величайший
великобритания: великобритании
великолепный: великолепная
величина: величиной
вепрь: вепрь
вернон: вернон
вернуться: вернувшись
верный: верных
вероятно: вероятно
вероятный: вероятным
версия: версия версии
весить: весь
вести: ведущая ведущие ведущий
весть: весть
весы: весами весы
весьма: весьма
ветвь: ветвями ветвей
ветер: ветром
ветка: ветки
ветхий: ветхими
вечер: вечером
вещь: вещей вещи вещам вещь
взлом: взлом
взрывчатка: взрывчатка
взрыть: взрыв
взяться: взялись
вид: вид виде
видеть: видеть видят видел
видимо: видимо
видимый: видим
визжать: визжащей визжащая визжащую
викиданных: викиданных
викимедиа: викимедиа
википедии: википедии
википедия: википедия
викисклад: викисклад
викискладе: викискладе
викия: викия
виктор: виктора
виновный: виновные
вирус: вирусы
висельник: висельник
висеть: висел висит
висок: виски
витрина: витрина витрины витринах витрине
вклад: вклад
включительно: включительно
вкус: вкус
владелец: владельцев владелец
властелин: властелин
власть: власти
влиять: влияющих
вместе: вместе
вместо: вместо
вне: вне
внешний: внешние внешний
внимание: внимание
вновь: вновь
внутри: внутри
внутрь: внутрь
воды: воды
возвратиться: возвратился
возвращать: возвращает
возвращаться: возвращаются
возвращение: возвращение
возвышаться: возвышающееся
воздух: воздуху
возле: возле
возложить: возложил
возможно: возможно
возраст: возраст
возродиться: возродился
вой: воя
война: войны
войти: войти
вокзал: вокзала вокзал вокзале
волан: волан
волновать: волнует
волшебник: волшебником волшебников волшебник волшебники
волшебный: волшебной волшебные волшебных волшебного волшебная волшебный волшебными
волшебство: волшебства
вонючка: вонючки
вообще: вообще
вопрос: вопросы вопросов
вор: воры
воровской: воровским
ворон: вороны
ворот: ворота
восемь: восемью
воспитанник: воспитанников
воспитатель: воспитателей
воспоминание: воспоминание воспоминания воспоминаний
восстание: восстания
восток: востоке востоку
впадина: впадины впадина
впервые: впервые
вплоть: вплоть
вполне: вполне
впрочем: впрочем
враг: врагами врагов
врата: вратах
врач: врачи
вредилки: вредилки
врезаться: врезались
временить: времени
временной: временном
время: времена время временам
все: всех всего
всевозможный: всевозможных всевозможные
вселенная: вселенная
всеять: всей
вспомогательный: вспомогательных
встретить: встретить
встреча: встреч
встречаться: встречается встречались встречаются
встроить: встроенной
всякий: всякий всякого
втаскивать: втаскивает
второе: втором второго второму
второй: второй
вуаль: вуали
вудкрофта: вудкрофта
вход: вход входу входа
входить: входи входят входил входящий входит
выбить: выбита
выбраться: выбраться
вывеска: вывеска
вывозить: вывозят
выглядеть: выглядит
выдворять: выдворяют
выжить: выжил
вызволять: вызволяя
выздоровление: выздоровления
вызывать: вызывает
выйти: выйти
выключить: выключить
выкопать: выкопал
вылетать: вылетают
выложить: выложен
вымыслить: вымышленная
вынудить: вынуждены
выпал: выпала
выражение: выражение
выручать: выручай
высокий: высокая высокое высоко высокой
вытягивать: вытягивают
выход: выход
выходной: выходные выходным
вышитый: вышит
выясняться: выясняется
габриэль: габриэль
газета: газеты
галеон: галеонов галеона галеон
галета: галета
галлеон: галлеон
галлеоне: галлеоне
галлеоны: галлеоны
гараж: гаражом
гарантированный: гарантированный
гарпия: гарпий
гаррет: гаррет
гарри: гарри
гвеног: гвеног
геллерт: геллертом геллерт
герб: гербе герб
гермиона: гермиона гермионы гермионой гермионе
героизм: героизме
герой: герои
гибель: гибели
гибкий: гибких
гиперъязычок: гиперъязычок
гиппократ: гиппократ
главное: главным
глаз: глаза глазах
глубоко: глубоко
гнилой: гнилых
гном: гномы
го: го
гоблин: гоблина гоблин гоблины гоблином
говорить: говорит
год: годов лет год годами годы года
годрик: годрик
годрика: годрика
годрикова: годрикова
годриковой: годриковой
голова: голову голова головы голове
голод: голода
голый: голый
гора: горах
горазд: гораздо
горбатый: горбатой
горбина: горбин
городок: городок
гостиная: гостиная гостиную гостиной
гостиница: гостиницы
гостить: гостили
гость: гостей
государство: государств
готовый: готовые
грабитель: грабителей грабитель
грамм: грамма
граница: границы
грейнджер: грейнджер
гремучий: гремучей гремучую гремучая
грех: грех
грешный: грешная
грибковый: грибковая
грива: гривами
гриммо: гриммо
грин: грин
гринготтом: гринготтом
гринготтс: гринготтс
гринготтса: гринготтса
гринготтсе: гринготтсе
гриппозный: гриппозная
гриффиндор: гриффиндор
гроссбух: гроссбухами
грохот: грохота
группа: группа
грюма: грюма
грязно: грязно
грязь: грязи
д: д
давний: давних давняя
давно: давно
дайлис: дайлис
далекий: дальше
дальнейший: дальнейший дальнейшая
дамблдор: дамблдор
дамблдора: дамблдора
дамблдоров: дамблдоров
дамблдором: дамблдором
дар: дары
дать: данным дать
два: два две двух двумя
двадцать: двадцать
дверца: дверцы
дверь: дверь дверях дверей двери дверями
двигаться: двигаться
двое: двое
двор: дворе
дворик: дворик
двуглавого: двуглавого
де: де
девочка: девочки девочкам
девять: девять
дедалусом: дедалусом
дежурный: дежурный
дежурство: дежурства
действие: действия действие
действительно: действительно
действовать: действовать
декабрь: декабря
делакур: делакур
делать: делающими
делиться: делятся
дело: деле делам
делюкс: делюкс
дементоров: дементоров
дементоры: дементоры
деннис: денниса деннис
день: дней дня дни
деньга: деньги деньгах
деньги: денег
дервент: дервент
деревня: деревни деревня деревню
дерево: дерево деревьями деревьев
деревушка: деревушка деревушку
деревянный: деревянный деревянное
держать: держать держит держат
десятисекундный: десятисекундный
десять: десять
детская: детских
детский: детский
деть: день
дж: дж
джагсон: джагсон
джеймс: джеймс
джинни: джинни
джоан: джоан
джонс: джонс
джордж: джордж джорджа джорджем
диагон: диагон
диаметр: диаметр
диван: диваном
диггори: диггори
дикий: дикий
диковинный: диковинных
дилогия: дилогия
динглом: динглом
директор: директором директора директор
дисковый: дисков
диссендио: диссендио
дитя: дитя
длинный: длинных
длиться: длится
дневник: дневник
добби: добби
добраться: добралась добраться
добровольный: добровольной
доверие: доверия
довольный: довольно
догадываться: догадывался догадываться
док: док
долбанады: долбанады
долгий: долго долгое
долгопупс: долгопупс
должен: должен
долина: долина
долохов: долохов
дом: дом дому домом доме
дома: дома
домашние: домашних домашними
домашний: домашний
домик: домик
домовик: домовик домовику
доноситься: доносится
дополнительный: дополнительные
дорогой: дорого
доска: досками
дослушать: дослушал
доставлять: доставляющий
достать: достать
достоверный: достоверных
достопримечательность: достопримечательность достопримечательностям достопримечательностью
доступный: доступных доступен доступны
дотронуться: дотронулась
дотянуться: дотянуться
дочь: дочь
драже: драже
драка: драка драки
драко: драко
дракон: дракона драконами
драконий: драконья
дракучая: дракучая
дранг: дранг
драчливый: драчливые
древность: древности
друг: друзья друзьями друзей другом друзьям другу
другой: другое другой другими другие других
дрянной: дрянная
думать: думать
дурмстранг: дурмстранг
дурмстранга: дурмстранга
дурмстранговцев: дурмстранговцев
дурсль: дурсль
дуэль: дуэль
дым: дым
дырявый: дырявый дырявого
дьявольский: дьявольских
дэвид: дэвид
дюжина: дюжиной
дядя: дядя
европа: европы
европейский: европейских
египет: египте
едва: едва
единорог: единорога
единственный: единственное единственная единственный единственной
едкий: едкий
ежедневный: ежедневного ежедневный
ежемесячный: ежемесячного
ездить: ездят ездит
жаба: жабы
жадность: жадности
жаловаться: жаловаться
желание: желания
железнодорожный: железнодорожная
желейный: желейные
жена: женой
жертва: жертв
живоглот: живоглот
живой: живое живых
жизненный: жизненный
жизнь: жизни жизнь жизнью
жила: жил жила
жилища: жилище жилища
житель: жителей
жить: жили живут
жук: жуков
забастовочный: забастовочные
забвение: забвения
заблокировать: заблокированные
заболевание: заболевания
заболеть: заболевшего
заботиться: заботятся
забрало: забрал
забрать: забран
забросить: заброшенным заброшенное
забытый: забытым
забыть: забудь
заведение: заведение заведении заведений заведения
завещание: завещание завещанию
завтрак: завтраки
завывать: завывать
заглавный: заглавная
задний: заднем задний
задушить: задушен
заказать: заказать
заклеить: заклеена
заклинание: заклинанием заклинания заклинаний заклинаниями заклинание
заключение: заключение заключения
заклятие: заклятие заклятий
заколдованный: заколдованная
заколотить: заколочены заколоченными заколочена
закон: законы
закончить: закончил
закончиться: закончилась
закрытый: закрыто закрыта закрыт
залезть: залезть
заляпать: заляпанными
заместитель: заместителем заместитель
заметить: заметить
замещать: замещающих
занимать: занимает
занять: заняла
заодно: заодно
запад: западе
запасть: западу
запах: запах
запираться: запираются
запись: запись записью
заплатить: заплатил
запор: запор
запрячь: запряжена
запутанный: запутан
зарегистрировать: зарегистрированное зарегистрированный
заставить: заставлена заставить
заставлять: заставляют
застревать: застревать
застрять: застрявшие
затем: затем
зато: зато
зачаровать: зачарованный
зачитывать: зачитывал
защита: защиты
защитный: защитной защитные
защищать: защищает
заявление: заявление
звезда: звездой
зверинец: зверинец
зверь: звери
звучать: звучащее
здание: здании здание
здоровый: здоровы
здоровье: здоровье
зелье: зельями зелья
земля: земли земле
земляной: земляной земляным
земной: земным
златопуст: златопуст
златопуста: златопуста
златопустом: златопустом
злой: злой
змея: змею
знак: знак
знаменитый: знаменитой знаменитая знаменитом
знать: знает знать знал знают знала
значительно: значительно
золотистый: золотистыми
золото: золото золота
золотой: золотом золотые золотых
золотуха: золотуха
зона: зону
зонко: зонко
зоомагазин: зоомагазин
зрение: зрения
ив: ивы ива иву
ива: ивой
игнотуса: игнотуса
игорь: игорь
игра: игра играх игре игры
играть: играет
идейный: идейных
идея: идея
избивать: избивать
избранный: избранные
известно: известно
известный: известные известный
извилистый: извилистая
изгонять: изгонять
изготовить: изготовлена
издавать: издавал
изменение: изменения
измениться: изменилось
изменяться: изменяется
изначально: изначально
изобразить: изображены
изогнуто: изогнуто
изучаться: изучаются
именно: именно
иметь: имел имело имеющей имеет
импортироваться: импортируется
имя: имена именами имени
инвентарь: инвентаря инвентарь
ингредиент: ингредиенты
иной: иной
инструмент: инструменты
интересно: интересно
интересный: интересной
интересоваться: интересуется
интерьер: интерьер
инфекционный: инфекционные
информация: информации
ириска: ириски
искра: искры
искусство: искусства
испания: испании
исполнять: исполняет
использование: использования
использовать: использующие использовали
использоваться: использовалось используется
испортить: испорченными
испытывать: испытывающий
истина: истину
историк: историк
история: историей история истории
источник: источников источник
исходить: исходившего
исчезательный: исчезательный
исчезновение: исчезновения
исчезнуть: исчез
июнь: июня
кабан: кабан
кабаний: кабанья кабанью кабаньей
кабачковый: кабачков
кадр: кадр
каждый: каждое каждую каждого каждом каждый каждая
казаться: казалось
какой: какие какими
калитка: калитке
каменный: каменные каменный
камень: камень
камера: камеры камер камере
камин: камином камин
канареечный: канареечные
каникулы: каникулы
капитан: капитана
капюшон: капюшону
карамельный: карамельных
карантин: карантина
карат: карат
карета: карете карета
каркаров: каркаров
карликовый: карликовые карликовых
карта: картах карте
карточка: карточке
карточный: карточные карточная
категория: категории категория
каф: кафе
качество: качество
квадратный: квадратное
квартал: квартале
квартира: квартира квартиру квартирой
квиддич: квиддич
квиддича: квиддича
квиддичу: квиддичу
квиреллом: квиреллом
квиррелл: квиррелл
кендра: кендра
кикимер: кикимер
кикимера: кикимера
кингс: кингс
кириллица: кириллице
кирпичный: кирпичную
кишка: кишках
кладбище: кладбище
клейн: клейн
клетка: клетка
клиент: клиент клиентов
климат: климат
клочковатый: клочковатого
клык: клыки
ключ: ключ
кната: кната
кнатов: кнатов
кнаты: кнаты
книга: книг книгах книги книгам книге
книжный: книжным книжный
ковшик: ковшик
коготь: когти
код: код
кодекс: кодекс
кожаный: кожаные
колберт: колберт
количество: количество количества
коллекционный: коллекционная
колонна: колонну
колченогий: колченогий
кольцо: колец
коля: коль
командовать: командовал командует
комната: комнате комнатах комнату комната комнаты
компакт: компакт
компонент: компоненты
кондитерский: кондитерская кондитерской
конец: конце
конструктор: конструктор
континуум: континууме
контрабанда: контрабанде
конфета: конфеты
конфиденциальность: конфиденциальности
конь: коней
корабль: корабле
корень: корни
коридор: коридоры коридор коридорах
корма: корм
коробка: коробки
королевство: королевство королевства
короткий: короткие короткий
косвенный: косвенным
косой: косой косом косому косого
кость: кость
кот: коты кот
котел: котла
котлы: котлов котлы
который: которым которое которой которую которого которые которых которая котором который
коттедж: коттедже коттедж коттеджа
коул: коул
край: краю краем
крайний: крайней
крама: крама
красный: красного
крауч: крауч
крауча: крауча
кремовый: кремовые
кресло: кресел креслами
крестраж: крестраж
крестражей: крестражей
кривой: кривая
криспин: криспин
кроваво: кроваво
кровопролитный: кровопролитные
кровь: кровь
кролик: кролики
кроме: кроме
кронк: кронк
кросс: кросс
круглый: круглая
кружиться: кружится
круциатус: круциатус
крушить: круша
крыльцо: крыльце
крыса: крысы крысу
крыша: крышу
крюкохват: крюкохват
крюкохвата: крюкохвата
кто: кого
кубок: кубка кубок
куда: куда
кук: куки
купить: купить купил купили
курс: курсе курс курса
курятник: курятник
кустарник: кустарники
кухня: кухня кухню кухне
кухонный: кухонным
кэти: кэти
кэчпоул: кэчпоул
лавгуд: лавгуд
лавгудов: лавгудов
лавгуды: лавгуды
лавка: лавка лавками лавке лавки
ладья: ладью
лаз: лаз
лакричный: лакричные
лампа: лампой
ланселот: ланселот
легенда: легенд
леденец: леденцы
лежать: лежит лежат
лекарство: лекарства
лес: лес
лестница: лестница
лестрейндж: лестрейндж
летать: летающем летающие летать
летний: летние
лето: летом
летучий: летучего
лжеволшебные: лжеволшебные
либо: либо
лили: лили
лиловый: лиловые
лимонный: лимонные
лисий: лисья
литература: литература
литтл: литтл
лицензия: лицензии
лицо: лиц
лишение: лишениях
лишиться: лишился лишилась
лишь: лишь
локализовать: локализованных
локация: локации
локонс: локонс
локонса: локонса
локонсом: локонсом
лондон: лондоне лондона лондон
лондонский: лондонском лондонского
лорд: лорда лорду лорд
лощина: лощина
лужица: лужице
луна: луна
любить: любит
любовный: любовные
любовь: любви
любой: любого любой
люксембург: люксембурга
люпин: люпин люпина люпине
лютном: лютном
лютный: лютный
люциус: люциус
люциусом: люциусом
лягушка: лягушек лягушки
маг: магов маги маге магами магом маг
магазин: магазином магазине магазин магазина
магазинный: магазинная
магазинчик: магазинчиков магазинчиками
магический: магического магической магические магических магическим магическими
магия: магия магии магией
магла: магла
маглов: маглов
магловские: магловские
магловский: магловский
магловских: магловских
магловском: магловском
маглоотталкивающие: маглоотталкивающие
маглорожденных: маглорожденных
маглы: маглы
мадам: мадам
майкл: майкл
макгонагалл: макгонагалл
македонский: македонски
макнейр: макнейр
максим: максим
маленький: маленькая маленьком маленькой меньше мало маленькое
малкин: малкин
малоимущий: малоимущим
малфоев: малфоев
малфоем: малфоем
малфой: малфой
малфою: малфою
малфоя: малфоя
мальсибер: мальсибер
мальчик: мальчика мальчику
манекен: манекены
мантия: мантией мантиями мантии мантий
марволо: марволо
марта: марта
маска: маски
масса: масса
мастерская: мастерской
материал: материал
мать: мать
мгновенный: мгновенной
мебель: мебелью мебель
меблировать: меблированных
медальон: медальоном медальон
медиафайлы: медиафайлы
медный: медный медными
международный: международный
мелкий: мелкий
мемориал: мемориал
меньшой: меньшую
мера: мере
меропа: меропа
меропы: меропы
местами: местами
местный: местном
место: место места местом месту месте
местонахождение: местонахождение
местоположение: местоположение
месторасположение: месторасположение
меткий: метки
метла: метла метлы
мех: меха
миленький: миленькие
миллиметр: мм
милый: милый
миля: миль
минерва: минерва
министерский: министерские
министерство: министерства министерство министерстве министерству
минута: минут
мир: мира мир миром миры мире
мириам: мириам
миссис: миссис
миссия: миссии
мистер: мистера мистер
миф: мифов
мифологический: мифологическим
младший: младшего младший младшие
мнение: мнению
многие: многие многих
многий: многое
много: более много
многоразовый: многоразового
многочисленный: многочисленные
множество: множество
мобильный: мобильная
могила: могилы могила могилу
могущественный: могущественных
модель: модели
можно: можно
молли: молли
молниеносно: молниеносно
молодая: молодых
момент: моменту момент
монета: монета монеты
мор: море
морить: моря
мороженое: мороженое мороженого
морт: морт
морта: морта
морфин: морфин
мотив: мотивам
мочь: мог могли могут
мошенник: мошенники
мракс: мракс
мраксов: мраксов
мракэнтлен: мракэнтлен
мрамор: мрамора
мраморный: мраморном
мрачный: мрачный
мстить: мстя
муж: мужем
мужской: мужского
мунго: мунго
мусорный: мусорным
мы: нами нам
мышь: мыши
мэнор: мэнор
мэттьюз: мэттьюз
мюриэль: мюриэль
мятный: мятные
наблюдать: наблюдают
набор: набор наборы
наведаться: наведались
наверх: наверх
наверху: наверху
навигация: навигации навигация
нагайну: нагайну
нагайны: нагайны
наглухо: наглухо
наговор: наговор
над: над
надвинуть: надвинутому
надеяться: надеявшийся надеясь
надпись: надпись
нажать: нажать нажав
назад: назад
название: названия название
назвать: назвать назвали
наземникус: наземникус
назойливый: назойливых
называть: называть
наиболее: наиболее
найти: найдены найти
накладывать: накладывала
накормить: накормлены
наложить: наложенные наложены наложил
намного: намного
нападение: нападение
написать: написал написано написала
напиток: напитки
напоминать: напоминает
напрасно: напрасно
например: например
нарисовать: нарисовала
нарнии: нарнии
народ: народ
нарушать: нарушают
нарцисс: нарциссы нарциссе нарцисса
насекомое: насекомыми
насильно: насильно
настолько: настолько
настоятельный: настоятельному
настоящее: настоящему
насчитывать: насчитывает
натиск: натиск
научить: научил
находиться: находящаяся находится находилась находятся находящийся находился
начало: начало начала
начинать: начинающего начинает начиная
начинаться: начинается
наш: наших нашей наше
наяву: наяву
небольшой: небольшой небольшую
невдалеке: невдалеке
невзрачный: невзрачная невзрачный
невидимка: невидимка невидимкой
невидимый: невидимого
невилла: невилла
невиновный: невиновные
невозможно: невозможно
неволшебникам: неволшебникам
негативный: негативно
негодяй: негодяя
недалекий: недалеко
недаром: недаром
недовольство: недовольству
недостоверный: недостоверный
недуг: недуги
незаконный: незаконное
незнакомец: незнакомец
неизвестно: неизвестно
неизменно: неизменно
неисправный: неисправной
некий: некоем
некоммерческий: некоммерческой
некоторые: некоторых некоторые
некоторый: некоторое
нельзя: нельзя
немагическими: немагическими
немецкий: немецком немецкое
немного: немного
немытый: немытые
необходимо: необходимо
необходимый: необходимые
неосторожность: неосторожность
неполный: неполный
неправильно: неправильно
непреложный: непреложный
непригодный: непригодными
непроницаемый: непроницаемыми
нерадивый: нерадивых
несколько: нескольких несколько
несмотря: несмотря
несовершеннолетний: несовершеннолетних
несовместимый: несовместимый
несчастный: несчастного
неудачно: неудачно
неудачный: неудачного
неудержимый: неудержимый
неудивительный: неудивительно
нечто: нечто
нидерланды: нидерландов
низкий: ниже
никакой: никаких никаким
никогда: никогда
никто: никто
нимбус: нимбус
нимфадора: нимфадора
ничей: ничьей
новоявленный: новоявленный
новый: новые новых новыми
номер: номер
нора: норы норе нора
норрис: норрис
носить: носят
носок: носков
нравиться: нравятся
нуждаться: нуждалась
нужно: нужно
нурменгард: нурменгард
нурменгарда: нурменгарда
нынешний: нынешнего
об: об
обедать: обедать
обет: обет
обещать: обещая
обитание: обитания
обитать: обитали
облазить: облазив
облезть: облезших
облик: облик
обличие: обличье
обманка: обманки
обмен: обмена
обморочный: обморочные
обнаружение: обнаружении
обнаружить: обнаружить обнаружили
обои: обоями
обоняние: обоняния
оборотень: оборотнем оборотня оборотню
образ: образом
обрасти: оброс
обратиться: обратится
обратный: обратное
обрыв: обрыв
обставить: обставленную
обсуждение: обсуждение
обутый: обуты
обучаться: обучается
обучение: обучение
обшарпать: обшарпанный обшарпанном
общий: общего
объединять: объединяет
объяснение: объяснения
объяснить: объяснила
обыгрывать: обыгрывает
обычно: обычно
обычный: обычное
оглушать: оглушающее
огонь: огня
ограбить: ограбили ограбить
ограбление: ограбления ограбление
ограничиваться: ограничивается
огромный: огромном огромной огромное
одежда: одежды
одетый: одеты
один: одну одной одна одном одного один одно одним
одиннадцать: одиннадцати
одичать: одичавшем
однажды: однажды
однако: однако
одновременно: одновременно
ожерелье: ожерелья ожерелье
ожог: ожоги
озеро: озера
означать: означает
озорной: озорным
оказаться: оказавшийся
оказываться: оказывается
окно: окнами окна
около: около
окончание: окончания
окраина: окраине
окрестность: окрестности
окрестный: окрестная
окружать: окружает окружающего
окружить: окружена окружили
октябрь: октября
олимпий: олимпия
олливандер: олливандер
олливандера: олливандера
олливандеров: олливандеров
олово: олова
они: им них
опасно: опасно
опасный: опасных
операция: операция
описание: описанию описание
описать: описанный описана
описываться: описывается
оправдать: оправдано
опрятно: опрятно
опыт: опыте
опытный: опытными
орган: орган
организация: организации организация
орден: ордену ордена орден
орел: орла
орешек: орешки
орфография: орфографии
ослепительно: ослепительно
осматривать: осматривать
основатель: основателей основатель
основательница: основательниц
основать: основанный основан
основное: основном
основной: основная
особенно: особенно
особняк: особняк
особый: особой
оспа: оспа
оставить: оставил
останавливать: останавливала останавливают останавливал
останки: останки
остаться: остались остался осталась
остров: островов острове
осязание: осязания
отбывать: отбывает отбывают
ответ: ответ
ответить: ответил
ответственность: ответственности
отвечать: отвечали
отвлекать: отвлекающие
отвозить: отвозит
отвращение: отвращение
отдел: отдел отдела
отделение: отделение отделения
отделить: отделены
отдельный: отдельных отдельные
отделять: отделяют
отец: отца отец
отказ: отказ
отключать: отключал
открываться: открывается
открытие: открытия
открыть: открыть открыли
открыться: открылся открывшихся
откуда: откуда
отличаться: отличаться отличается
отличие: отличие
отличительный: отличительная
отличный: отличном
отметить: отметить
отнести: отнесло отнесла
отнестись: отнесутся
относиться: относится
отныне: отныне
отобрать: отобрало
отполировать: отполированные
отправиться: отправиться
отправляться: отправляется
отпускать: отпускали
отравление: отравления
отредактировать: отредактирована
отросток: отростком
отряд: отряда отряд
отсиживаться: отсиживался
отсутствие: отсутствия
отсутствовать: отсутствует
отсюда: отсюда
оттери: оттери
оттуда: оттуда
отходить: отходит
отчаянно: отчаянно
отчитываться: отчитывается
отыскать: отыскать
офис: офис
официальный: официальное
охранник: охранника охранники
охранять: охраняло охраняют охраняла
охраняться: охраняется
очень: очень
ошибка: ошибке
паб: паб пабах паба
паддифут: паддифут
пакет: пакет
палата: палате
палочка: палочку палочек палочка палочками палочки палочкой
памятник: памятник
память: память
пар: пар пара
парадное: парадного
парадный: парадный
параллельный: параллельном параллельными
парк: парк
паркий: парком
пародия: пародии
парочка: парочек
парус: парусе
патентовать: патентованные
паучий: паучий паучьем
пахнуть: пахнуть
пациент: пациентами пациенты
певерелла: певерелла
певереллов: певереллов
педдл: педдл
первое: первое первых первом
первый: первый
перевод: переводы переводах переводе перевод
переводиться: переводящееся
перед: перед
передаваться: передающийся
передвигаться: передвигаются
переживать: переживать
пережить: пережила пережил
перейти: перейти
переметнуться: переметнулись
перенаправить: перенаправлено
переставить: переставить
переть: при
переулок: переулке переулок переулку переулка
переход: перехода
переходить: переходит
перо: перья перьев перу
перси: перси
персиваль: персиваль
персонаж: персонажи
персонал: персонал
персональный: персональные
перчатка: перчатки
пес: пса
петля: петли
петтигрю: петтигрю
петуньи: петуньи
печальный: печальна
печать: печати
печень: печень
пещера: пещеры пещере пещера
писательница: писательницы
письмо: письма
питер: питером питер питере
питомец: питомцами
пить: пьющих
пл: пл
плакат: плакат
план: план плане
платить: платит
платформа: платформами платформы платформа платформу
плащ: плащи
племянник: племянником
пленник: пленников
плита: плита
плохой: худшие
площадь: площадь
побег: побега
поведение: поведения
поверх: поверх
поверхность: поверхности
повествование: повествовании
повод: поводу
погибать: погибает
подавать: подаваемая
подарок: подарок
подбираться: подбираться
подвал: подвалов
подвергнуться: подвергся
подготовка: подготовке
поддерживать: поддерживающую поддерживать
подземелье: подземелья подземельям
подземный: подземный подземному подземные
подкинуть: подкинул
подмор: подмор
подниматься: поднимается
подогнать: подогнать
подпол: подпола
подробный: подробнее
подслушать: подслушал
подслушивание: подслушивания
подставить: подставлен
подходить: подходят
подчиняться: подчиняются
поезд: поезд
пожаловать: пожалуй
пожертвовать: пожертвовать
пожиратель: пожирателям пожирателей пожиратель пожирателем пожиратели
позади: позади
поздний: позже поздним позднем
познакомиться: познакомился
поиск: поисках поиск поиску
пойти: пойти
пока: пока
показать: показана
покидать: покидает покидал
покоиться: покоятся
поколение: поколение поколения
покровительствовать: покровительствовать
покупать: покупать покупают
покупка: покупки покупками
пол: полы полу пола пол
полезный: полезной
политик: политика политике
полиция: полиции
полнолуние: полнолуние полнолуния
полный: полной полными полным
половина: половины
положить: положили
полок: полках
поломка: поломка
полтергейст: полтергейстах
полукровка: полукровка
полумну: полумну
полумны: полумны
полуразвалившееся: полуразвалившееся
получать: получает
получить: получить
получиться: получится получилось
полыхалок: полыхалок
пользоваться: пользующиеся пользовался
помадка: помадки
поменять: поменял
поместиться: поместиться
поместье: поместье
помещение: помещения помещение
помнить: помнит
помочь: помочь
помощница: помощниц
помощь: помощью помощи помощь
помфри: помфри
помянуть: помянуть
понимать: понимает
попадать: попадает попадают
попасть: попал попасть попало попала
попечитель: попечителей
попискивать: попискивающие
попросить: попросить
популярный: популярное популярны
попытаться: попытается попытался
попытка: попытки попытку
пора: пор
поражение: поражения
порох: порохом пороха
порошок: порошок
порт: порту
портал: портал порталами
портативный: портативное
портрет: портретами
португалия: португалии
порча: порча
порядок: порядок порядке
посадить: посаженное посадили посажены
поселение: поселение
поселиться: поселился поселились
посетитель: посетителей
посещать: посещать посещала посещаемым
поскольку: поскольку
последний: последнее последний последних последней
последовать: последовав
последующий: последующих
пособничество: пособничество
посол: после
посреди: посреди
посредство: посредством
постер: постерами
постоянный: постоянная
построить: построена
постройка: построек
поступить: поступил
поступление: поступления
поступок: поступком
посуда: посуда посудой
потайной: потайных
потенциальный: потенциальных
потерять: потерявшими
потолок: потолок
потомок: потомков
потрясать: потрясающий
поттер: поттером поттер поттера поттеров поттеру поттере
поттеромания: поттеромания
похвастаться: похвастаться
похищение: похищения
похожий: похожий
похоронить: похоронены
почему: почему
починить: починить
почта: почты
почтальон: почтальоны
почтить: почти
почувствовать: почувствовавшая
поэтому: поэтому
появиться: появились появился
появление: появлением появления
появляться: появлялся появляется
пояс: пояса
пр: пр
править: правило править
правка: правок правки
правомерность: правомерность
правосудие: правосудия
практический: практически
пребывание: пребывания
превратиться: превратившись
превращаться: превращался
предлагаться: предлагаются
предмет: предметов предметы предмет
предоставить: предоставить
предположить: предположить
предпочитать: предпочитают
представитель: представитель
представить: представить
представиться: представились
представлять: представляют представляющее представляющая
представляться: представляется
предъявить: предъявить
предыстория: предыстория
прежде: прежде
преимущественный: преимущественно
прекрасный: прекрасным
прекращать: прекращали
преобладать: преобладает
преобразовать: преобразовали
преподаватель: преподавателей преподаватели
преподавательница: преподавательницей
преследование: преследования
преступление: преступления
преступник: преступники
приблизительно: приблизительно
прибор: приборов
прибрежный: прибрежных
прибывать: прибывавших прибывает
прибыльный: прибыльное
прибыть: прибыли
привезти: привезли
привозить: привозит
привычный: привычного
приглядеться: приглядеться
пригород: пригород
приезжать: приезжает
призвать: призвана
призрак: призраками
прийтись: пришлось
приказ: приказу
приказание: приказания
приказать: приказать
прикол: приколы
приколоть: приколов
прикосновение: прикосновением
приличный: поприличней
применение: применения
применить: применить
пример: примеру
примерный: примерно
примечание: примечания
примоститься: примостившаяся
примыкать: примыкает
принадлежать: принадлежащий принадлежал принадлежит
принимать: принимает
приниматься: принимаются
принц: принц
принять: принято приняв принять
приобрести: приобрести
припугнуть: припугнув
природа: природу
прислать: присланным пришли
приспичить: приспичило
пристанище: пристанища пристанище
пристраивать: пристраивали
присутствовать: присутствует
притон: притоном
притулиться: притулился
притягательный: притягательным
приход: прихода
приходить: приходит
приходиться: приходится
прихожая: прихожей
причина: причину
пришествие: пришествия
пришибить: пришибленными
приют: приюта приюте приют
приютский: приютский
приятный: приятное
проба: пробы
пробиваться: пробивается
пробираться: пробирается
пробраться: пробраться
проверить: проверил проверенной
проверка: проверкой проверки
проверять: проверяет проверяют
проверяться: проверялась
провести: провести
проводить: проводит проводили
продавать: продающий продают продаваемой продавал
продаваться: продаются
продажа: продаже
проделка: проделок
продолжать: продолжала
проект: проектах
проживание: проживания
проживать: проживая проживает
проиграть: проиграв
производитель: производители
производство: производство
произнести: произнесла
произойти: произошла произошло
происходить: происходят происходил происходит
пройти: пройдя пройти прошли
проклясть: проклятого проклятое проклятые проклятых
прокрасться: прокрались прокрасться
промахнуться: промахнувшийся
проникать: проникают
проникнуть: проникнет
пророк: пророка пророк
пророчество: пророчество
просить: просит
проследовать: проследовать
просмотр: просмотры
простейшее: простейших
простираться: простираются
просто: просто
пространственный: пространственно
пространство: пространство пространства
прототип: прототипом
профессор: профессором профессор
проходить: проходят
прочий: прочее
прочитать: прочитал
прочить: прочим
прыщевыводитель: прыщевыводитель
прямая: прямых
прятать: прячет
прятаться: прятаться
псих: псих
птица: птицами птиц
пустить: пустить
пустовать: пустующим
пустой: пустой
пусть: пусть
путеводитель: путеводитель
путешествовать: путешествуют
путь: путь путями
пушистики: пушистики
пушистиков: пушистиков
пушистый: пушистые
пушка: пушек
пытаться: пытаются
пытка: пыток пытки
пята: пятой
пятачок: пятачке
пять: пятью
рабастан: рабастан
работа: работу
работать: работают работать работала работающий
равный: равен
ради: ради
радио: радио
разборный: разборные
разговаривать: разговаривают
разговор: разговор
разделить: разделены
разделять: разделяющую
размер: размера размерах размеров
разместить: разместить
разместиться: разместилась
разновидность: разновидности
разномастный: разномастна разномастной
разнообразный: разнообразные
разный: разные разное разного
разработать: разработали
разработка: разработки
разработчик: разработчики
разрешать: разрешает
разрешение: разрешение разрешения
разрушаться: разрушается
район: районе
ракушка: ракушка
ранение: ранения
раненый: ранен
ранить: раненного ранил
ранний: раньше
расписать: расписано
располагаться: располагалась
расположение: расположение
расположить: расположенный расположен расположены
распределять: распределяющая
рассказ: рассказы
рассказывать: рассказывал
рассмотрение: рассмотрении
рассориться: рассорился
рассохнуться: рассохшимися
рассудок: рассудка
растение: растениями
рвота: рвота
реальность: реальности
ребенок: детей дети
ребята: ребята ребятам
регулус: регулус
регулярно: регулярно
реддл: реддл
реддла: реддла
реддлов: реддлов
реддлом: реддлом
реддлы: реддлы
реж: реже
резиновый: резиновых
резка: резкой
резкий: резко
результат: результате
река: река
рекламный: рекламным
религиозный: религиозные
ремень: ремни
ремонт: ремонт
репутация: репутация репутацию
ресторан: рестораны
решать: решает
римус: римус
римуса: римуса
римусе: римусе
рисунок: рисунок
рог: рога
родитель: родителям родителей родители
родить: родив
родиться: родился
родной: родной
родственник: родственников родственник
роды: роды
рождение: рождения
рождественский: рождественские
рождество: рождество
розмерты: розмерты
розовый: розовые
ролик: ролике
роль: роль
роман: романов романе романом романах
рон: рону рона рон
росмэн: росмэн
роулинг: роулинг
рубеус: рубеус
рудольфус: рудольфус
рука: руки
руквуд: руквуд
рукомойник: рукомойник
рукотворный: рукотворных
русский: русский
руфус: руфус
рыскать: рыщущих
ряд: рядом
сага: саг
сад: саду сад
салазара: салазара
сам: самого самой самом самих сами самое само
самозаправляющиеся: самозаправляющиеся
самопомешивающиеся: самопомешивающиеся
самый: самым самые
сантиметр: см
сапог: сапог
сарай: сарай
сарайчик: сарайчике
саундтрек: саундтрек
сахарный: сахарных
сбежать: сбежала сбежав сбежал
сбережение: сбережения
свадьба: свадьбы свадьбе
сведение: сведения сведениями сведений сведениям
свежий: свежие
света: свет света
светлый: светлые
свидетельство: свидетельства
свободный: свободного свободной
сводить: сводить
свое: своих свои своему своего своим своими
своеобразный: своеобразный
свой: своей свою
связанный: связанные связанных связанным
связаться: свяжитесь
святой: святого
сдаваться: сдаются
сделать: сделает сделанные сделало
себя: собой
северный: северный северном
северо: северо
северус: северус
северуса: северуса
северусом: северусом
седрик: седрик
седьмой: седьмой
сейф: сейфы сейфа
секретный: секретный секретные
семейный: семейный
семейство: семейство семейства
семестр: семестр семестра
семикнижья: семикнижья
семь: семь
семью: семью
семья: семья семей семье семьи
сент: сент
сентябрь: сентября
сепсис: сепсис
серебро: серебра
серебряный: серебряные серебряных
сериал: сериал
серия: серии серию серия
сестра: сестрой
сесть: сесть
сеть: сеть
сивилла: сивилла
сивый: сивым
сидеть: сидела
сикле: сикле
сиклей: сиклей
сикли: сикли
сикля: сикля
сила: сил
силберстейн: силберстейн
силковый: силков
сильный: сильным
символизировать: символизирующий
синеть: синей
сириус: сириуса сириус сириусе сириусом
сирота: сирот сиротам сиротой
система: системе
сказка: сказки
сказочный: сказочно
скала: скал
скачать: скачать
сквозь: сквозь
склад: склад
складный: складной
скончаться: скончался
скоростной: скоростных
скорый: скорее
скримджер: скримджер
скрипеть: скрипеть
скрываться: скрывался скрываться скрывалась скрывается скрывающийся скрываясь
скрытый: скрыт скрытые
славиться: славится
славянский: славянские
сладкое: сладкого сладкое
сладость: сладости сладостей
слегка: слегка
следующий: следующий
слизень: слизни
слизерина: слизерина
слизняк: слизняки
слишком: слишком
слово: словам словами слово
слог: слоги
сложно: сложно
слой: слой
сломать: сломанными
слон: слона
служебный: служебные
случай: случаях случай случаи
случайно: случайно
случайный: случайная
слышать: слышал
смелый: смелым
смертельный: смертельно
смерть: смерти
сметвик: сметвик
смех: смех
снаружи: снаружи
снегг: снегг
снегга: снегга
снеггом: снеггом
снимать: снимают
снятие: снятии
снять: снятых
собака: собаки
собираться: собираются собирались
собрание: собрание
собственный: собственной собственную собственная собственное
событие: события событий событиях
сова: сов совы совой
совершать: совершал
совершаться: совершаются
совершенно: совершенно
совершить: совершившие
совет: совета советом совету
советовать: советует
совиный: совиный совиной
современный: современной
содержание: содержание
соединять: соединяет
сожжение: сожжении
создание: создания
создать: создать созданная
сомнение: сомнения
сообщество: сообщество сообщества
сообщить: сообщить
соответствие: соответствии
сопровождать: сопровождаемая сопровождала сопровождает
сопротивление: сопротивление
составлять: составляют
состоять: состоящим
состояться: состоялось
сотня: сотни сотню сотней
сотрудник: сотрудник сотрудников
сохранение: сохранением
сохранять: сохраняя
спальный: спален
спальня: спальня спальни спальне
спародировать: спародировать
спасаться: спасаясь
спасение: спасения спасение
спать: спят
специализация: специализация
специализироваться: специализируется
специальный: специальный специально
спешить: спешит
список: список
спокойный: спокойно
спора: споры
спортивный: спортивных
способ: способа
способность: способностей
способный: способен
справка: справка
спрос: спрос
спрятать: спрятать спрятан спрятал
спустя: спустя
срабатывание: срабатывание
сражаться: сражаются
сражение: сражения
среди: среди
средний: средние среднем
средство: средства
средь: средь
срок: сроке
срочный: срочно
српски: српски
српскохрватски: српскохрватски
ссылка: ссылка ссылками ссылки
стадий: стадии
стакан: стаканы
сталагмит: сталагмиты
сталактит: сталактиты
становиться: становятся становится становились
станция: станция станции
старинный: старинный
старое: старыми старому старое
староста: старосты
старуха: старухи
старший: старший
старый: старой старый
статистика: статистика
статуя: статуе
стать: стал стали
статья: статья статьи
ствол: стволе
стебель: стебель
стекло: стекло
стен: стен стену стене
стена: стеной
стерджис: стерджис
стиль: стиле
стоить: стоят стоило стоит стоящей стоящий
стол: стол столом столы
столик: столик
сторона: стороны сторону
сторонник: сторонники сторонников
стошнить: стошнит
стоять: стоял стояла
страна: странах страны стране страна страну стран
страница: страницы страница страницу странице
страут: страут
страшный: страшным страшное
строение: строение
студент: студенты студентов
стул: стульями
ступень: ступени
стэн: стэн
судить: судя
судьба: судьбе судьба
судьбоносный: судьбоносные
суровый: суровый
суть: сути
сучок: сучок
суша: суши
существо: существо существ существа
существование: существовании существования
существовать: существуют
сфинкс: сфинксов
схватить: схватил
сцена: сцену сценах
считать: считает считать
считаться: считается
съедобный: съедобные
съехать: съехали
сын: сына сын сыном сыну
сыпь: сыпи
сюда: сюда
сюжет: сюжете
сюжетный: сюжетном
т: т
табличка: табличкой табличка
тайком: тайком
тайна: тайн
тайник: тайники
тайный: тайный тайная тайной
также: также
таки: таки
такой: такой таким таких такие
текст: текст
текущий: текущие текущая
тележка: тележках
телескоп: телескопы телескоп
тем: тем
тематический: тематический
темный: темно
тереть: три
территория: территории
тик: тики
тип: типам
типография: типографией
тихий: тихое
ткацкий: ткацкой ткацкая
товар: товары товаров
товарный: товарный
толика: толику
толщина: толщина
том: томом тома
тонкс: тонкс
тоннель: тоннель
торговать: торгующая
торговец: торговцы
торговый: торговый
тот: том тех тот тому
точно: точно
трава: травы
травма: травмы
трактир: трактире трактир
трансгрессируют: трансгрессируют
трансформироваться: трансформировался
требовать: требуют
трелони: трелони
третий: третий третьей
треть: трети
третье: третьем третьего
треугольный: треугольную
тридцатый: тридцатых
трое: трое
троица: троица
труба: труб
труд: трудом
труднодоступность: труднодоступность
туда: туда
тупик: тупик тупике
турнир: турнир турнира
тухлый: тухлых
ты: тебе
тьма: тьмы
тюрьма: тюрьмой тюрьму тюрьма тюрьме тюрьмы
тяжкий: тяжкие
убежище: убежищем убежищу
убийство: убийства убийство
убийца: убийцу
убить: убил
убойма: убойма
уборка: уборке
убрать: убран
уверенность: уверенности
увидеть: увидел увидеть
угодить: угодили
угодно: угодно
удар: ударами
удаться: удалось
удивительный: удивительных
удлинитель: удлинители
удобный: удобен удобная
ужаление: ужаления
ужасный: ужасным ужасного
ужин: ужин
узкий: узкие узкая
узнать: узнают
узник: узник узники
уизли: уизли
уилтшире: уилтшире
уингинг: уингинг
уйти: уйти
указание: указанием
указать: указано указан
украсить: украсила украшен
украсть: украсть
укрытие: укрытия
укус: укусы укусов
улица: улица улице улицы
улочка: улочка
умереть: умерла
уместить: уместили
уметь: умеет
умирать: умирали
унд: унд
универмаг: универмаг
уникальный: уникальную
унция: унцию
унылый: унылое
уолден: уолден
упасть: упал
упоминание: упоминанию
упоминаться: упоминавшиеся упоминающийся упоминается
упомянуть: упомянуты
управление: управления
управлять: управляют
упырь: упырь
уровень: уровень
урок: уроки
усадьба: усадьбы
усилие: усилий
условие: условий условия
услуга: услугами
успевать: успевает
успешный: успешное
успокоить: успокоить
устойчивый: устойчивая
устраивать: устраивали
устроить: устроил
утащить: утащил
утверждение: утверждениями
утихомирить: утихомирить
уточнение: уточнение
уханье: уханье
ухитриться: ухитрился
ухо: ушей
уход: уходу
участие: участие участия
участник: участниками
участок: участок
учащийся: учащиеся
учебник: учебниками учебники учебников
учебный: учебного
ученик: учеников ученики ученикам
учиться: учатся учились учился училась
фабрика: фабрикой фабрика
фаджа: фаджа
факт: фактов
факультет: факультета
фантазийных: фантазийных
фантастический: фантастические
февраль: февраля
феникс: феникса
фенриром: фенриром
фигура: фигуре
фиделиус: фиделиус
философия: философия
философский: философский
филчем: филчем
фильм: фильм фильме фильмов фильмах
флетчер: флетчер
флитвик: флитвик
флориан: флориана
флориш: флориш
флюм: флюм
фокус: фокусы
фонд: фонд
форд: форд
форма: форма форме форму
фортескью: фортескью
форум: форум
фоссетов: фоссетов
фр: фр
франция: франции
фред: фредом фред фреда
фрэнк: фрэнк
фундамент: фундамент
функция: функции
фунт: фунту фунтам
хагрид: хагрид
хагрида: хагрида
халат: халаты
хватать: хватает
хвост: хвосте
хенгист: хенгист
хижина: хижине хижину хижина хижины
хлам: хламом
хобби: хобби
хогвартс: хогвартс
хогвартса: хогвартса
хогвартсе: хогвартсе
хогсмид: хогсмид
хогсмида: хогсмида
хогсмиде: хогсмиде
ход: ходом хода ходов ходу ход
ходить: ходили
хозяин: хозяин хозяина
хозяйка: хозяйки
холихедских: холихедских
холл: холле холла
холм: холмами
холодный: холодной холодно
хороший: лучше
хотеть: хотел
хоть: хоть
хранилище: хранилище хранилища
хранитель: хранителями
хранить: хранят
храниться: хранившийся
хроник: хроник
хулиган: хулиган
хэнглтон: хэнглтон
хэнглтоне: хэнглтоне
цвет: цвета цветами
целитель: целитель целителей целители
целительница: целительница
цель: целью
цена: ценой цены
ценный: ценных
центр: центр
цепь: цепей
цикл: цикла
цилиндр: цилиндр
цитировать: цитировать
чанг: чанг
чар: чары чарами
чародейство: чародейства
час: час
частить: части
частность: частности
часто: часто
часть: часть
часы: часы
чей: чьи
человек: человек людьми человека людей
чемпионат: чемпионат
чердак: чердаком чердак
через: через
черепаха: черепахи
черта: черта
честь: честь
четверть: четверти
четыре: четыре
чжоу: чжоу
число: числе
чистка: чистке
чистота: чистоту чистотой
читать: читать
член: членов членом члены
чтобы: чтобы
чугунный: чугунные
чудесный: чудесного
чудище: чудищах
чудо: чудо
чудовищный: чудовищной
чужая: чужим
чулан: чулан
чуть: чуть
шанпайк: шанпайк
шапка: шапка
шарик: шарики
шармбатон: шармбатон
шармбатона: шармбатона
шахматный: шахматную
шестая: шестой
шесть: шесть шести
шина: шины
шип: шипы
шкаф: шкаф шкафы шкафами шкафов шкафах
школа: школа школу школе школой школы школ
школьник: школьники
школьный: школьный школьного школьные
шляпа: шляпы шляпа
шоколадный: шоколадные
шон: шон
шотландия: шотландии
штаб: штаб
штука: штуку
штурм: штурм
штучка: штучек
шуба: шубы
шум: шума
шутка: шутки
щит: щиты
э: э
эвакуировать: эвакуировать
эйвери: эйвери
экз: экз
экзамен: экзамены
экземпляр: экземпляров
эксклюзивный: эксклюзивные
эксперимент: эксперименты
экспресс: экспресс
элемент: элемент
эльф: эльф эльфу
эмблема: эмблемами
эми: эми
эмоция: эмоции
энциклопедия: энциклопедии
эра: эры
этаж: этаже этажами этажах этаж
этимология: этимология
это: этом это этому этим
этот: этой этих эта эту
юго: юго
юмор: юмором
юный: юным
являться: является
язык: язык языках языка
яйцо: яиц
якоб: якобы
яксли: яксли
янус: янус
ярка: яркой
яркий: яркими
ясный: ясно
ячменный: ячменный
