авад: авада
авария: авария
август: августа
авив: авивом
автобус: автобус
автоматически: автоматически
авторство: авторства
адский: адского
азкабан: азкабан
азкабана: азкабана
аламейне: аламейне
аластор: аластор
аластора: аластора
алексей: алексей
алиса: алисы
алфавит: алфавиту
альбус: альбус
альбуса: альбуса
альпина: альпина
амбридж: амбридж
американский: американском
анатолий: анатольевич
англ: англ
английский: английской английского
андреа: андреа
андрей: андрей
анимаг: анимаг
анимагу: анимагу
аниме: аниме
апрель: апреля
арест: ареста
армия: армии
архив: архив
архивировать: архивировано
архивный: архивная
астрель: астрель
атака: атаке атак
атаковать: атаковал
аукцион: аукционе
б: б
балл: баллов
банк: банка
барда: барда
барти: барти
бежать: бежал бегущая бежать
безжизненный: безжизненное
безуспешный: безуспешны
беларуская: беларуская
белатрисса: белатрисса
белизна: белизна
беседа: беседе
библиографический: библиографических
бидля: бидля
билл: билла билл
биография: биография биографию
битва: битве битву битвы
благодаря: благодаря
блестеть: блестящим
ближний: ближайшей
близкий: близко
блэк: блэк
блэка: блэка
блэков: блэков
блэком: блэком
блэку: блэку
богатый: богат
боггарт: боггарт
боггарта: боггарта
бой: боя боях
болеть: болеть
больница: больницу
больший: большей большими большая большую больше
большой: большом
борьба: борьбы
боттлингер: боттлингер
бояться: боялись
брат: брата братьям братьев брат братья
бросать: бросали
брюнет: брюнет
бузинный: бузинной бузинная
букля: букля
буря: бурю
български: български
быстров: быстров
быть: бывшему будучи были
вадим: вадим
вакансия: вакансия
василиск: василиска василиск
вд: вд
век: веке
великобритания: великобритания великобритании
вернон: вернон
вернуться: вернуться вернувшимся вернулся
версия: версия
верх: верх
ветеран: ветераны
вечер: вечером
взаимосвязь: взаимосвязь
взять: взяла взять
взяться: взялся
вид: видом вид виде
видео: видео
видеоролик: видеоролик
видеть: видит видели видя видел
видимо: видимо
визжать: визжащей
визит: визита
вика: вики
викиданных: викиданных
викимедиа: викимедиа
викиновости: викиновости
википедии: википедии
википедия: википедия
викисклад: викисклад
викискладе: викискладе
виновный: виновен
вклад: вклад
включать: включая
владеть: владел
владимир: владимир
власть: власти
влияние: влияние
вместе: вместе
вмешаться: вмешался
внесение: внесения
внести: внесено
внешний: внешние
внешность: внешность
вновь: вновь
вовсе: вовсе
военный: военных
возвращение: возвращение возвращении
возглавить: возглавил возглавить
возле: возле
возможно: возможно
возненавидеть: возненавидел
возраст: возраст возрасте
возродиться: возродиться возродившийся
возрождение: возрождение возрождения
война: войн
войти: войти
вокзал: вокзал
волан: волан
волос: волосы
волшебник: волшебником волшебника волшебников волшебнике волшебник волшебники
волшебница: волшебница
волшебный: волшебные волшебная волшебный
волшебство: волшебства волшебству
воля: воли волю воле
воплощение: воплощение
вопреки: вопреки
воронцов: воронцов
воскрешать: воскрешающего
воспоминание: воспоминания воспоминаний
восхождение: восхождение
восьмой: восьмой
впадина: впадине
впервые: впервые
впоследствии: впоследствии
враг: врага врагом
врать: врать
врач: врачом
вредилки: вредилки
временить: времени
временно: временно
время: времена время
все: всех всего всем
вселенная: вселенная
вселиться: вселился
встать: встала
встретить: встретил
встретиться: встретился
встречать: встречает
встречаться: встречались
вступить: вступил вступившему
вторжение: вторжения
второе: второго
второй: вторая
вустерширского: вустерширского
выбрать: выбрав выбрал
выбраться: выбраться
выгнать: выгнал
выдаваться: выдающийся
выдвигать: выдвигает
выдумщик: выдумщиком
выжить: выжил
вызвать: вызвал вызвать
вызов: вызов
вызывать: вызывать
выиграть: выиграл
выйти: выйти вышла выйдет
выманивать: выманивает
вымыслить: вымышленные
вынудить: вынуждены
выпасть: выпавшей
выполнить: выполнить
выполнять: выполнять выполняя
выпускаться: выпускается
вырасти: вырос
выручать: выручай
выставка: выставки
выставлять: выставлял
выступление: выступления
вытечь: вытекли
выход: выход выхода
выходить: выходит
выходка: выходку
выяснить: выяснить
г: г
газета: газета
галлеонов: галлеонов
гарри: гарри
гейтс: гейтс гейтса
гера: герой
гермиона: гермиона гермионы гермионой гермионе
героизм: героизме
герой: героем героев герои
гибкий: гибкая
гигантский: гигантской
глава: главе глава
главное: главным главных
главный: главный
главый: главой
глаз: глаза глазах
говорить: говорит
говориться: говорится
год: году годах лет год годы года
годрикова: годрикова
годриковой: годриковой
голос: голосом
город: городе
горячий: горячая
госпиталь: госпиталь
гость: гости
государственный: государственного
грейнджер: грейнджер
гринготтс: гринготтс
гриффиндор: гриффиндор
гриффиндора: гриффиндора
гриффиндорская: гриффиндорская
грюм: грюм
грюма: грюма
дадли: дадли
дальнейший: дальнейшем дальнейшая
дамблдор: дамблдор
дамблдора: дамблдора
дамблдором: дамблдором
дамблдору: дамблдору
дар: дары
дата: дата
дать: данным дать
два: двух двумя
двоюродный: двоюродный двоюродного
де: де
дебютировать: дебютировал
девин: девин
действие: действия
действовать: действовать действует
декабрь: декабря декабре
делакур: делакур
дементор: дементор
дементора: дементора
дементоров: дементоров
дементоры: дементоры
деннис: денниса
день: дней
деньга: деньги
держать: держали
детектив: детективом детектив
детская: детских детской
детство: детства детстве
деть: день дело
дж: дж
джеймс: джеймс джеймсом джеймса
джинни: джинни
джоан: джоан
джордж: джорджу джорджем
диггори: диггори
дилогия: дилогия
динской: динском
директор: директоров директор директора
директорский: директорском
дитя: дитя
длинный: длинное
дневник: дневник дневника
добавить: добавлена
добби: добби
добиться: добился
добраться: добраться добрался добрались
доброта: доброты
добыть: добыть
доверие: доверия
дож: дожем
док: док
доказать: доказал доказать
долгопупс: долгопупс
должен: должно должен
должность: должность
долорес: долорес
дом: дом доме
дома: дома
домашний: домашней
домовик: домовика
домовой: домового
дополнительный: дополнительных дополнительные
дополнить: дополнить дополните
доработка: доработок
доставить: доставил
достигнуть: достичь
достопримечательность: достопримечательностей
доступный: доступен
дочь: дочь
драко: драко
дракон: дракона
древний: древняя древнее
древность: древности
друг: друзья друзьями друг друзей другом друга
другой: другой другими другому другие других
дружба: дружбу
дружина: дружины
дружить: дружить дружила
дублировать: дублировал
думать: думая
дурмстранг: дурмстранг
дурной: дурная
дурслей: дурслей
дурсли: дурсли
дурсль: дурсль
дурслями: дурслями
душ: души
дуэль: дуэли дуэль
дэниел: дэниела дэниел
дюйм: дюймов
дядя: дяди дядя
единственный: единственной
ежедневный: ежедневный
еженедельный: еженедельного
еиналеж: еиналеж
елистрат: елистратов
ехать: едущем
ждать: ждет
желать: желающих
жена: жена
жениться: женился
жертва: жертву
жизнь: жизни жизнь жизнью
жила: жил жилах жила
жительство: жительства
жить: жившая живущего
журнал: журнала
забрало: забрал
заверить: заверила
завершение: завершения
завещание: завещанием
зависимость: зависимости
завладеть: завладеть
загадка: загадки
заглавный: заглавная
заглянуть: заглянул
заголовок: заголовком
задание: заданиями заданием
задумать: задумавшего задумал
заклинание: заклинания заклинаниями заклинание
заклятие: заклятие заклятием заклятия
заколдованный: заколдованным
закончить: закончить
закончиться: закончилась
зало: зале
заманить: заманить
заменить: заменить заменит
заметить: замеченным
замкнутость: замкнутость
замок: замок
занятие: занятия занятий занятиях
заняться: заняться
заодно: заодно
запереть: заперт
записка: записке
запись: запись
заподозрить: заподозрили
запрет: запрета
запретный: запретный запретном
зарегистрировать: зарегистрированный
заснуть: заснул
заставить: заставила
затем: затем
захватить: захватить
захоронение: захоронений
защита: защиты защита защите
защитить: защитил защитить
защищать: защищал защищала защищая
заявить: заявившего
заявление: заявление
звать: зовут
зверь: звери
звонить: звонили
здание: здания
зеленский: зеленский
зелье: зелья
зельеварения: зельеварения
зеркало: зеркала
зло: зла
змееуст: змееуст
змееустом: змееустом
змеиный: змеиным
змея: змеи змей змею змея
знак: знак
знакомить: знакомит
знакомиться: знакомится
знаменитость: знаменитостью
знать: знал
значительный: значительной
зов: зов
зоопарк: зоопарк
зритель: зрителей
игра: игра игр игре игры
играть: играл играла
игрок: игроком игрок
игрушечный: игрушечная
идти: идти
избранный: избранные
известие: известия
известный: известный
изготовление: изготовления
изд: изд
издание: издание
издать: изданных издана
излечить: излечив
излишний: излишне
изменение: изменений
изменяться: изменяться
израиль: израиле
изучать: изучать
икабог: икабог
именно: именно
имя: имя имени
иногда: иногда
иной: иного
инспекционный: инспекционной
институт: института
инструмент: инструменты
интервью: интервью
интересный: интересные
инферналов: инферналов
информация: информацию
ипром: ипром
искать: искал
исключение: исключением
исключить: исключен
искусство: искусств искусство
исполнение: исполнения
исполнить: исполнил
исполнять: исполнять
использование: использование использовании использования
использовать: используя использовал использующие использовали используют
испытывать: испытывал
истинный: истинный
история: история историй истории
источник: источник
исчезновение: исчезновение
исчезнуть: исчез
итог: итоге
июль: июля
июнь: июня
кабинет: кабинете
каждый: каждый
какой: каким
камень: камень камня
кандидатура: кандидатуру
капитан: капитан
карта: карта
картина: картины
карточный: карточная
касаться: касающееся
каталог: каталогах
категория: категории
качество: качества качествами качестве
квартира: квартира квартиру
квиддич: квиддич
квиддиче: квиддиче
квиддичу: квиддичу
квиррелл: квиррелл
квиррелла: квиррелла
квирреллу: квирреллу
кевин: кевин
кедавра: кедавра
кентавр: кентавров
кикимера: кикимера
кингс: кингс
кинематограф: кинематографе
кино: кино
кинуться: кинулась
кладбище: кладбище
клаудиа: клаудиа
клык: клыком
ключ: ключ
книга: книг книгах книги книге книга
книжный: книжный
когтеврана: когтеврана
код: код
кодекс: кодекс
кожа: коже
колдовство: колдовства
коллекционный: коллекционная
колючий: колючего
команда: команды команду команде
комиссия: комиссии
комментарий: комментариями
коммерсантъ: коммерсантъ
коммерческий: коммерческих
комната: комнате комнату комната комнаты
комсомольский: комсомольская
конан: конан
конаном: конаном
конец: конце
конструктор: конструктор
конфиденциальность: конфиденциальности
кончиться: кончилось
копия: копия
корморане: корморане
короткий: короткие короткий
корпорация: корпорации
коснуться: коснулся
косой: косой косом
который: которым которое которой которую которого которые которых которая котором который
кошка: кошку
кража: кражи
красносельский: красносельский
крауч: крауч
крестный: крестного
крестраж: крестраж
крестража: крестража
крестражах: крестражах
крестражей: крестражей
крестражем: крестражем
крестражи: крестражи
кровь: крови кровью кровь
кроме: кроме
кросс: кросс
кроссовер: кроссовере кроссовера
круглый: круглые
крыса: крысой
кто: кем
кубок: кубка кубок
куда: куда
кук: куки
кукушка: кукушки
культура: культуру
купить: купить
курс: курсе курса
кустарник: кустарника
кырык: кырык
лабиринт: лабиринте
лавгуд: лавгуд
ларусса: ларусса
лгать: лгать
легенда: легенде
лента: лента
лес: лесу лес
лестрейндж: лестрейндж
летний: летнего
лето: летом
лже: лже
лили: лили
линия: линия
литература: литературы литература литературе
литературный: литературных литературном литературный
лицензия: лицензии
лишение: лишениях
лишить: лишит
лишь: лишь
лоб: лбу
ловец: ловцом ловцов ловец
ловушка: ловушкой
ложный: ложный
локация: локации
лорд: лордом лорда лорд
лощина: лощина
луна: луна
любить: любили любит любила
любовь: любви любовь
люпин: люпин люпином люпина люпину
люциуса: люциуса
люциусом: люциусом
м: м
маг: маги мага
магазин: магазине магазинов магазин
магический: магической магические магическом магическая магическое
магия: магия магию магии магией
магл: магл
маглом: маглом
маглы: маглы
мадам: мадам
майо: майо
макгонагалл: макгонагалл
макдональд: макдональд
македонский: македонски
малкин: малкин
маловажный: маловажных
малфоев: малфоев
малфоем: малфоем
малфой: малфой
малфою: малфою
малфоя: малфоя
мальчик: мальчик мальчики мальчика мальчику
манге: манге
манги: манги
мантия: мантией мантию
мариэтта: мариэтта
мария: мария
марта: марта
мары: мары
мастер: мастером
материал: материал
матч: матчи матче
мать: мать матерью матери
махаон: махаон
мая: мая
медальон: медальон медальона
медиафайлы: медиафайлы
менее: менее
место: место места месте
местоположение: местоположении
месяц: месяцев месяц месяца
метла: метле метла
метод: методы
меч: мечом
милосердие: милосердие
миндалевидный: миндалевидные
минервой: минервой
министерство: министерства министерство министерством министерстве
министр: министра
мир: мира мир мире
миртл: миртл
миссис: миссис
мистер: мистера
мл: мл
младенчество: младенчестве
младший: младшего младшему младший младшая
мнение: мнению
многий: многому многом
много: более много
многократно: многократно
многочисленный: многочисленных многочисленные
множество: множество
мобильный: мобильная
могила: могилы могила могилу
можно: можно
молния: молния молнии
молодая: молодые молодых молодой молодым
момент: момент
монгол: монгол
морить: моря
морт: морт
морта: морта
мортом: мортом
морту: морту
мочь: мог могли могут могла
мощный: мощной
мракоборец: мракоборец
мракоборца: мракоборца
мракоборцев: мракоборцев
мракоборцы: мракоборцы
мраксов: мраксов
мрачный: мрачную
мужской: мужской
мужчина: мужчина
мультсериал: мультсериал
мурал: мурал
мучить: мучают
мы: нами нас
мышление: мышления
набедокурить: набедокурил
навигация: навигации навигация
навсегда: навсегда
нагайна: нагайна
нагайны: нагайны
над: над
надеяться: надеясь
надпись: надпись надписи
название: названием название
названый: назван
назвать: названный
назначить: назначенная
назойливый: назойливых
называть: называвшего называл
наивный: наивного
найти: найден
наказание: наказание
наказать: наказать
наказывать: наказывали
нападение: нападения нападениях нападение
напасть: напасть напал напали
написание: написания
написать: написал написавший написала
напрасный: напрасной
наравне: наравне
насколько: насколько
наследник: наследником
насмехаться: насмехаясь
настолько: настолько
настоящий: настоящий
наступление: наступлении
натравить: натравил
научить: научить
научиться: научился
научный: научный
находиться: находится находящимся находились находился
начало: начале начала
начать: начали
начинать: начиная
наш: наших
небольшой: небольшое
невидимка: невидимкой
невидимость: невидимости
невилл: невилл
невиллу: невиллу
невиновность: невиновность
невиновный: невиновен
невозможный: невозможным
невысокий: невысокого
недалекий: недалеко
неделя: недели
недостаток: недостатков недостаткам
недостоверный: недостоверный
недостойный: недостоин
незаконный: незаконном
незапланированный: незапланированным
неизменный: неизменной
нейтрализовать: нейтрализовать нейтрализовало
некий: неким некую
неком: неком
некоммерческий: некоммерческой
некоторые: некоторых
некоторый: некоторое некоторую
ненависть: ненависти
ненормальный: ненормальными
необходимый: необходимое
необычный: необычные необычных
неоднократно: неоднократно
неопр: неопр
неполный: неполный
непредсказуемый: непредсказуемым
неприятный: неприятную
непростительный: непростительными
нераспознанный: нераспознанным
нередко: нередко
несколько: нескольким нескольких несколько
несмотря: несмотря
несправедливый: несправедливо
неудача: неудачей
неэнциклопедический: неэнциклопедическим
неэнциклопедичных: неэнциклопедичных
никакой: никаких
николай: николай
николас: николасом
никто: никем
нимбус: нимбус
нимфадоры: нимфадоры
ничей: ничьей
новость: новости
новый: нового новым новая новые
нога: ног
норвежский: норвежская
норрис: норрис
носить: носил носила носит
ночной: ночной
ноябрь: ноября
нравиться: нравилась
нуждаться: нуждается
нужно: нужно
об: об
оба: оба
обвинить: обвинили обвинен
обезвредить: обезврежен
обжигаться: обжигаться
обитание: обитания
обитатель: обитателями обитатели
обладатель: обладателю
обладать: обладает
область: области
облик: облик
обнаружить: обнаружил
обнаружиться: обнаружился
оборотень: оборотнем
образ: образом образ образе
образоваться: образовался
обратный: обратно
обращаться: обращались
обращение: обращения
обстановка: обстановке
обстоятельство: обстоятельств
обсуждение: обсуждение
обучаться: обучался
общий: общие общей
объявить: объявлено объявлен
объясняться: объясняется
обычно: обычно
обязанность: обязанности обязанность
огонь: огня
одерживать: одерживала
один: одну одной одном одного один одно
одиннадцатый: одиннадцатый
одиночка: одиночку
однако: однако
одновременно: одновременно
однокурсник: однокурсник
озвучить: озвучил озвучен
озеро: озера
означать: означает
оказаться: оказалось оказался оказавшийся оказались
оказываться: оказывается
окаянный: окаянное
окклюменции: окклюменции
окончание: окончанием
окончательный: окончательное
окончиться: окончилась
оксфордский: оксфордский
октябрь: октября
олень: олень оленя
олливандером: олливандером
омут: омут
он: нему
они: им них
онлайн: онлайн
опасность: опасности
опасный: опасных опасного опаснейший
операция: операции операция
описание: описание описанием
описываться: описывалось
оправдаться: оправдаться
опубликовать: опубликовал
организация: организации
организовать: организовав организована
организовывать: организовывал
орден: ордена орден
оригинал: оригинала
освободить: освободил
особый: особые
оставаться: оставался
оставить: оставил оставив
оставлять: оставляет
остальное: остальным
остаться: оставшихся остался
остров: острове
остролист: остролист
отвага: отваги
ответный: ответном
ответственность: ответственности
отдать: отдать отдал
отдел: отдел отделе
отделение: отделение
отдельный: отдельных отдельные
отец: отца отцом отец
отказ: отказ
отказаться: отказался
открытие: открытия открытии
открыть: открыли открыта
отличаться: отличался
отличный: отличным отличных
отменить: отменены
отнести: отнесли отнести
относиться: относящееся
отношение: отношения отношений отношении отношениях отношение
отныне: отныне
отобрать: отобранной
отправить: отправленная отправили отправила
отправиться: отправиться
отправляться: отправляется
отравить: отравленного отравлен
отразить: отразило
отредактировать: отредактируйте отредактирована
отрицать: отрицать отрицает отрицало отрицала
отряд: отряда отряд
отчасти: отчасти
отыскивать: отыскивал
официально: официально
официальный: официальное официальный официальной
охранять: охраняемое
очень: очень
очередной: очередной
очередь: очередь
очки: очки
очнуться: очнувшись
ошибка: ошибке
ошибочно: ошибочно
паблишер: паблишер
падение: падении
палочка: палочку палочке палочек палочка палочки
памятник: памятник
память: памяти
папворт: папворт
парк: парк
парламент: парламента
пародийный: пародийный
пародия: пародии
парселтангом: парселтангом
патронус: патронус
патронуса: патронуса
певереллов: певереллов
пенсионер: пенсионеру
первое: первым первое первые первыми первом
первоисточник: первоисточника
первоначальный: первоначальная
первый: первой первую первая первый
перевод: переводе
перед: перед
передать: передав передать
передаться: передалась
переехать: переехала
пережить: пережил
перейти: перейти
переместить: переместил
переправка: переправки
пересказываться: пересказывался
переставать: переставала
перестать: перестал перестала
переть: при
переулок: переулке переулок
период: периода период
перо: пером пера перо
персонаж: персонаж персонажами персонаже персонажи
персональный: персональные
пес: пса
петтигрю: петтигрю
петуния: петуния
петунье: петунье
печать: печати
пещера: пещере
писатель: писателя
писательница: писательницы
писать: писавшим писать
письмо: письмо письме писем письма
питер: питер питеру питера
плагиат: плагиате
плакса: плаксы
пламя: пламени
план: планах
планироваться: планируется
пленять: пленяет
плохо: плохо
победа: победу победы
победитель: победителем
победить: победил победить
поблагодарить: поблагодарила
поведение: поведения
повесить: повесили
повествование: повествование
повод: поводу
повстанец: повстанцами
погиб: погиб
погибать: погибает
погибнуть: погибли погибнуть погибшего погибло погибнет погибла
поговорить: поговорив
подарить: подаренный подаренная
подать: подать
подбирать: подбирает
подвергнуться: подвергся
поддержка: поддержке
поджечь: поджечь
подкинуть: подкинувшего
подозревать: подозревают подозревал подозревая
подписать: подписанной
подпись: подписи
подробность: подробностей
подробный: подробнее подробным подробное
подружиться: подружились
подсказка: подсказки
подстроить: подстроенной
подходить: подходили
подчинение: подчинении
поединок: поединка
поезд: поезде
поездка: поездку поездки
пожалуйста: пожалуйста
пожертвовать: пожертвовать пожертвовала
пожиратель: пожирателями пожирателя пожирателей пожиратель пожирателем пожиратели
позаимствовать: позаимствовала
позволить: позволив
позволять: позволяя
поздний: позже
поздравление: поздравление
позиция: позицией
познакомиться: познакомился
познань: познань
поиск: поиск поиске поиском поиску
поймать: поймал
пока: пока
показать: показан
покидать: покидает покидал
покинуть: покинула покинуть
покушение: покушения
пол: пол
политик: политика политике
полностью: полностью
полок: полка
полтергейст: полтергейстах
полувеликан: полувеликан
полукровка: полукровкой полукровка
полумна: полумна
полумны: полумны
получить: получил полученная получивший полученный получить
польша: польша
поместье: поместье
помешать: помешал помешать
помимо: помимо
помогать: помогает
помочь: помог помочь
помощь: помощью помощи помощь
понравиться: понравились
понять: понял
пообещать: пообещал
попадание: попадания
попадать: попадает попадать попадают
попасть: попали попал
попечительский: попечительского
попробовать: попробовал
популярность: популярность
популярный: популярной
попытаться: попытавшихся попытаться попытался
попытка: попытка попытке
пора: пор
порог: пороге
портал: портал
портрет: портрет
посетить: посетил посетили
посещать: посещает посещаемую посещая
поскольку: поскольку
последний: последнее последний последние последних последним
последствие: последствиям
послушный: послушная
посмотреть: посмотрел
посол: после
посреди: посреди
поссориться: поссорились
постоянный: постоянная
постоять: постоять
поступить: поступить
потеря: потерей
потерять: потерял
потомок: потомком
потребовать: потребовали
поттер: поттер поттера поттеры поттеров поттеру поттере
поттероманию: поттероманию
похитить: похищен
похожий: похожем
почему: почему
починить: починил
почуять: почуяв
пощадить: пощадить
поэтому: поэтому
появиться: появились появившийся появился
появление: появление появления
появляться: появляться
правда: правда
правило: правилами правилам
правительство: правительства
править: править
правка: правки
правосудие: правосудия
практик: практики
практиковать: практиковать
практический: практически
прах: праха
превратить: превратил
превратиться: превратившись
предатель: предатель
предать: предала предал
предлагать: предлагала
предложить: предложил предложила
предмет: предметы
предпоказов: предпоказов
предположение: предположение
представитель: представители
представиться: представились
представлять: представлять
предстать: предстал
предупредить: предупредил
предыстория: предыстория
президент: президент
презрительный: презрительное
прекратить: прекратило прекратил
прекратиться: прекратилось
преподаватель: преподавателя преподаватели
преследование: преследование
пресс: прессы
преступник: преступник
приблизительно: приблизительно
прибыть: прибыл
привести: привело
привлекать: привлекать
приводить: приводят
пригодиться: пригодились
приднестровский: приднестровского
приднестровье: приднестровья приднестровье
прием: приеме
признать: признал
прийти: прийти
приказ: приказу приказ
прикасаться: прикасаться
приквел: приквел
приключение: приключениях
прикосновение: прикосновения
прилавок: прилавках
применить: применить
примерный: примерно
примета: приметы
примечание: примечания
принадлежность: принадлежность
принимать: принимал принимающего
принц: принц принцем
принять: приняла принят
приобретать: приобретает
прислать: пришли
присоединиться: присоединились
присудить: присудил
присутствовать: присутствовал присутствует
притворяться: притворялся
приход: прихода
приходить: приходить приходит приходили
причина: причины причин причина причинам причиной
пробраться: пробрался
провалиться: провалилась
проверить: проверенная
провести: провести
провидица: провидица
проводить: проводили
прогулка: прогулки
продать: продано
продержаться: продержаться
проект: проектах
прозвище: прозвища прозвищу
произведение: произведения произведение
произведенье: произведений
производство: производство
произнести: произнесла
произойти: произошла произошло
происходить: происходящего происходило
происхождение: происхождение
проклясть: проклятое
проклятие: проклятие
проникать: проникал проникать
проникнуть: проник
прообраз: прообраз
пропажа: пропажи
пророк: пророк
пророчество: пророчество пророчеством пророчества пророчестве
просмотр: просмотры
просто: просто
пространство: пространства
просьба: просьбы просьбе просьбой
против: против
противник: противники
противоречие: противоречия
проткнуть: проткнул
прототип: прототипом прототип
протяжение: протяжении
профессор: профессора профессор профессоров
проходить: проходившем
процарапывать: процарапывавшим
прочий: прочие прочих прочее
прошлый: прошлом прошлое
проявиться: проявилась
проявлять: проявлял
прояснить: прояснить
психологический: психологической
психотерапевт: психотерапевта
птица: птицу птица
путеводитель: путеводитель
путешественник: путешественники
путь: путь пути
пытать: пытают
пытаться: пытался
пьеса: пьесе
пята: пятой
пятый: пятом пятого
р: р
работать: работать
рабочий: рабочим
раз: раза
разбить: разбито
разгадывать: разгадывая
раздел: разделами
раздеть: раздел раздела
различный: различные
разоблачить: разоблачил
разработчик: разработчики
рамка: рамках
рамля: рамле
ранго: ранго
ранее: ранее
ранний: раньше
раскрыть: раскрыл
расположиться: расположилась
распределять: распределяющая
рассказ: рассказами рассказы
рассказать: рассказал
расследование: расследование
расцвет: расцвет
расширение: расширение
рациональный: рационального
реакция: реакции
ребенок: детей дети
реддл: реддл
реддла: реддла
резиденция: резиденцию
результат: результате
рекорд: рекордом
рекордный: рекордные
религиозный: религиозные
репетиционный: репетиционное
ресурс: ресурсы
решимость: решимость
решить: решили решил
риа: риа
ригби: ригби
римус: римус
римуса: римуса
род: род
родитель: родителями родителей родители
родиться: родившийся родилось родится
родственник: родственники родственников
родственница: родственнице
рождение: рождения
рождественский: рождественский
роль: роль роли
роман: романов романе романа романы
рон: рону роном рона рон
россия: россии
рост: роста
роулинг: роулинг
рубеус: рубеус
рубить: руби
рука: руке руку рукой рук руках руки
руководство: руководством
русская: русской
русский: русском русски русское русский
русый: рус
рыцарь: рыцарь
рэдклифф: рэдклифф
рэдклиффа: рэдклиффа
рядовой: рядового
садиться: садится
сайт: сайте сайты
салазара: салазара
сам: самому самим сама
самопожертвование: самопожертвованию
самый: самую самый самым самые
сантиметр: см
сарычев: сарычева
саундерс: саундерс
саундтрек: саундтрек
сбегать: сбегает
сбежать: сбежал сбежать
сбить: сбила
сбрасывать: сбрасывать
свадьба: свадьбы свадьбе
сведение: сведения
свежий: свежие
света: свет
светлый: светлая
свидетель: свидетелем
свидетельство: свидетельств
свободный: свободной свободным
свое: своих свои своего своими
свой: свой своей свою
связанный: связанные связана
связаться: свяжитесь
связь: связи
сделать: сделаны сделать сделал сделав
себя: собой
северус: северус
северуса: северуса
седрик: седрика седрик
седьмой: седьмая седьмой
семейный: семейную
семь: семь
семью: семью
семья: семья семьи
сентябрь: сентября
сердце: сердце
середина: середину середине
сериал: сериал
серия: серии серию серия
сестра: сестра сестре
сесть: сел
сивилла: сивилла
сильный: сильные
сингапур: сингапуром
сингулярность: сингулярности
сириус: сириуса сириус сириусу сириусом
сирота: сироты
система: системе
сказаться: сказалось
сказка: сказки
скачать: скачать
скорый: скорее
скримджера: скримджера
скрытность: скрытность
скрытый: скрытые
слабый: слабого
следующий: следующем последующей
слизерин: слизерин
слизерина: слизерина
слизнорта: слизнорта
слишком: слишком
словарь: словари словарь
слово: слов слово
словосочетание: словосочетания
сложность: сложности
сложный: сложных
сломать: сломана
служба: службе
служебный: служебные
служить: служившего
случай: случае случаях случаев
случайно: случайно
случайный: случайная
слушание: слушание
смертельный: смертельная смертельного
смертоносный: смертоносного
смерть: смерть смерти
смириться: смириться
смит: смит
смочь: сможет смогут смог
сначала: сначала
снегг: снегг
снегга: снегга
снитч: снитч
снова: снова
сняться: снялся
собирательный: собирательный
собираться: собирался собирается
собрание: собраний
собственный: собственную собственный
событие: события
сова: сова
совершеннолетие: совершеннолетия
совершить: совершил
совет: совета совет
согласиться: согласился
согласно: согласно
содержание: содержание содержанием
содержать: содержали содержит
содержимое: содержимое
создание: создание
создатель: создателя создатель создатели
создать: создал созданный создать
сознание: сознание
сон: сон сне
сообщество: сообществе сообщество
сообщить: сообщить сообщено
сооснователь: сооснователь
соответствие: соответствии
сопровождение: сопровождении
соревнование: соревнованиях соревнование
состоять: состояли
состояться: состоялось
сострадание: сострадание
сотрудник: сотрудники сотрудник
сохранение: сохранением
социальный: социальный
спас: спас
спасать: спасая
спасти: спасшего спасти
спастись: спаслись
спектакль: спектакля
специальный: специальное
спивак: спивак
список: список
спора: споры
спортсмен: спортсмены
способность: способностью способности способностями способность
способный: способен
справиться: справиться
справка: справка
спрятать: спрятал
спрятаться: спрятаться
спустя: спустя
спутник: спутникам
спутница: спутницей
сработать: сработавшей
сравнение: сравнении
сражение: сражения
сразу: сразу
среди: среди
средний: среднее средний
српски: српски
српскохрватски: српскохрватски
ссориться: ссорится
ссылка: ссылка ссылками ссылки
стабильный: стабильная
станислав: станиславович
становиться: становится
стараться: старается
старинный: старинного
старое: старому
старший: старшего старший старшим
старый: старый
статистика: статистика
статус: статус
стать: стал стало стала став стали
статья: статью статей статья статье статьи
столкновение: столкновении
сторожа: сторожа
сторона: сторона сторону
сторонник: сторонником сторонника
страйке: страйке
страница: страницы страницах страница страницу странице страницам
страшный: страшное
студент: студенты студенту
суд: суд
судьба: судьбой судьба
сумерки: сумерки
суметь: сумевшей сумели сумел
существо: существа
существование: существовании существования
существовать: существовавшего
схватка: схватке
сценарий: сценария сценарий
считать: считая считает считали
сша: сша
сын: сына сын сыном
сэм: сэм
сюда: сюда
сюжет: сюжет сюжета сюжету
тайна: тайну тайн
тайный: тайная тайно тайной тайную тайны
также: также
такой: такой таким такими такая
талант: талант
татарча: татарча
творческий: творческой
тедди: тедди
текст: текст текстом
текущий: текущие
телеканал: телеканалов
тело: тела тел тело
телосложение: телосложение
тель: тель
тем: тем
тема: теме
тематический: тематический тематические
теория: теории
тереть: три
терновый: терновая
террариум: террариуме
течение: течение
течь: текла
тим: тим
тираж: тиражом
тирания: тирании
тирасполь: тирасполе
тисовый: тисовую тисовая
тоби: тоби
тобруке: тобруке
товарищ: товарищ
товарный: товарный
толстый: толстый
том: тома
тонкс: тонкс
топ: топ
тот: том тех тот тому
трагедия: трагедии
требовать: требующие
трейлер: трейлеры
трелони: трелони
тренировка: тренировки
третий: третья
третье: третьем
тринадцать: тринадцать
трое: трое
троица: троица
тролль: троллем тролль тролля
туда: туда
турист: туристов
турнир: турнира турнире
тщеславный: тщеславным
тысяча: тысячу тыс
убедиться: убедились
убежище: убежище
убивать: убивает
убийство: убийства убийство
убить: убил убитых убить убившего убила убитым
увидеть: увидел увидев
угнетение: угнетении
уговорить: уговорить
уготовать: уготовано
ударить: ударив
удаться: удалось
удача: удачей
удивление: удивлением
узнать: узнают узнав узнавшей узнали узнал
узник: узник
уизли: уизли
уинтербурне: уинтербурне
указание: указанием
указать: указан
украина: украину украины
украсть: украсть
укрытие: укрытия
улица: улица улиц улицу
улучшить: улучшите
умереть: умереть
уметь: умеет
умирать: умирая
унаследовать: унаследовал
университет: университета
уничтожать: уничтожали уничтожал
уничтожение: уничтожения
уничтожить: уничтожить уничтожен уничтожена
управление: управление
урок: уроки
усадьба: усадьбы
условие: условий условия
успевать: успевает
успеть: успел
установить: установили
устареть: устаревших
устроить: устроили
уцелеть: уцелели
участвовать: участвовали участвовал
участие: участие участия
учащийся: учащийся
учебник: учебнику
учебный: учебного
ученик: ученику ученика
ученица: ученицы
учить: учить
учиться: учился
факт: факт факты
факультет: факультет
фамилия: фамилией фамилию
фанат: фанатов
фантастический: фантастические
фанфик: фанфик
фараси: фараси
февраль: февраля
феникс: феникса феникс
философский: философский
филча: филча
фильм: фильм фильме фильмов фильма
фламелем: фламелем
флорида: флорида
фонд: фонд
формат: формате
форум: форум
фоукс: фоукс
фред: фредом фреду
фрэнк: фрэнка
хагрид: хагрид
хагрида: хагрида
хагриду: хагриду
характер: характере характер характера
характеристика: характеристики
хватать: хватает
хвост: хвост
хевроном: хевроном
хижина: хижине хижины
хит: хит
хобби: хобби
хогвартс: хогвартс
хогвартса: хогвартса
хогвартсе: хогвартсе
хогвартсу: хогвартсу
ход: ходе
хозяин: хозяином хозяина
хороший: лучших лучший лучшим хороший
хотеть: хочет
хохбрунн: хохбрунн
хранитель: хранителем
худощавый: худощавый
хэллоуин: хэллоуин
цель: целях цель целью цели
ценный: ценную
цепенеть: цепенели
церемония: церемонии
цитировать: цитировать
чанг: чанг
частить: части
частично: частично
частность: частности
часто: часто
часть: частью часть
часы: часов
чей: чьим
человек: человек людях людей
чемпион: чемпион
чемпионат: чемпионат
чернила: чернила
чернильный: чернильно
честь: честь
чет: чету
чжоу: чжоу
число: числе
чистка: чистке
чистокровный: чистокровный
чистота: чистота
читать: читать
член: членов членом членам члены
чтобы: чтобы
чувствовать: чувствовал
чудо: чудом
чудовище: чудовище
чуть: чуть
шаблон: шаблонами
шармбатон: шармбатон
шварзмэйер: шварзмэйер
шелкопряд: шелкопряд
шестая: шестая
шипеть: шипит
школа: школу школе школы
школьный: школьного школьные школьных
шляпа: шляпа
шон: шон
шоссе: шоссе
шпроттер: шпроттер
шрам: шрам
штаб: штаб
штат: штате
эванс: эванс
эгоизм: эгоизма
эджком: эджком
экз: экз
экзамен: экзамена
экземпляр: экземпляров
экранизация: экранизациях
экспресс: экспресс
элемент: элементы элемент
элиезер: элиезер
эльф: эльфа эльфом
эля: эль
эмиль: эмиль
эмоциональный: эмоциональной
эмоция: эмоции
энна: энн
энциклопедия: энциклопедии
эпизод: эпизод
эпический: эпическое
это: этом это этому этим
этот: этой эта эту
юдковски: юдковски
юный: юный юном юного
являться: является являющейся
яд: ядом
ядовитый: ядовитым
язык: язык языках языка языком
яйцо: яйцо
яковенко: яковенко
яна: яна ян
январь: января
ярко: ярко
ясность: ясности
