август: августа
авторитетный: авторитетных
авторство: авторства
азкабана: азкабана
аластор: аластор
аластора: аластора
алгебраический: алгебраической
алфавит: алфавиту
альбус: альбус
альбусу: альбусу
амортеции: амортеции
амортеция: амортеция
аналогия: аналогия
англ: англ
апрель: апреля
артефакт: артефактов
архивировать: архивировано
архивный: архивная
атаковать: атакуют
бабушка: бабушки
баз: базе
банк: банке
барда: барда
барти: барти
беллатрисы: беллатрисы
беседа: беседе
бидля: бидля
благодаря: благодаря
бодроперцовое: бодроперцовое
болтливый: болтливое
болтушка: болтушкой
боль: боль
больший: больше
брат: братьях
бузинный: бузинной бузинная
български: български
быть: будучи были
вальда: вальда
вальдом: вальдом
вальду: вальду
ваш: ваше
везучесть: везучесть
вейлы: вейлы
вейн: вейн
веритасерум: веритасерум
верить: веря
версия: версия
вечный: вечную
вещь: вещи
вид: видом вид
видеть: видит видят
вика: вики
викиданных: викиданных
викимедиа: викимедиа
википедии: википедии
википедия: википедия
викисклад: викисклад
викискладе: викискладе
викия: викия
виктор: виктора
вклад: вклад
вкус: вкусом
владелец: владельца
владеть: владеет
власть: власти
влиять: влияет
влюбить: влюбить
вместе: вместе
возвращать: возвращать
возвращение: возвращение возвращения
воздействие: воздействие
возможность: возможности возможность
войти: войти
волан: волан
волос: волоса волос
волчий: волчье
волшебник: волшебника волшебников волшебники
волшебный: волшебные волшебного волшебная волшебный
волшебство: волшебство
воплощение: воплощений
воскрешать: воскрешающий
воспоминание: воспоминания
впервые: впервые
время: время
все: всех
вселенная: вселенная
вслух: вслух
вставка: вставкой
выбивать: выбивая
выбирать: выбирает
выбор: выборах
выведать: выведать
выведение: выведения
выдать: выдать
вызывать: вызывающий
выигрывать: выигрывает
вылечить: вылечить
вымыслить: вымышленных вымышленного
выпить: выпившего выпившему
выполнение: выполнении
выращивать: выращивающее
вытягивать: вытягивая
выясниться: выяснилось
гарри: гарри
гелий: гелием
геллерт: геллерту геллертом
гермиона: гермиона гермиону
героизм: героизме
глава: главах главе
гласить: гласит
говорить: говорить
год: году годы года
гойла: гойла
голос: голос
голпалотта: голпалотта
гораций: гораций горацием
горячее: горячее
граб: граба
грейнджер: грейнджер
григор: григорович
грин: грин
гринготтс: гринготтс
группа: группа
грюм: грюм
грюма: грюма
давать: дающее дают дающим
дамблдор: дамблдор
дамблдора: дамблдора
дамблдору: дамблдору
дар: даров дары
дарить: дарят
даровать: даровать
дата: дата
дать: дать
де: де
дед: дедом
действие: действия действие
действовать: действовать
декабрь: декабря
делакур: делакур
делать: делая
день: дней дни
дерево: дерева
держать: держащим
дж: дж
джоан: джоан
джордж: джорджа
диадема: диадема
диггори: диггори
дилогия: дилогия
дитя: дитя
длина: длину длиной
длиться: длится
дневник: дневник
док: док
докси: докси
доксицид: доксицид
долголетний: долголетнее долголетние
должность: должности
дом: дом
дополнительный: дополнительные
дополнить: дополнив
доска: доской доски
доступный: доступен
драко: драко
дракон: дракона
древность: древности
друг: друг друзей друга
другой: другой другие других другого
дурмстранг: дурмстранг
дурмстранга: дурмстранга
дух: духов
душ: душу души
дым: дым
дюйм: дюймов дюйма
единорог: единорога
еиналеж: еиналеж
желание: желание желания
жертвовать: жертвует
живой: живыми живых живая
жидкий: жидкая
жизнь: жизнь
заглавный: заглавная
зад: задом
заимствовать: заимствованными
заклинание: заклинаний
заключить: заключена
закон: закону
замариновать: замаринованных
замаскировать: замаскировать
занимать: занимает
заново: заново
занять: занять
запах: запаха
записка: запискам
запись: запись
запретить: запрещено
зарегистрировать: зарегистрированный
заставлять: заставляющее
затем: затем
захват: захвата
захватить: захваченную
заявление: заявление
зверь: звери
зелье: зелью зелий зелье зелья
зельеварение: зельеварение
зельеварения: зельеварения
зельеваром: зельеваром
зеркало: зеркале зеркала зеркало
зеркальный: зеркальном
змея: змея
знак: знак
значимый: значимых
игра: игра игре игры
играть: играют играет
игрок: игроки
идентичный: идентичной
идти: идет
избежать: избежать
избранный: избранные
известный: известным
изготовитель: изготовителей
изготовление: изготовления
изменять: изменяет
изобразить: изображены
изучаться: изучаются
иметь: имеет
инструмент: инструменты
информация: информацию информации
искать: искали
использование: использованию использования использованием
использовать: использующие используемые используют
использоваться: использовалась использовавшееся
испытание: испытания
история: история
источник: источников источник
итог: итога итогов
июнь: июня
й: й
какой: какого
камень: камень камня
кандидат: кандидаты
кандиды: кандиды
капитан: капитаном
карточный: карточная
категория: категории
квиддич: квиддич
квиддичу: квиддичу
квирелл: квирелл
квиринус: квиринус
клятва: клятву
книга: книгах книги книге
когтевран: когтевран
код: код
кодекс: кодекс
кожа: кожу
коллекционный: коллекционная
кольцо: кольцо
команда: команды
комната: комнате комната
конец: конце
конструктор: конструктор
конфиденциальность: конфиденциальности
копия: копии копия
короткий: короткие короткий
костерост: костерост
кость: кости
который: которую которые которая котором который
крама: крама
крауч: крауч
крестраж: крестраж
крестража: крестража
крестражем: крестражем
крестражи: крестражи
крововосполняющее: крововосполняющее
кровь: крови
крэбба: крэбба
кубок: кубок
кук: куки
кульминационный: кульминационных
курс: курсе курс
легенда: легенде
лестрейндж: лестрейндж
либо: либо
литература: литература
лицензия: лицензии
лицо: лицо
лишение: лишениях
лишь: лишь
локация: локации
лорд: лордом
льюис: льюис
маг: мага магом маг
магический: магические магических
магия: магия магии
маглы: маглы
мадам: мадам
мазь: мазь
македонский: македонски
малфоем: малфоем
малфой: малфой
малфою: малфою
малфоя: малфоя
мантия: мантия
марволо: марволо
марта: марта
мастер: мастера
материал: материал материала
медальон: медальон
медиафайлы: медиафайлы
менее: менее
место: место места
мечтать: мечтавший
министерство: министерство
мир: мира мир мире миров
миссис: миссис
младший: младший
многие: многие
много: более
мобильный: мобильная
могущественный: могущественная
можно: можно
молодая: молодым
молчун: молчунов
морт: морт
мортом: мортом
морту: морту
мочь: можете могут
мощный: мощное
мракса: мракса
мраксов: мраксов
мы: нами
набор: набор
навигация: навигации навигация
нагайна: нагайна
надпись: надпись
название: название
наземникуса: наземникуса
назойливый: назойливых
называть: называя называемого
наиболее: наиболее
наконец: наконец
направленность: направленностью
наследство: наследству
настой: настой
настойка: настойка
находиться: находится
наш: наших
неверный: неверные
невероятный: невероятную
невидимка: невидимка
невидимый: невидимым
неделя: недели
недостаток: недостатков
недостоверный: недостоверный
независимый: независимых
незадолго: незадолго
неисчерпаемый: неисчерпаемое
некоммерческий: некоммерческой
некоторые: некоторые
некоторый: некоторое
неопр: неопр
неполный: неполный
непроизвольный: непроизвольно
нечто: нечто
николосом: николосом
новый: новые
норрис: норрис
нос: носа
носок: носков
нотация: нотации
ноябрь: ноября
об: об
обезоружить: обезоруженным
обитание: обитания
обладатель: обладателя
облегчать: облегчает
облик: облик
оборотень: оборотней
оборотный: оборотное
обортное: обортное
обращение: обращения
обстоятельство: обстоятельство
обсуждение: обсуждение обсуждения
обучение: обучения
объединение: объединению объединение
объединить: объединить
объект: объектах объектов объекте
обычно: обычно
обычный: обычной обычным
овладеть: овладев
огонь: огня
один: одной одном одного один одним
однако: однако
оживать: оживают
ожог: ожоги
оказаться: оказался
оказывать: оказывает
окклюменцию: окклюменцию
октябрь: октября
олливандер: олливандер
омут: омута
они: ими им
оно: оно
опасный: опасных
описание: описание описании
описывать: описывает
описываться: описываются
опытный: опытный
оранжевый: оранжевая
организация: организации
организм: организме
орден: орден
оригинал: оригинала оригинале
освободить: освободить
основа: основе
основать: основанные
особенность: особенностью
оставить: оставленный
остров: острова
остролист: остролиста
острый: острым
ответственность: ответственности
отдавать: отдающего
отдельный: отдельных отдельные
отказ: отказ
отредактировать: отредактирована
отряд: отряд
официальный: официальном
очень: очень
ошибка: ошибке
палочка: палочек палочка палочки палочкой
память: памяти
пара: парой
парк: парк
пародия: пародии
певереллов: певереллов
пенелопа: пенелопы
первое: первого
первокурсница: первокурсниц
первый: первой
перевод: переводе
передаваться: передавалась
перейти: перейти
перемещать: перемещают
перенаправить: перенаправлено
перестать: перестал
переть: при
перечный: перечным
перо: пера
персонаж: персонаж персонажами персонажи персонажей
персональный: персональные
печать: печати
писклявый: писклявым
плоть: плоти
плохо: плохо
победитель: победителя
победить: победив
побочный: побочным
поведение: поведения
повелитель: повелителями
повлиять: повлияло
повышать: повышающее
подведение: подведения
подготовить: подготовленный
подробный: подробнее
пожертвовать: пожертвовать
пожиратель: пожиратели
позволять: позволяющее
поздний: позже
позиция: позицию
поиск: поиск поиску
показывать: показывать показываю
покинуть: покинуть
поле: полях
политик: политика политике
политический: политических
полтергейст: полтергейстах
полукровка: полукровки полукровке полукровка
получать: получает
получить: получил получило получить
получиться: получится
помогать: помогает
помочь: помочь
помощь: помощью помощи
помфри: помфри
попасть: попал
популярный: популярных
портал: портал
поскольку: поскольку
последний: последний
послужить: послужил
посмотреть: посмотрел
посол: после
постоянный: постоянная
поттер: поттер поттера поттеров поттеру поттере
поттеромания: поттеромания
появляться: появляется
пояснение: пояснение
правда: правды правду
править: правила править
правка: правки
практиковать: практикующий
превратить: превращены превратить
превращаться: превращаются
предлагаться: предлагается
предмет: предмета предметы предмет
предназначить: предназначенное
представиться: представились
предыстория: предыстория
прежний: прежнего
преодолеть: преодолеть
преподаватель: преподавателем
преступление: преступления
приворотный: приворотного
привязанность: привязанность
приготовить: приготовлено
приготовление: приготовления
признать: признано
применить: применено
примечание: примечания
примечательный: примечательной
принадлежать: принадлежала принадлежал
принимать: принимают
принц: принца принц принце
принять: принять
причина: причин
проект: проектах проекту
произведение: произведения произведении
производство: производство
проклясть: проклятое
проникнуть: проникнуть
просмотр: просмотры
просрочить: просроченные
пространство: пространства
простуда: простуды
противоожоговая: противоожоговая
противоядие: противоядий противоядие
профессор: профессора
процедить: процеженных
прочий: прочее
прочтение: прочтении
путать: путать
путеводитель: путеводитель
пуффендуй: пуффендуй
пытаться: пытается
развязка: развязку
различный: различной различных
размер: размера
разработчик: разработчики
рама: раме
рамка: рамках
ран: ран
раскалывать: раскалывающего
раскрываться: раскрывается
распределять: распределяющая
распространить: распространены
рассказ: рассказы
рассказываться: рассказывается
растопырника: растопырника
расширить: расширенный
реддла: реддла
религиозный: религиозные
реплика: реплик
род: роду
родитель: родителей
рождество: рождества
розовый: розового
роман: романов романа
ромильдой: ромильдой
рон: рона рон
росмэна: росмэна
роулинг: роулинг
рубеус: рубеус
русский: русский
русый: рус
ряд: рядом
салазара: салазара
сам: самого сама самое
самый: самая самые
сантиметр: см
саундтрек: саундтрек
сварить: сварившему
сведение: сведения
свежий: свежие
свободный: свободной
свое: своих своего
свой: свой своей свою
свойство: свойству свойство свойства
связанный: связанные связанное
связаться: свяжитесь
связь: связь
сделать: сделать сделана
северус: северус
северуса: северуса
седрик: седрика
седьмой: седьмого седьмой
семейный: семейное
семейство: семейству
семью: семью
сентябрь: сентября
сердце: сердца
сердцевина: сердцевиной
сериал: сериал
серия: серии серию серия
симуса: симуса
система: системе
сказать: сказала
сказка: сказки сказке
скачать: скачать
скрытый: скрытые
слизерина: слизерина
слизнорт: слизнорт
слизнортом: слизнортом
слово: словам слово
служебный: служебные
случай: случаях
случайный: случайная
слушаться: слушаются
смерть: смертью смерть смерти
смотреть: смотрит смотрящим
смягчающий: смягчающее
сначала: сначала
снегг: снегг
снегга: снегга
снотворный: снотворное
собеседник: собеседника
собственный: собственный собственным
событие: события событий
совершение: совершения
совет: советы совету
содержание: содержание
создавать: создавать
создаваться: создавалось
создать: создан созданный создать
сознание: сознание
сокровенный: сокровенное сокровенные
сообщество: сообщество
сообщить: сообщить
сопротивляться: сопротивляться
соревнование: соревнованиях
состоять: состоящая
сотрудник: сотрудников
сохранение: сохранением
сохранить: сохранить
специализированный: специализированных
список: списки список
спора: споры
спортивный: спортивных
способ: способ способы
способный: способна способен способная
справка: справка
спрашивать: спрашивал
сращивать: сращивающее
ссылка: ссылка ссылками ссылки
староста: старостой
статистика: статистика
стать: стала станут
статья: статью статья статьи
степень: степени
стойкий: стойкую
страница: страницы страница страницей страницу страниц странице
студентка: студенток
сухожилие: сухожилия
существо: существа
существовать: существовал
счастливый: счастливыми
сыворотка: сыворотки сыворотка
сын: сына
сюда: сюда
сюжет: сюжет сюжета
тайный: тайная тайной
также: также
такой: такие
тварь: твари
твой: твоего
текст: текст
текущий: текущие
тело: тела
тематический: тематический
тисовый: тисовой
товарный: товарный
токсичный: токсичное
толстый: толстых
том: тома
тот: том тот тому
трансформация: трансформаций
третье: третьему
три: трех
турнир: турнира
тюрьма: тюрьмы
убеждаться: убеждается
убийство: убийства
увидеть: увидел увидев
удаленный: удалена
удалять: удаляйте
удача: удача
узнать: узнать узнал
узник: узник
уизли: уизли
указание: указанием
указать: указан
указывать: указывает
улица: улице
умерший: умерших
упоминать: упоминаемых
упомянуть: упомянуты
уровень: уровень
урок: уроки
условие: условий условия
ухо: ушей
уходить: уходит
участие: участие
учебник: учебника
ученический: ученический
факт: факт
фантастический: фантастические
феликс: феликс
фелицис: фелицис
феникс: феникса
фестрала: фестрала
фигура: фигурой фигурами фигуры фигуру
фигурировать: фигурирующие
фигурка: фигурки
философский: философский философского
фильм: фильм фильме фильмов фильмах
финнигана: финнигана
фламелем: фламелем
флетчера: флетчера
фонд: фонд
форум: форумов форум
франшиза: франшизы
фред: фреда
хагрид: хагрид
хлопушка: хлопушек
хобби: хобби
хогвартс: хогвартс
хогвартса: хогвартса
хогвартсе: хогвартсе
хозяин: хозяином
хороший: лучшим
хорошо: хорошо
хотеть: хочет
хранилище: хранилище
художественный: художественном
цвет: цвета
цитировать: цитировать
частить: части
часто: часто
часть: частью часть
чаша: чаша
человек: человеку человека люди
человеческий: человеческое человеческие
чемпионат: чемпионат
читать: читать
что: чему
чтобы: чтобы
шаблон: шаблонами шаблон
шармбатон: шармбатон
шармбатона: шармбатона
шахматный: шахматный шахматной шахматные
шахматы: шахмат шахматам шахматы
шерстяной: шерстяных
шест: шестом
шестая: шестой
широкий: широко
школа: школе школы школ
школьный: школьных
шляпа: шляпа
щупальце: щупалец
экзамен: экзаменах
элемент: элемент
эликсир: эликсиры
энциклопедия: энциклопедии
это: это этим
этот: этой эта эту
эффект: эффектом
являться: является
язык: язык языках
январь: января
ясень: ясеня
