август: август августа
августейший: августейшее
автоматически: автоматически
автор: автора
авторство: авторства
ага: ага
агент: агенты агент агентом
адели: адели
адриана: адриана
азкабана: азкабана
алан: алане аланом алан
алек: алек
александр: александр
алексей: алексей
алфавит: алфавиту
альбус: альбус
альбуса: альбуса
альбусом: альбусом
амбридж: амбридж
амикус: амикус
англ: англ
английский: английской
анджелесских: анджелесских
антигерой: антигерой
аргумент: аргументом аргументы
архивировать: архивировано
балл: баллов
барда: барда
бежать: бежать
безопасный: безопасное
безуспешно: безуспешно
беларуская: беларуская
беллатриса: беллатриса
беллатрисы: беллатрисы
бенедикт: бенедикт
беседа: беседе беседы
бидля: бидля
биография: биография биографии
биологический: биологическому
битва: битвой битве битвы
благодетель: благодетель
блестеть: блестящим блестящий
блэк: блэк
блэка: блэка
блэком: блэком
больший: большая больше
большой: большой
брать: брать
бродяга: бродяги
бузинный: бузинной
букля: букля
български: български
бывать: бывает
быть: будут будучи бывший бывшего были
важный: важной важный важная
вал: вал
ваш: ваши ваш
вд: вд
великан: великана
великий: величайший
великобритания: великобритания
верить: верить верит
верность: верность
вернуться: вернувшись вернулся
вероятно: вероятно
вероятный: вероятнее
версия: версия версии
весить: весь
вести: вести
весьма: весьма
взаимоотношение: взаимоотношения
взамен: взамен
взволновать: взволнованным
вид: виду вид виде
видеть: видит
визжать: визжащая визжащую
викиданных: викиданных
викимедиа: викимедиа
википедии: википедии
википедия: википедия
викисклад: викисклад
викискладе: викискладе
викия: викия
вино: вину
виртуозно: виртуозно
вклад: вклад
включать: включавшей
владелец: владельцем
владеть: владеет
власть: власти власть
вместе: вместе
вмешиваться: вмешивался
вне: вне
внезапный: внезапное
внешний: внешние
внешность: внешности внешность
внимание: внимание
внушить: внушил
возвращать: возвращает
возвращение: возвращение
воздух: воздух
возлюбить: возлюбленная
возможно: возможно
возможный: возможное
возникнуть: возникло
войти: войти
волан: волан
волос: волосы волосами
волчий: волчьей
волшебник: волшебник
волшебница: волшебницы волшебница
волшебный: волшебной волшебные волшебном волшебный
волшебство: волшебства
воплощение: воплощение
вопрос: вопросы вопросу вопрос
воспоминание: воспоминания воспоминаний
восстановить: восстановил
восхитить: восхищена
вполне: вполне
впоследствии: впоследствии
впрочем: впрочем
враг: врага
вражда: вражда
враждовать: враждовал
вред: вреда
временить: времени
время: временем время
все: всех всего
вселенная: вселенная вселенной
вскоре: вскоре
вспоминать: вспоминает
встретиться: встретятся
встречаться: встречаться
второй: второй
выбор: выборе
вывод: выводу
выглядеть: выглядит
выгонять: выгоняет
выдержка: выдержки
выйти: вышедший выйдет
вымыслить: вымышленные
вынудить: вынужден вынужденный
выпить: выпьют
выполнить: выполнить
выполнять: выполнять
вытаскивать: вытаскивает
вытащить: вытащив
выход: выхода
выходить: выходит
выходка: выходку
выясниться: выяснилось
выясняться: выясняется
гагинский: гагинский
газета: газеты
гарри: гарри
гера: герой
гермиона: гермиона гермиону
героизм: героизме
героический: героический
герой: героем герои
гибнуть: гибнут
глава: главе глава
главный: главный
глаз: глаз глаза глазах
говорить: говорить говорит говорите
говорящий: говорящей
год: году лет год годы года
голос: голос
горазд: гораздо
гораций: гораций
горечь: горечи
грейнджер: грейнджер
гриффиндор: гриффиндор
гриффиндора: гриффиндора
гриффиндоре: гриффиндоре
гриффиндорцам: гриффиндорцам
гриффиндорцами: гриффиндорцами
грозный: грозный
грубый: груб
группа: группы
грюм: грюм
грязнокровкой: грязнокровкой
гюго: гюго
дама: дама
дамблдор: дамблдор
дамблдора: дамблдора
дамблдором: дамблдором
дамблдору: дамблдору
дар: дары
дата: дата дату
дать: дали дать
два: двух
движение: движение
двойник: двойников
двойной: двойной двойные двойным
де: де
девочка: девочку девочек
действие: действий
действительно: действительно
действительность: действительности
действовать: действовать
декабрь: декабря
декан: декан
делать: делает
делиться: делиться
дело: делам
демонстрировать: демонстрирует
день: дней дне
деревня: деревни
десять: десяти десять
деталь: деталях
детство: детства детством детство
деть: день
дж: дж
джеймс: джеймс джеймсом джеймса
джоан: джоан
джон: джон
джордж: джорджу джордж
дилогия: дилогия
дина: дин
директор: директором директор директора
директорский: директорский
дитя: дитя
длинный: длинной
добро: добра
добрый: добрая
добыть: добыть
доверять: доверяли доверяет
док: док
доказательство: доказательства
докладывать: докладывает
долгий: долгое
должен: должна
должное: должное
должность: должность
долорес: долорес
дом: дом доме
дома: дома
домик: домике
дополнительный: дополнительные
дополнить: дополнить дополните
дорогой: дорого
доставить: доставить
достаточно: достаточно
достижение: достижений
доступный: доступен
драко: драко
древность: древности
друг: друзья друзей другом друзьям
другой: другим другими другие других
дружба: дружба
дружеский: дружеские
дубляж: дубляж
думать: думать думаете
дурмстранг: дурмстранг
дурслей: дурслей
душераздирающий: душераздирающим
дуэльный: дуэльного
дуэлянт: дуэлянт
дядя: дяди
е: е
едва: едва
единственный: единственный единственном
ежедневный: ежедневный
жало: жало
желать: желали
женщина: женщину
жестокий: жестоким жестокий
животное: животных
жизнь: жизни жизнь жизнью
жительство: жительства
журнал: журнал
заботиться: заботилась
зависеть: зависит
загадка: загадку
заглавный: заглавная
задание: заданию
задержание: задержанию
заимствовать: заимствовано
заклинание: заклинанием заклинания заклинаниям заклинаний заклинание
заключаться: заключалась заключался
зало: зала
заметить: заметил заметив
замечательный: замечательных
занятие: занятий занятии
занять: занять
запись: запись
запугивать: запугивать
заранее: заранее
зарегистрировать: зарегистрированный
заслужить: заслужил
заставить: заставила
заступиться: заступилась
затем: затем
захват: захвата
защита: защиты
защитить: защитить
защищать: защищал защищать
заявить: заявил заявила
заявление: заявление
заявлять: заявляет
зверь: звери
звучание: звучание
здорово: здорово
зелье: зелий зелье зелья
зельевар: зельевар
зельеварению: зельеварению
зельеварения: зельеварения
зельевару: зельевару
зло: зла
злобный: злобная
злодей: злодей
злой: злая злым
змея: змея змее
знак: знак
знать: знает знать знал знают зная
значение: значения
игра: игра игру игры
идея: идея идею
избранный: избранные
известно: известно
известный: известных
изготовление: изготовлению
издевательство: издевательства
измена: измена
изобретатель: изобретателем
изумление: изумлению
именно: именно
именование: именования
иметь: имеет
император: императора
имя: имя имени
иначе: иначе
иной: иное
инструмент: инструменты
интервью: интервью
интересно: интересно
интересный: интересным
интересоваться: интересовавшимися интересовался
информация: информация информации
исказить: искажена
искупить: искупить
искусный: искусный
искусство: искусств искусствами
исписать: исписанный
исполнение: исполнению исполнения
исполнитель: исполнитель
использование: использование использования
использовать: использовать использующие
истинный: истинной истинные
история: история историй
источник: источник
итог: итога итогов
июль: июля
июнь: июня
й: й
йоркшир: йоркшире
кабинет: кабинета кабинете
каждый: каждого каждом каждый
казаться: казалось
какой: какая какие
камень: камень камнем
каро: каро
карточный: карточная
касаться: касающемся
категория: категории
квиддич: квиддич
квиддичу: квиддичу
квиреллом: квиреллом
квиринус: квиринус
квиррелл: квиррелл
квирреллу: квирреллу
кларк: кларк
класс: классе классах
клуб: клуба
книга: книг книгах книги книгу книге книга
книжный: книжного
когтевран: когтевран
код: код
кодекс: кодекс
кожа: кожей
коллекционный: коллекционная
коммерсант: коммерсант
комната: комната
конец: конце концу конца
конечный: конечном
конструктор: конструктор
конфиденциальность: конфиденциальности
конфундус: конфундус
королевский: королевский
короткий: короткие короткий
корреспондент: корреспондент
косвенный: косвенные
который: которым которое которой которую которого которые которых которая который
кпм: кпм
крайне: крайне
крайний: крайней
крестражей: крестражей
критика: критика
кровотечение: кровотечение
кровоточить: кровоточила
кровь: крови
кроме: кроме
крупный: крупнейшая
крючковатый: крючковатым
кубок: кубок
куда: куда
кук: куки
курс: курсе курса
кэрроу: кэрроу
лань: лань лани
лата: лат
латинский: латинскому
левитаторы: левитаторы
левитация: левитации
легенда: легенду
легиллименцией: легиллименцией
легко: легко
лес: лес
летучий: летучей
либо: либо
ликантропное: ликантропное
лили: лили
лицензия: лицензии
лично: лично
личной: личными
лишение: лишениях
лишь: лишь
логичный: логичному
локация: локации
лорд: лордом лорда лорду лорд
лос: лос
лояльность: лояльности
любить: люблю любил любимые любит
любовь: любви любовь
любой: любом
любопытство: любопытством
люпин: люпин люпином люпину
люциуса: люциуса
м: м
маг: магов маги
магический: магическую магические
магия: магия магии магией
магл: магл
магла: магла
маглы: маглы
макгонагалл: макгонагалл
македонский: македонски
маленький: маленьком малейшему
малфоем: малфоем
малфой: малфой
малфоя: малфоя
мальсибера: мальсибера
манера: манеры
мантия: мантии
марта: марта
мастер: мастером мастер мастера
материал: материал
мать: мать
мая: мая
медиафайлы: медиафайлы
менее: менее
мера: меру мере
местами: местами
место: место места
меч: меч
минерва: минерва
минерве: минерве
министерство: министерство
мир: мира мир мире
миссис: миссис
мнение: мнение
многие: многие многих
много: более много
многочисленный: многочисленные
множество: множеством множество
мобильный: мобильная
можно: можно
мой: моим
молниеносно: молниеносно
молодая: молодую
момент: момента
монета: монетой
морган: морган
морт: морт
морта: морта
мортом: мортом
морту: морту
мосфильм: мосфильм
мотив: мотивы
мотивировать: мотивировала
мочь: могут могла могу
мрачный: мрачной
муж: мужем
мужской: мужской
мужчина: мужчины
мы: нами нас
мыший: мышью
набрать: набрала
навигация: навигации навигация
навык: навыки
нагайне: нагайне
над: над
надежда: надежды надежду
название: название
назвать: назвать назвал
наземникусу: наземникусу
назойливый: назойливых
называть: называет называл называют
называться: называются
наиболее: наиболее
найджелуса: найджелуса
наконец: наконец
намекать: намекает
намеренно: намеренно
нападение: нападения нападение
написание: написания
напоминать: напоминали напоминало напоминая
напрасно: напрасно
например: например
напротив: напротив
нарцисс: нарцисса
насильно: насильно
насколько: насколько
настолько: настолько
настоящее: настоящему
научить: научить
находиться: находится
начало: начале началом начала
начальный: начальной
начаться: началась
начинать: начинает
начинаться: начинается
наш: наших нашего
небольшой: невелика
невербальный: невербальных
неверность: неверности
невиновность: невиновность
недоверие: недоверия
недостаток: недостатков
недостоверный: недостоверный
нездоровый: нездорового
некого: некому
некоммерческий: некоммерческой
некоторые: некоторых некоторые
некоторый: некоторое
нелюдим: нелюдим
немногие: немногих
ненавидеть: ненавидит
ненависть: ненависть ненависти
необходимый: необходимым необходимый
неоднозначный: неоднозначным
неоднократно: неоднократно
неопр: неопр
неполный: неполный
непосредственно: непосредственно
непосредственный: непосредственной
непреложный: непреложным
непримиримый: непримиримая
неприятный: неприятного неприятен неприятную
несанкционированный: несанкционированное
несколько: несколько
несмотря: несмотря
несправедливый: несправедливо несправедлив
неттлшип: неттлшип
неудачно: неудачно
неудачный: неудачного
неясный: неясной
никак: никак
никакой: никакого
никто: никому
новый: новые новых
норрис: норрис
нос: носом
нравиться: нравятся нравится
нуждаться: нуждается
нужно: нужно
нужный: нужным
ныне: ныне
об: об
оба: обе обоих оба
обвинять: обвиняет
обезоруживать: обезоруживающее
обезоружить: обезоружил
обет: обетом
обещать: обещает
обитание: обитания
обладать: обладает
обо: обо
обожать: обожаю
обозвать: обозвал
обойтись: обошлось
оборотень: оборотень оборотням
оборотный: оборотное
образ: образом образ
обращаться: обращается
обращение: обращения
обстоятельство: обстоятельств
обсуждать: обсуждаемых
обсуждение: обсуждение обсуждения
обучение: обучения
общение: общении общение
общество: общество
объяснить: объяснила
объятие: объятиях
огонь: огня
огромный: огромной
один: одну одной одна одном одного один одному одним
однако: однако
одновременно: одновременно
одновременный: одновременное
одноклассник: одноклассников
озвучивание: озвучивание
озеро: озеру
оказаться: оказалось
оказываться: оказывается
окклюменцией: окклюменцией
окклюменции: окклюменции
около: около
окончательно: окончательно
октябрь: октября
окунуться: окунуться
олениха: олениха
олень: олень
олицетворять: олицетворяют
омут: омут омута
они: им них ними
оно: оно
опасность: опасности
опасный: опасных
описание: описание
оправдать: оправдан
опубликовать: опубликованных
опытный: опытный
организация: организации
орден: ордена орден
оригинал: оригинала оригинале
оригинальный: оригинальное оригинальный
основать: основанные
основное: основном
основывать: основывайте
особенно: особенно
особый: особой
остальное: остальным
остаться: остались остался
отбиваться: отбиваться
отваживаться: отваживается
ответ: ответов
ответить: ответить
ответственность: ответственности
отдавать: отдают
отдельный: отдельный отдельных отдельные
отец: отца отец отцу
отзыв: отзывы
отказ: отказ
отказаться: отказался
отказываться: отказывается
открыть: открытого открыть
отлично: отлично
отличный: отличной отличный
отметить: отмечено
относительно: относительно
относиться: относится относятся
отношение: отношения отношение
отомстить: отомстить
оторваться: оторвусь
отправиться: отправившись отправиться
отправляться: отправляется
отравление: отравление
отражать: отражать
отредактировать: отредактирована
отрывистый: отрывистое
отряд: отряд
отсекать: отсекает
отстреливать: отстреливать
отсутствие: отсутствие
отсюда: отсюда
отталкивать: отталкивающей
отчаянно: отчаянно
отчислить: отчислить
отчитывать: отчитывает
очевидно: очевидно
очень: очень
очередь: очередь
очки: очки
ошибка: ошибке ошибкой
ошибочно: ошибочно
палочка: палочки
память: памяти
параллель: параллели
парк: парк
пародия: пародии
патронус: патронус
патронуса: патронуса
патронусы: патронусы
пауза: паузы
паучий: паучий паучьем
пенсия: пенсию
первое: первого первое первом
первый: первой первую первый
перевод: переводе перевод перевода
переводиться: переводится
переводчик: переводчиками
перед: перед
передавать: передаю
передать: передать
передача: передача
переименование: переименования переименованию
переименовать: переименовать
перейти: перейти
переправить: переправить
переправлять: переправлять
переработка: переработке
пересадить: пересажена пересадили
пересмотреть: пересмотрел
переть: при
персонаж: персонаж персонажа персонажами персонажем персонажи
персональный: персональные
петтигрю: петтигрю
петунью: петунью
печать: печати
писать: писать
питер: питером питер
план: планах план
планировать: планировал
платить: платит
плечо: плеч
плотно: плотно
победить: победить
поведение: поведением поведение поведения
повлиять: повлиять
повод: поводу
повстречать: повстречал
повышение: повышение
погиб: погиб
погибнуть: погибла
погрузиться: погрузившись
подавать: подававшую
подарок: подарок
подведение: подведения
подвергаться: подвергаясь
подделать: подделаны
поддерживать: поддерживали
подзатыльник: подзатыльники
поднять: поднял
подобный: подобном
подозревать: подозревать
подозрение: подозрения
подпись: подписи
подробность: подробности
подробный: подробнее
подруга: подруга
подслушать: подслушал
подслушивать: подслушивает
подтвердить: подтвердила
пожалуйста: пожалуйста
пожертвовать: пожертвовать
пожиратель: пожирателями пожирателям пожирателей пожиратель пожирателем пожиратели
поздний: позже
поиск: поиск поиску
показать: показанные
показывать: показывает
покинуть: покинуть покинул
поклонник: поклонники
пол: пол
полагать: полагали полагая
полезный: полезных
политик: политика политике
полностью: полностью
половина: половину половина
полтергейст: полтергейстах
полукровка: полукровкой полукровка
получить: получили получить
получиться: получилось
польза: польза пользу
поменяться: поменяться
пометка: пометками
помогать: помогал помогающее
помочь: помог помочь
помощь: помощью помощи
поневоле: поневоле
понимать: понимает
понятие: понятия
понять: понять понял
пообещать: пообещал
попросить: попросил
популярность: популярности
попытка: попыткам попытками попытки
порвать: порвала
порой: порой
портал: портал
портрет: портрета портрет
посетитель: посетителей
поскольку: поскольку
последний: последнее последнюю последний последнего последней
посол: после
поспособствовать: поспособствует
пост: пост
поставить: поставил
постепенно: постепенно
постоянный: постоянная постоянных постоянной
поступок: поступок
потайной: потайной
потерять: потерял
поттер: поттером поттер поттера поттеров поттеру поттере
поттеромания: поттеромания
похолодание: похолодание
почему: почему
почерпнуть: почерпнул
почитатель: почитателей
поэтому: поэтому
появиться: появится появился
появление: появлению появлении появление
появляться: появляется
пояснение: пояснение
правда: правда
правило: правилах правилами
правильно: правильно
править: править
правка: правки
пребольшой: пребольшая
пребывание: пребывания
превратиться: превратятся
превращение: превращений
преданность: преданность преданности
преданный: предан
предатель: предателем предатели предателей
предательство: предательства
предлагаться: предлагается
предложить: предложил предложенное
предмет: предметы
преднамеренно: преднамеренно
предполагать: предполагает предполагают
предпоследний: предпоследней
предпочитать: предпочитая
представиться: представились
предстоять: предстояло
предшественник: предшественник
предыстория: предыстория
преемник: преемник
прежний: прежнему
премьер: премьер
преподаватель: преподаватель преподавателей преподавателя преподавателем
преподавать: преподававшая
преследовать: преследует
приблизительно: приблизительно
прибыть: прибыли
приводиться: приводится
приготовить: приготовить
придираться: придирается
придирка: придирок
придумать: придуман
приказ: приказу приказ приказы
приказать: прикажет приказал
применить: применил применив применено
примечание: примечания
примирение: примирения
примкнуть: примкнул
принадлежать: принадлежал
принадлежность: принадлежность
приносить: приносящим
принц: принца принц принцем
присылать: присылает
приходить: приходить приходят
приходиться: приходится
причастность: причастности
причина: причины причин причинах причина
причинять: причиняли
приют: приюте
приятель: приятелей
приятный: приятным приятные
проблема: проблему
проводить: проводит
продолжаться: продолжались продолжаются
проект: проектах
прозвище: прозвища прозвище прозвищу
произведенье: произведений
производство: производство
произойти: произойдет
происходить: происходит
происхождение: происхождение
проклясть: проклятое
проникновение: проникновения
пророк: пророк
пророчество: пророчества пророчестве
просить: просил просит
прослеживаться: прослеживается
просмотр: просмотры
просмотреть: просмотрев
просрочить: просроченные
пространство: пространства
просьба: просьбы просьбе
против: против
противник: противники
противодействовать: противодействовал
прототип: прототипом
протяжение: протяжении
профессор: профессора профессор
прочий: прочее
прошлый: прошлом
прятать: прятал
прятаться: прятался
психологический: психологическая
публикация: публикации
пугало: пугало
пустой: пуст пустыми
пусть: пусть
путеводитель: путеводитель
пуффендуй: пуффендуй
пытаться: пытался пытается
пята: пятой
пятый: пятом пятого
равный: равно
радовать: радует
развитие: развития
разглашать: разглашает
разговаривать: разговаривают
разговор: разговор
раздел: разделами разделе
раздеть: раздел
раздирать: раздираемый
раздражать: раздражает
разнообразный: разнообразных
разный: разными
разработчик: разработчики
разум: разум
район: районе
рамка: рамках
ранний: раньше раннее
распределить: распределена
распределять: распределяющая
рассказ: рассказы
рассказать: рассказал
рассказывать: рассказывает рассказывать
расследование: расследования
расхождение: расхождения
реакция: реакцией
реальный: реальным
редкость: редкостью
резка: резок
резкий: резкое резко
результат: результате результатом
религиозный: религиозные
реплика: реплика
речь: речь
решать: решает
решаться: решается
решить: решил
решиться: решусь
рикман: рикман
рикмане: рикмане
рикманом: рикманом
римский: римского
римус: римус
римусом: римусом
риск: риску
род: род
родитель: родителями родителей родители
родиться: родился родится
рождение: рождения
рождество: рождества
роль: роль роли
роман: романов романа
рон: рону рона рон
роулинг: роулинг
рубеус: рубеус
рукоприкладство: рукоприкладстве
русская: русской
русский: русский
русскоязычный: русскоязычные
рыдать: рыдал
рязанец: рязанцев
сайт: сайте
сальный: сальными
сам: самого самой самом самому
самка: самки
самый: самый самым самых самые
сантиметр: см
саундтрек: саундтрек
сбить: сбить
сведение: сведения
свежий: свежие
светиться: светились
свободный: свободной
свое: своих свои своего своим
свой: свой своей свою
связанный: связано связанные связанных связаны
связаться: свяжитесь
связывать: связывают
связь: связь
сговор: сговоре
сделать: сделанный сделать сделал
сдерживать: сдерживает
север: севера
северный: северном
северус: северус
северуса: северуса
северусом: северусом
северусу: северусу
седьмой: седьмая седьмой
сейчас: сейчас
сектумсемпра: сектумсемпра
семью: семью
семья: семья семье
сентябрь: сентября
септимия: септимия
сериал: сериал
серия: серии серию серия
сжимать: сжимая
сивилла: сивиллы
сила: силу силой сил
сильвий: сильвия
сильный: сильно
синдром: синдромом
сириус: сириуса сириус сириусом
система: системе
сказать: сказать сказал сказала
сказка: сказки
скачать: скачать
скитание: скитаний
скреплять: скрепляет
скрывать: скрывает
скрываться: скрываться
скрытый: скрытые
следовать: следует
слизерин: слизерин
слизеринцами: слизеринцами
слизеринцев: слизеринцев
слизнорт: слизнорт
слишком: слишком
слово: слов словам слову
словом: словом
сложный: сложные сложным сложнейшее
служебный: служебные
служить: служить
случай: случае случаях
случайно: случайно
случайный: случайная
смелый: смелых
смертельный: смертельному
смерть: смертью смерти
смех: смех
смешок: смешок
смеяться: смеется
смочь: сможет смог
снегг: снегг
снегга: снегга
снегге: снегге
снеггом: снеггом
снеггу: снеггу
снейп: снейп
снимать: снимает
снова: снова
снять: снять
собирать: собирают
собрание: собрании собраниях
событие: события
сова: сова
совершать: совершают
совет: совету советов
советовать: советует
согласие: согласие
согласиться: согласился
согласно: согласно
соглашаться: соглашается
содействие: содействие
содержание: содержание
создание: создание
создатель: создатель
создать: создать
сознание: сознание
сообщать: сообщает
сообщаться: сообщается
сообщество: сообществ сообщество
сообщить: сообщить
соответствие: соответствии
соперник: соперником
соседский: соседских
сохранение: сохранением
сохранить: сохранить
сохранять: сохраняла
социальный: социальный
спас: спас
спасать: спасал спасало
спасти: спасти
спекуляция: спекуляции
специальный: специальному
список: списке список
спойлер: спойлер
спокойный: спокойно
спора: споры
спорить: спорит
способ: способ
способность: способности
способный: способных способен
способствовать: способствовало способствуя
справка: справка
спрятать: спрятан
сразу: сразу
среди: среди
српски: српски
српскохрватски: српскохрватски
ссориться: ссорились
ссылка: ссылка ссылками ссылки
становиться: становится
старание: старания
стараться: старались
старший: старших
статистика: статистика
статус: статус
стать: стал стало стали
статья: статью статей статья статьи
стен: стене
сторона: стороны стороне сторону
страдать: страдает
страница: страницы страница страницу страниц странице
строгий: строг
строить: строили
студент: студентам
студия: студия
стыдно: стыдно
субкультура: субкультуре
суровый: суровая суровый
существо: существа
сходство: сходство
сцена: сцену сцене сцены
считать: считаю считает считаете считают
сша: сша
сын: сына сыновей сыне
сюда: сюда
сюжет: сюжета сюжете
тайный: тайном тайная
также: также
таки: таки
такой: такой таким такими таких такие
текст: текст
текущий: текущие
тело: тело
тем: тем
тематический: тематический
теория: теория теории теорий
теплый: тепла
тест: тесте
течение: течение
тип: типам
тиран: тирана
тихий: тихую
тобиас: тобиас
тобиаса: тобиаса
товарный: товарный
тождественный: тождественно
толк: толку
тот: том тот тому той
точный: точной
травить: травили
травма: травма
тревожить: тревожит
трелони: трелони
третий: третьей
туда: туда
туннель: туннели туннеля
тупик: тупик тупике
тупой: тупых
тур: тура
тысяча: тысяч
убегать: убегая
убедить: убедил
убежденный: убеждены
убивать: убивать убивает
убийство: убийстве убийства
убить: убить
уважать: уважает
уважение: уважением
уверить: уверен
увидеть: увидела
угадать: угадал
удалять: удаляйте
удивительный: удивительным
удобный: удобном
удовлетворение: удовлетворение
ужасный: ужасен
узкий: узкого
узнать: узнают узнав узнаем узнал
узник: узник
уизли: уизли
указание: указанием
указать: указан
украсть: украсть
улучшить: улучшите
умелый: умелый
умереть: умереть умер
уничтожение: уничтожения
уничтожить: уничтожена
упоминаться: упоминается
урок: уроке уроки уроков уроках урока урокам
усиливаться: усиливаются
усилиться: усилилась
условие: условий условием условия
успевать: успевает
уточнить: уточните
ухо: ухо
участие: участие участием
учебник: учебник
учитель: учитель учителя
учиться: учиться учился
факт: факт фактом
фактически: фактически
факультет: факультетам факультета
фамилия: фамилии фамилией фамилия
фанат: фанаты фанатов фанатами
фанатской: фанатской
фантастика: фантастики фантастике
фантастический: фантастические
феникс: феникса
философский: философский философским
фильм: фильму фильм фильме фильмов фильмах
финальный: финальной
финеаса: финеаса
флетчеру: флетчеру
фонд: фонд
форма: форме форму
форум: форумов форум
фыркнуть: фыркнула
хагрид: хагрид
хагрида: хагрида
характер: характера
характеристика: характеристики
хижина: хижину хижина
химия: химии
хобби: хобби
хогвартс: хогвартс
хогвартса: хогвартса
хогвартсе: хогвартсе
хогсмид: хогсмид
ход: ход ходе
холодное: холодными
холодный: холоден
хопкинс: хопкинс
хороший: лучше лучшая лучшим
хорошо: хорошо
хотеть: хочет хочу
хотеться: хотелось
храбрость: храбростью
худой: худой
хэнд: хэнд
цата: цатой
цвет: цвета
ценный: ценные
цепляться: цепляться
цитировать: цитировать
чародейство: чародейства
частить: части
частично: частично
часто: часто
часть: часть
чат: чат
чей: чьей
человек: человек людей человеком люди людям
чемпионат: чемпионат
через: через
четверичный: четверичным
число: числе
чистокровный: чистокровной чистокровная
чистота: чистота
читатель: читатель читатели читателям
читать: читая читали читать
член: члену членом член членами
чтобы: чтобы
чувство: чувства
шаблон: шаблонами шаблона шаблон
шармбатон: шармбатон
шест: шестом
шестая: шестой
шестеро: шестеро
шесть: шести
школа: школе школы школ
школьник: школьников
школьный: школьный школьного школьную
шляпа: шляпа
шокировать: шокирован
шотландия: шотландия
шпион: шпионом
шпионить: шпионить
штаб: штаб
штаны: штаны
шумно: шумно
эванс: эванс
эйвери: эйвери
эйлин: эйлин
экзамен: экзаменов
экспеллиармус: экспеллиармус
эксцентричный: эксцентричное
элемент: элементы элемент
элизабет: элизабет
эмоциональный: эмоционален
энциклопедия: энциклопедия энциклопедии
эпизод: эпизоде
эпилог: эпилоге
это: этом это этому этим
этот: этой этих эта эту
юность: юность
юноша: юноша
являться: является
язык: язык языках
яксли: яксли
январь: января
ясный: ясен
