август: августа
авторство: авторства
адский: адский
азкабан: азкабан
азкабана: азкабана
азкабане: азкабане
аластора: аластора
алекс: алекс
алфавит: алфавиту
алхимический: алхимическим
альберт: альберт
альбус: альбус
альбуса: альбуса
амбридж: амбридж
англ: англ
анимага: анимага
антипод: антипод
апрель: апреля
армия: армией
артефакт: артефактов
архив: архив
архивировать: архивировано
архивный: архивная
астория: астории астория
банк: банка
барда: барда
барти: барти
беларуская: беларуская
беллатриса: беллатриса
беллатрисой: беллатрисой
беллатрисы: беллатрисы
беспокоить: беспокоит
бидля: бидля
биография: биография
битва: битва битвы
бладдер: бладдер
бледный: бледный
блондин: блондин
блэка: блэка
богатство: богатства
больший: больше
большинство: большинство
борьба: борьбы
боярышник: боярышник
бросить: бросили
бузинный: бузинной
бумага: бумаги
бумажный: бумажным
български: български
быстро: быстро
быть: бывших
вд: вд
вдохновить: вдохновлены
версия: версией версия версии
вещь: вещей
взгляд: взгляд
взрослый: взрослым
вид: видом вид
викиданных: викиданных
викимедиа: викимедиа
википедии: википедии
википедия: википедия
викисклад: викисклад
викискладе: викискладе
викия: викия
винсент: винсента винсент
витрина: витринах
вклад: вклад
владелец: владельцем
владеть: владел
власть: власти
вместе: вместе
вмешиваться: вмешивается
внешний: внешние внешним
возвращаться: возвращается
возвращение: возвращение
воздействие: воздействием
возможно: возможно
возобновляться: возобновляется
возрождение: возрождении
войти: войти
волан: волан
волос: волосы волос
волшебник: волшебников волшебник волшебники
волшебница: волшебница
волшебный: волшебную волшебные волшебных волшебного волшебная волшебном волшебный
воплощение: воплощение
вопреки: вопреки
воспоминание: воспоминания
воссоединяться: воссоединяется
восходить: восходит
впервые: впервые
впоследствии: впоследствии
враг: врага враг враги
временно: временно
время: время
все: всех всем
вселенная: вселенная
вскоре: вскоре
вследствие: вследствие
встать: встали
встретить: встретил
встречать: встречает
встречаться: встречалась
вступать: вступает
всякая: всякая
всячина: всячина
второе: втором
входить: входит
выбор: выбор
выживание: выживании
вызывать: вызывает
вымыслить: вымышленные
вырастить: вырастит
выручать: выручай
высокий: высокий
вэйверли: вэйверли
гарри: гарри
гермиона: гермиона гермионы гермиону
героизм: героизме
гибкий: гибкая
гиппогриф: гиппогрифа
глава: главе главы глава
глаз: глазах
гоблин: гоблином
говорить: говорит
говориться: говорилось
год: году годы года
гойл: гойл
гойла: гойла
голос: голос
горазд: гораздо
грегори: грегори
грейнджер: грейнджер
гринграс: гринграс
гринграсс: гринграсс
гриффиндора: гриффиндора
гриффиндорской: гриффиндорской
группа: группа группы групп
грюма: грюма
грязнокровкой: грязнокровкой
давно: давно
дамбдлора: дамбдлора
дамблдор: дамблдор
дамблдора: дамблдора
дамблдору: дамблдору
дар: дары
дата: дата
дать: данный данном данной
двойственность: двойственности
де: де
девятый: девятое
действовать: действовать действует
декабрь: декабря
делать: делает
дементором: дементором
день: дней
держать: держит
детство: детстве
деть: дело
дж: дж
джастин: джастин
джерко: джерко
джинни: джинни
джоан: джоан
диадема: диадему
дилогия: дилогия
директор: директора
дитя: дитя
дневник: дневника
добби: добби
добиваться: добивается
доброта: доброта
добрый: добрым
догадаться: догадалась догадавшись
договориться: договорились
док: док
долгопупсом: долгопупсом
должность: должность
долорес: долорес
домовой: домового
домохозяйка: домохозяйка
дополнительный: дополнительное дополнительные
достаточно: достаточно
доступный: доступен
драко: драко
дракон: дракона
драконовский: драконовским
древность: древности
друг: друзьями друг другу
другой: другими другие других другого
дружба: дружба
дружина: дружины дружина
дурмстранг: дурмстранг
дуэльный: дуэльном
дюйм: дюймов
егерь: егеря
единорог: единорога
жалость: жалость жалости
желание: желание
жена: жены жена женой
жениться: женится
жизнь: жизнь
забрать: забрать
завершать: завершающий
заглавный: заглавная
заклинание: заклинание
заклятие: заклятия
заколдованный: заколдованного
заладиться: заладились
заменить: заменить
заметно: заметно
замысел: замыслами
занятие: занятий
занять: занять
заодно: заодно
запись: запись
запланировать: запланированного
зарегистрировать: зарегистрированный
застенок: застенком
заточение: заточения
заточить: заточили
зачаровать: зачарованном
защитить: защитить
защитник: защитникам защитники
заявление: заявление
звание: звания
звать: зовут
зверь: звери
зельеварения: зельеварения
злодей: злодеи
злодейский: злодейскими
злой: злой
змея: змею
знак: знак
знакомый: знакомых
знать: знает знал
значительно: значительно
зрение: зрения
игра: игра игры
играть: играет
играющий: играющих
игрок: игрок
идейный: идейный
идея: идеи
идти: идут
избегать: избегают
избранный: избранные
издеваться: издевается
изменить: изменена
именно: именно
иметь: имеет
имя: именем имя
иначе: иначе
инспекционный: инспекционной инспекционная
инструмент: инструменты
интервью: интервью
интерес: интерес
исполнение: исполнение
использование: использования
использовать: использует использующие
исправить: исправить
история: историю история историй
источник: источник
исчезательный: исчезательный
итог: итоге
итоговый: итогового
июль: июля
июнь: июня
казнить: казни
камень: камень камня
карточный: карточная
касаемо: касаемо
категория: категории
квартира: квартиру
квиддич: квиддич
квиддичу: квиддичу
кивок: кивок
кинозлодеи: кинозлодеи
клуб: клубе
клювокрыла: клювокрыла
книга: книгами книгах книги
когтевран: когтевран
код: код
кодекс: кодекс
коллекционирование: коллекционирование
коллекционный: коллекционная
кольцо: кольцо
команда: команды
комедийный: комедийном
комната: комнате комната комнаты
конечный: конечном
коннотация: коннотации
конструктор: конструктор
конфиденциальность: конфиденциальности
копия: копия
короткий: короткие короткий
коррумпировать: коррумпированными
косой: косом
костюм: костюмы
который: которым которыми которой которую которого котором который
крауч: крауч
крестраж: крестраж
крестражем: крестражем
критик: критиков
кровь: крови
крэбб: крэбб
крэбба: крэбба
крюкохватом: крюкохватом
кубок: кубок
кук: куки
кукла: кукла
культура: культуре
курс: курсе курс
лавгуд: лавгуд
лайонс: лайонс
ледяной: ледяной
лес: лесу
лесничий: лесничий
лестрейндж: лестрейндж
литературный: литературные литературного
лицензия: лицензии
лишать: лишает
лишаться: лишается
лишение: лишениях
лишь: лишь
ловец: ловец
ложный: ложным ложного
локация: локации
лорд: лорда лордом лорду лорд
любить: любят
люциус: люциус
люциуса: люциуса
люциусом: люциусом
маг: маги маг
магазин: магазин
маггл: маггл
магический: магическую
магия: магия магии
магловедения: магловедения
маглы: маглы
македонский: македонски
маленький: маленькой
малфоев: малфоев
малфоем: малфоем
малфои: малфои
малфой: малфой
малфоя: малфоя
мальчик: мальчик мальчики
марволо: марволо
марионетка: марионеткой марионетка
мастер: мастера
материал: материал
мать: мать
мая: мая
медальон: медальона
медиафайлы: медиафайлы
медовуха: медовухи
менее: менее
место: место места
местонахождение: местонахождения
министерство: министерства министерство
мир: мира мир мире
миссис: миссис
миссия: миссия
младший: младшего младший
многие: многие
многий: многом
много: более много
мобильный: мобильная
можно: можно
молодая: молодых
монгол: монгол
морт: морт
морта: морта
мортом: мортом
морту: морту
мочь: мог могут
мракоборца: мракоборца
мракса: мракса
мужской: мужской
музыка: музыку
музыкант: музыкантов
мучить: мучить
мы: нами
набросок: набросках
навигация: навигации навигация
над: над
название: названием
названый: назван
назойливый: назойливых
называть: называет
найти: найти
налагать: налагает
наложить: наложенного
намекать: намекает
намереваться: намеревавшимся
намерение: намерение
нанести: нанести
нападение: нападения нападению
напасть: напасть
напоминать: напоминая
например: например
нарастать: нарастает
нарушать: нарушает
нарцисс: нарцисса
насмешка: насмешки
настолько: настолько
натравливать: натравливает
натура: натуры
находить: находит
начало: начале
начинаться: начинается
наш: наших нашем
невиллом: невиллом
невозможный: невозможна
недобросовестность: недобросовестность
недостаток: недостатков
недостоверный: недостоверный
некоммерческий: некоммерческой
некорректный: некорректные
нела: нел
немного: немного
немолодой: немолодой
необходимость: необходимости
неопр: неопр
неосторожность: неосторожности
неполный: неполный
непреложный: непреложный
неприятный: неприятными неприятный
несмотря: несмотря
неудача: неудачу
неэнциклопедичен: неэнциклопедичен
низко: низко
нил: нила
нильсен: нильсен
новый: новые
норберт: норберта
норма: нормы
норрис: норрис
носить: носят
ноябрь: ноября
об: об
оба: обе
обеспечить: обеспеченный
обессилить: обессиленного
обет: обет
обида: обид
обижать: обижает
обитание: обитания
оборотень: оборотнем
образ: образов
обращение: обращения
обслуживание: обслуживание
обсуждение: обсуждение
обучение: обучения
общество: обществе
общий: общие
огонь: огонь огня
одеваться: одеваться одеваются
одержать: одержит
один: одной
однако: однако
ожерелье: ожерелья
озлобить: озлобленный
означать: означает
оказать: оказать
оказаться: оказалось оказался
оказываться: оказывается
октябрь: октября
олливандера: олливандера
они: них ними
опасный: опасных
описание: описание
опознание: опознании
опубликовать: опубликованной
опытный: опытными
организация: организации
орден: орден
основа: основе
основание: основания
особый: особые
остальное: остальных
осуществление: осуществления
осуществлять: осуществляет
ответ: ответ
ответственность: ответственности
отдельный: отдельных отдельные
отец: отца отец
отказ: отказа отказ
отказывать: отказывает
открытие: открытия
отличаться: отличаться отличается
отличие: отличие
отличный: отличного
отметить: отметила отметил
отношение: отношения отношениях
отправляться: отправляется
отравить: отравленной
отражение: отражение
отредактировать: отредактирована
отряд: отряда отряд
очень: очень
очки: очки
ошибка: ошибке
падать: падает
палочка: палочку палочек палочка палочки
парк: парк
пародируется: пародируется
пародия: пародии
пенаты: пенаты
первое: первое
первоначально: первоначально
перевести: перевести
передать: передать
перейти: перейти
переть: при
переулок: переулке
персонаж: персонаж персонажа персонажами персонажи персонажей
персональный: персональные
песня: песен
печать: печати
печь: печи
писательница: писательница
план: планы
платиновый: платиновый
платформа: платформе
пленник: пленники
плохой: плохой плохи
плэйс: плэйс
победа: победу
победитель: победителем
победить: победить
поведение: поведения
погибать: погибает
подвал: подвалы
подозревать: подозревал
подполье: подполье
подробный: подробнее
подруга: подругу
подтверждение: подтверждение
поединок: поединок поединка
поезд: поезде
поездка: поездки
пожертвовать: пожертвовать
пожиратель: пожирателями пожирателей пожиратель пожиратели
познакомиться: познакомился
поиск: поиск поиску
пока: пока
показывать: показывает
покушение: покушениями
пол: пол
полагать: полагать
политик: политика политике
положение: положение
полтергейст: полтергейстах
полукровка: полукровка
полумну: полумну
получать: получает
получить: получить
поместье: поместья поместье
помнить: помнит помнят
помогать: помогает
помощь: помощью помощи помощь
понять: понял
попасть: попавшего
попечительский: попечительского
популярный: популярной
попытка: попытки
портал: портал
поручение: поручение
порядок: порядка
посадить: посаженного
поскольку: поскольку
послать: посланного
последний: последнее последний последних
посол: после
посредство: посредством
пост: пост
поставить: поставил
постареть: постаревшего
постоянный: постоянная
потенциальный: потенциальному
поттер: поттером поттер поттера поттере
поттеромания: поттеромания
поход: похода
почтить: почти
появление: появлению появление
появляться: появляется
правило: правилам
правильно: правильно
править: править
правка: правка правки
превращать: превращает
предавать: предают
предмет: предметы предметом
предоставить: предоставлен
предостережение: предостережения
представиться: представились
предыстория: предыстория
презрительный: презрительный
преподаватель: преподаватель
префект: префект
префикс: префикс
приближать: приближает
привилегированность: привилегированности
приготовиться: приготовились
приехать: приехали
примета: приметы
примечание: примечания
принадлежать: принадлежит
принадлежность: принадлежность
принимать: принимает
приносить: приносит
принц: принц
приобретение: приобретении
про: про
провал: провал
проваливаться: проваливается
провальный: провальный
проверить: проверенной
проверка: проверки
проверяться: проверялась
проводить: проводить
проект: проектах
произведенье: произведений
производство: производство
происходить: происходит
проклясть: проклятое
проникнуть: проникший
пророчество: пророчество
просмотр: просмотры
простоять: простой
пространство: пространства
противник: противники
профессор: профессор
прочий: прочее
прямой: прямо
пустой: пуст
путеводитель: путеводитель
пытать: пытал
пытаться: пытался пытается
пятый: пятом
работать: работать
разделять: разделяли
раздражать: раздражает
разработчик: разработчики
ранее: ранее
ранний: ранних
расизм: расизм
раскрывать: раскрывает
раскрытие: раскрытии
расположить: расположенный
распределять: распределяющая
рассказ: рассказы
рассказывать: рассказывает
расстроить: расстроенных
расширение: расширение
реакция: реакция
ребенок: детей дети
реддла: реддла
результат: результат
религиозный: религиозные
решающий: решающий
решить: решил
род: род
родитель: родителями родители
родиться: родится
родные: родные
родовой: родовом
родственник: родственников
рождаться: рождается
рождение: рождения
роль: роли
роман: романов
рон: роном рона рон
роулинг: роулинг
рубеус: рубеус
рука: руки
рукопись: рукописям
русский: русского русский
руссо: руссо
ряд: ряд ряды
сакко: сакко
сам: самому
сантиметр: см
саундтрек: саундтрек
сбежать: сбежавшего сбежать
сборная: сборной
сведение: сведения сведениям
свежий: свежие
светлый: светлые
свободный: свободной
свое: своих своему своего своими своем
свой: своей свою
связанный: связанные
связаться: свяжитесь
сделать: сделанной сделал
сдержанный: сдержанный
северус: северус
северусу: северусу
семейный: семейным семейное
семью: семью
семья: семья семье
сентябрь: сентября
сериал: сериал
серия: серии серию серия
сестра: сестры сестре
сжигать: сжигает
сивый: сивым
сириус: сириуса
сисиреджи: сисиреджи
система: системе
сказка: сказки
скачать: скачать
скетч: скетче
скорпиус: скорпиус
скорпиуса: скорпиуса
скрытый: скрытые
следовать: следует
слизерин: слизерин
слизерина: слизерина
слизеринской: слизеринской
слишком: слишком
слово: словам
служебный: служебные
случай: случае случаях
случайный: случайная
смертельный: смертельный
смерть: смерти
снегг: снегг
снегга: снегга
снеггу: снеггу
собираться: собирается
собрание: собрания
собственный: собственной собственный
событие: события
совет: совета
согласно: согласно
содержание: содержание
создание: создание
создатель: создатель
создать: создан создал созданной создать
сокурсница: сокурсницы
сообщество: сообщество
сообщить: сообщить
состав: состав
состояние: состоянии
сотрудник: сотрудником
сохранение: сохранения сохранением
социальный: социальный
спародирован: спародирован
спасать: спасает
спасти: спасли
спектакль: спектакле
спешить: спешит
список: список
спора: споры
способствовать: способствует
справка: справка
спрятать: спрятанный
спунген: спунген
спутник: спутник
среди: среди
српски: српски
српскохрватски: српскохрватски
ссылка: ссылка ссылки
ставить: ставит
сталкиваться: сталкиваются сталкивается
становиться: становится
староста: старостой
старший: старший старшей
статистика: статистика
статус: статус
стать: стать став стали ставшего
статья: статью статья статье статьи
стеклянный: стеклянных
стивен: стивен
стилистический: стилистическим стилистически
стиль: стиле стиль стиля
стильный: стильным
стоить: стоит стоящие
стол: столом
столкнуться: столкнулся
сторона: стороны сторону
страница: страницы страница страницу странице
странный: странных странный
студент: студенты студентов
суметь: сумели
сухой: сухой
существо: существа
схватить: схватили
считать: считает
сын: сына сын сыном сыновей
сюда: сюда
тайный: тайная тайной
также: также
такой: такие
татарча: татарча
текст: текст тексты
текущий: текущие текущая
телесериал: телесериале телесериала
тело: тело
телосложение: телосложение
тематический: тематический
терпеть: терпеть терпит терпят
терпимый: терпимым
тетя: тетя
товарищ: товарищей
товарный: товарный
тоесть: тоесть
том: тома
топ: топе
тот: том
точка: точки
травма: травму
традиция: традициям
трапезный: трапезной
требовать: требует
тренировка: тренировке
троица: троицей
тронуть: тронули
трудный: трудное
турнир: турнира
тюрьма: тюрьмы
убивать: убивает
убийца: убийце
убить: убитого убить убита
увидеть: увидел
увлечение: увлечениях
удар: удар
узнать: узнал
узник: узник
уизли: уизли
уйти: ушедших
указание: указанием
указать: указано указан
умирать: умирает
уничтожать: уничтожает
уничтожить: уничтожить уничтожит
урок: уроке уроки
условие: условий условия
усовершенствовать: усовершенствованной
успеть: успел
утверждать: утверждают
участие: участие
участник: участниками участники участником
учащийся: учащийся
ученик: учеником
факультет: факультета факультет
фамилия: фамилия
фантастический: фантастические
февраль: февраля
фелтон: фелтон
феникс: феникса феникс
фенриром: фенриром
фигурировать: фигурировал
филипп: филипп
философский: философский философского
фильм: фильм фильмов
фонд: фонд
форменный: форменным
форум: форум
фраза: фразы
фрай: фрай
французский: французский французского
хагрид: хагрид
хагрида: хагрида
хагридом: хагридом
халат: халаты
характеристика: характеристики
хижина: хижине
хобби: хобби
хогвартс: хогвартс
хогвартса: хогвартса
хогвартсе: хогвартсе
холл: холле
хороший: лучше
хранить: хранит
худощавый: худощавый
хулиган: хулиганов
цвет: цвет
цель: целях
цитировать: цитировать
часто: часто
человек: люди
чемпионат: чемпионат чемпионате
через: через
чинить: чинит
чистокровный: чистокровной чистокровных чистокровный
чистота: чистота
читать: читать
член: члена членом члены
чтобы: чтобы
чувство: чувствах
шаблон: шаблонами шаблон
шармбатон: шармбатон
шейн: шейн
шест: шестом
шкаф: шкаф
школа: школу школе школы
школьный: школьный школьного школьные школьных
шляпа: шляпа
штаб: штаб
элемент: элемент
эльф: эльфа
энциклопедия: энциклопедии
эпизод: эпизоде эпизодах
это: этом это
этот: этой эта
являться: являясь является
язык: язык языках языка
январь: января
