август: августа
автор: авторы
авторство: авторства
аглая: аглая
агрий: агрий
азия: азии
аида: аид
акрополь: акрополь
акт: акт
александр: александра
алексей: алексей
алекто: алекто
алкиону: алкиону
аллегорист: аллегорист
алфавит: алфавиту
амазонка: амазонки
америка: америки
амфитрита: амфитрита
амфора: амфора
аналог: аналогом
ананке: ананке
англ: англ
английский: английского
анкий: анкий
антерос: антерос
античность: античности
античный: античной античного
апдайк: апдайк
аполлодор: аполлодор
аполлон: аполлона аполлон
арабский: арабских
аргонавт: аргонавты
арес: арес
арийский: арийского
аристотель: аристотель
артемида: артемида
архивировать: архивировано
асий: асия
асклепий: асклепий
астерий: астерия
астрей: астрей
атлант: атлант
атрибутивный: атрибутивным
атропос: атропос
афина: афина
афиней: афиней
афродита: афродите афродита
ахилл: ахилл
ахилла: ахилла
б: б
батист: батист
бежать: бегущими
беларуская: беларуская
берналь: берналь
беспочвенный: беспочвенными
беспощадный: беспощадное
бестиарий: бестиарий бестиарии
библиотека: библиотека
битва: битва
бия: бия
благодаря: благодаря
благородный: благородного
ближний: ближайший
бова: бове
бог: бога богов боги
богиня: богини
божество: божества
больший: большая
боровск: боровском
бороться: боролся
борьба: борьба
брат: брат
брокгауза: брокгауза
бронзовый: бронзового бронзовое бронзовом бронзовая
буйвол: буйволы
буйный: буйным
букентавр: букентавр
бурак: бурак
бурный: бурных
български: български
бык: быков бык быками
быть: были
вазописца: вазописца
варвар: варваров
вариант: вариант варианте
вариация: вариаций
ватиканский: ватиканский
вверху: вверху
ведийский: ведийские
век: века веке век
великий: великий
вепрь: вепрем
верность: верность
вероятно: вероятно
вероятный: вероятнее
версия: версиях версию версия
верх: верхом
верховый: верховую верховой
весь: вся
весьма: весьма
ветер: ветры
вид: вида
видеть: видели
викиданных: викиданных
викимедиа: викимедиа
википедии: википедии
википедия: википедия
викисклад: викисклад
викискладе: викискладе
викисловаре: викисловаре
викисловарь: викисловарь
вино: вина
вклад: вклад
внешне: внешне
внешний: внешние внешнего
внешность: внешностью внешность
водный: водной
возводиться: возводится
возмужать: возмужав
возникнуть: возник
воин: воина
война: война
войти: войти
вообще: вообще
воплощение: воплощение воплощением
вопрос: вопрос
воспитатель: воспитателями
воспитать: воспитаны
восходить: восходит
впервые: впервые
вплоть: вплоть
впоследствии: впоследствии
враждебный: враждебны
временить: времени
время: время временам
всадник: всадник всадниках всадниками
все: всех всего
всеять: всей
встречаться: встречается встречались
вступить: вступили
выводить: выводили
выкармливаться: выкармливались
вымыслить: вымышленных
вымя: выменем
высокомерие: высокомерия
вытеснить: вытеснен
галатея: галатея
галена: галена
гамадриада: гамадриады
гандхарв: гандхарв
гандхарва: гандхарва
гандхарвы: гандхарвы
ганимед: ганимед
гармония: гармония
гарпия: гарпии
геба: геба
геката: геката
гекатонхейры: гекатонхейры
гектор: гектор
геликон: геликоне
гелиос: гелиос
гемера: гемера
генеалогический: генеалогического генеалогические
география: география
геометрический: геометрического
гера: гера герой
геракл: геракл геракла гераклом
гераклит: гераклит
геральдика: геральдике
герб: гербах герб
гермафродит: гермафродит
гермес: гермес
героиня: героини
героический: героических
герой: героя героев герои
гесиона: гесиона
геспериды: геспериды
гестия: гестия
гефест: гефест
гефестион: гефестион
гея: гея
гибрид: гибриды
гибридный: гибридное
гигант: гиганты
гигин: гигин
гидра: гидры
гилонома: гилонома
гиль: гилей
гименей: гименей
гимерос: гимерос
гиперион: гиперион
гипериониды: гипериониды
гипнос: гипнос
гипподамии: гипподамии
главк: главк
гмина: гмины
говорить: говорить
год: гг году год года
голова: головой
голод: голода
гольшан: гольшан
гомер: гомер
гопатшах: гопатшах
гора: горах гор горе горы
горгона: горгона
гореть: горя
горный: горных
город: города
городской: городских
грайи: грайи
грация: грации
греко: греко
греча: греч
греческий: греческого греческим греческих
григорьев: григорьев
грудь: грудью
группа: группы
д: д
далее: далее
дата: дата
датский: датская
два: две двух
двоедушный: двоедушного
двуприродные: двуприродные
деймос: деймос
дейно: дейно
действовать: действовать действует
декабрь: декабря
дель: дель
деметра: деметра
демиург: демиург
день: дня
деревня: деревни
деяние: деяния
деянира: деянира
деянире: деянире
деяниру: деяниру
джон: джон
диас: диас
дик: дике
дикий: дикими дикие диких
диодор: диодор
диодору: диодору
диона: диона
дионис: дионис диониса
добром: добром
додекатеон: додекатеон
дополнительный: дополнительные
дорида: дорида
доступный: доступен
др: др
дракон: драконы дракон
драма: драма
древнегреческий: древнегреческая древнегреческие древнегреческой
древнерусский: древнерусской
древность: древностей
дриада: дриады
друг: друзья другом
другой: другому другие других
дурной: дурной
духовно: духовно
дьявол: дьяволу дьявола
евразия: евразии
евринома: евринома
еврипид: еврипид
евритион: евритион
европейский: европейские европейских
евфросина: евфросина
единение: единения
единственный: единственная
единство: единства
единый: единым
езда: езды езду
еретик: еретика
ефрона: ефрона
ехидна: ехидна
жан: жан
жанр: жанра
жена: жена жену
женский: женского
женщина: женщины женщина
живопись: живопись живописи
животное: животным животные
животный: животная
жила: жил
жить: жили
завоевание: завоевания
заглавный: заглавная
задний: задняя
заимствовать: заимствованы заимствовано
запах: запах
запечатлеть: запечатлены
запись: запись
заполнить: заполнены заполнить
запрос: запросы
зарегистрировать: зарегистрированный
заслушаться: заслушались
затем: затем
зачастую: зачастую
заявление: заявление
зевс: зевс
зевса: зевса
зел: зел
земля: земле земля
зеркало: зеркала зеркало
зло: злом
знак: знаков знак
знать: знавших знает знавшим
значение: значения
зодиак: зодиака
иапет: иапет
иапетиды: иапетиды
ибрагим: ибрагим
игра: играх
играть: играя
идентифицировать: идентифицированы
избранный: избранные
извергнуть: извергнутого
известный: известной известны известная
излишество: излишества
изначальный: изначальный
изображаться: изображается
изображение: изображениями изображения изображение
изобрести: изобрели
иксиона: иксиона
илифия: илифия
иметь: имел имевшего имели
имя: имя имени
инд: инд
индеец: индейцы индейцам индейцами
иногда: иногда
инструмент: инструменты
интерес: интерес
интерпретироваться: интерпретироваться
иранский: иранской
ирида: ирида
искусство: искусстве
ислам: исламе
испанский: испанский испанского
использование: использования
использовать: использует
использоваться: используется
истолкование: истолкованию
исторический: исторические историческая
история: история
источник: источнике источник
итальянский: итальянская
ихтиокентавр: ихтиокентавр
июнь: июня
йоркский: йоркском
каллиопа: каллиопа
каллироя: каллироя
карсака: карсака
касситов: касситов
кастильо: кастильо
катастеризм: катастеризм
катастеризмы: катастеризмы
категория: категории
качество: качества
кентавр: кентавра кентаврами кентаврах кентавров кентавром кентавры кентавр
кентаврида: кентаврида
кентавридой: кентавридой
кентавриды: кентавриды
кентаврица: кентаврица
кентаврицы: кентаврицы
кентавроиды: кентавроиды
кентавромахии: кентавромахии
кентавромахия: кентавромахия
керамик: керамики
керасты: керасты
кето: кето
кеяниды: кеяниды
киллара: киллара
кино: кино
кипр: кипра
китоврас: китоврас
классический: классических
климена: климена
клио: клио
клото: клото
кн: кн
книга: книга
княжество: княжестве
ко: ко
кобылица: кобылицы кобылиц кобылицами
ковбой: ковбой
код: код
кодекс: кодекс
кой: кой
колоть: колоть
комма: комм
комментарий: комментарий
компьютерный: компьютерных
конец: концов конце
конкистадор: конкистадор
конкистадоры: конкистадоры
конный: конными
конфиденциальность: конфиденциальности
конь: коня конь
коренной: коренными
корень: корней
корибант: корибанты
королевич: королевиче
король: король
короткий: короткий
коротко: коротко
космологический: космологических
космос: космоса
который: которое которого которые которых которая который
кочевник: кочевников
кочевой: кочевых
кратос: кратос
крий: крий
крияниды: крияниды
кровь: кровью кровь
кронос: кронос
кроноса: кроноса
крот: крот
кротос: кротос
кругосвет: кругосвет
крылатый: крылатый крылатым
крышка: крышке
кук: куки
культура: культуре
культурный: культурный
ла: ла
лаконии: лаконии
лама: лам
лапиф: лапиф
лапифов: лапифов
лаптев: лаптевых
ларец: ларца
лата: лат
латинизировать: латинизированный
лахесис: лахесис
левый: лев
легендарный: легендарные
леонтокентавр: леонтокентавр
лернейский: лернейской
лес: леса лес
лесной: лесных
лето: лето
летопись: летопись
лефканди: лефканди
либо: либо
лика: лики
ликофрон: ликофрон
лимнады: лимнады
линкея: линкея
лира: лир
литература: литература литературе
литературный: литературной
лицензия: лицензии
лицо: лицу лицом
лошадиный: лошадиная лошадиной лошадиными
лошадь: лошади лошадей лошадью лошадьми
луг: луга
лука: лука
любкер: любкер
любовь: любви любовь
лютомерск: лютомерск
м: м
магнесийских: магнесийских
македонский: македонски
макса: макс
малеан: малеан
малый: малый
материал: материал
мая: мая
мгла: мгла
мегера: мегера
медведь: медведь
медиафайлы: медиафайлы
медуза: медуза
мелия: мелии
мельпомена: мельпомена
менетий: менетий
место: месте
метаморфоза: метаморфозы
метида: метида
метрополитен: метрополитен
микенский: микенской
миниатюра: миниатюрах
минос: минос
минотавр: минотавр
мир: мира мир
миф: мифе мифам мифа мифах мифы
мифический: мифические
мифограф: мифограф
мифологический: мифологическая мифологическом мифологические мифологического
мифология: мифологии мифология
мнемосина: мнемосина
много: более
мобильный: мобильная
могила: могиле
могучий: могучее
мойра: мойры
монета: монетах
морить: моря
морской: морской
москва: москва
мочь: можете могут
мудрец: мудрецов
мудрость: мудрости
мудрый: мудрые
муж: мужа
муза: муз музы
музей: музее музей
мухаммед: мухаммеду
мучение: мучениях
мы: нами
н: н
навигация: навигации навигация
наиболее: наиболее
найти: найдена найдено найденных найден
напеи: напеи
напольских: напольских
например: например
напротив: напротив
напрямую: напрямую
народ: народов народы
народный: народная народным
населять: населяли
наследье: наследье
настоящее: настоящее
научный: научной научно
находить: находит
находиться: находится
находка: находок
начинать: начинает начиная
наяда: наяды
неавторитетный: неавторитетный неавторитетном
небо: небе
неверный: неверно
невероятный: невероятном
невеста: невесту
невоздержанность: невоздержанностью
некий: неких некоего
некоммерческий: некоммерческой
некоторые: некоторых некоторые
немалый: немало
немертея: немертея
немесида: немесида
немногие: немногие немногих
необузданный: необузданных необузданные необузданного
необычный: необычные
неопр: неопр
нереида: нереиды
нерей: нерей
несдержанный: несдержанными
несс: несс
несса: несса
нессом: нессом
нефелы: нефелы
низкий: ниже
ника: ника
никогда: никогда
никольский: никольский
нимфа: нимфы нимфами
новый: новый новые
нога: ноги
нонна: нонн
норвежский: норвежская
нохчийн: нохчийн
нрав: нрава нравом нрав
нью: нью
нюкта: нюкта
об: об
обесчестить: обесчестить
обитатель: обитателями обитатели
облагородить: облагородить
облик: облике
обозначение: обозначения
оборот: оборот
образ: образу образа образами образы образ
образец: образцов
обращаться: обращались
обращение: обращения
обсуждение: обсуждение
обучать: обучает
общий: общего
объяснение: объяснение
объясняться: объясняется
обычно: обычно
овидий: овидий
одежда: одежду
одетый: одет
один: одном одного одному одно одними одни
одиссей: одиссее одиссей одиссея
ожеребятившего: ожеребятившего
ок: ок
океан: океан
океанида: океаниды
октябрь: октября
олимпиец: олимпийцы
олимпийский: олимпийские
олицетворение: олицетворением
олицетворять: олицетворяющий
они: им них
онлайн: онлайн
онокентавр: онокентавр
описание: описание
описать: описан
описывать: описывали описывает
описываться: описывается
опубликовать: опубликовал
организация: организации
ореада: ореады
орей: орей
оригинал: оригинала
оригинальный: оригинальный
оры: оры
основа: основой
основать: основанными
основное: основном
основной: основные основная
особенно: особенно
особый: особое
оставаться: оставалась
остров: островах острове
ответственность: ответственности
отдельный: отдельных
отказ: отказ
отличаться: отличаются
относительно: относительно
отомстить: отомстить
отравить: отравленной
отредактировать: отредактирована
отчего: отчего
офион: офион
охотник: охотник
оцарапаться: оцарапался
очередь: очередь
ошибка: ошибке
палефат: палефат
паллант: паллант
парфенон: парфенон
пауль: пауль
пелефроний: пелефроний
пелионе: пелионе
пемфредо: пемфредо
первоначально: первоначально
первоначальный: первоначальные
первый: первую первая первый
перебить: перебили перебита
перевод: перевод перевода
передвигаться: передвигавшиеся
передний: передние
перейти: перейти
переосмысление: переосмыслением
перестать: перестали
переть: при
период: периода периоде
перс: перс
персеида: персеида
персефона: персефона
перси: персей
персонаж: персонаж персонажами персонажи персонажей
персональный: персональные
петербург: петербург
печать: печати
пиленор: пиленор
пилион: пилион
пир: пиру пир
пирифоя: пирифоя
писатель: писателей
питер: питер
планет: планеты
плейона: плейона
племя: племени
плеяда: плеяды
плод: плод
плотский: плотским
побывать: побывала
поведение: поведения
повестить: повести
погонщик: погонщик
подвигнуть: подвиг
подвластный: подвластных
подробный: подробнее
подход: подходу
пожертвовать: пожертвовать
позволять: позволяет
поздний: позже позднейшим
поиск: поиск поиску
показаться: показалось
показываться: показываются
покончить: покончила
пол: пола
поле: поля
полигимния: полигимния
политик: политика
полкан: полкан
полный: полная
полуконь: полуконь
полуостров: полуостров
получеловек: получеловек
получить: получить
помочь: поможет помочь
помощь: помощью
попадать: попадают
популярный: популярными популярны популярным популярен
попытаться: попытался
портал: портал
посейдон: посейдон посейдона
последний: последняя последний последних
посоветовать: посоветовал
посредство: посредством
постоянный: постоянная
потерять: потеряла
поток: потоков
потомок: потомками
потомство: потомством
потос: потос
похитить: похитить
похищение: похищение
поход: похода
почва: почву
почтить: почти
поэт: поэтов
поэтика: поэтика
поэтический: поэтическим
появляться: появляются
пояс: пояса
править: править
правка: правка правки
предварительно: предварительно
предок: предка
предположительно: предположительно
представитель: представителей
представиться: представились
представление: представлениям представления
представлять: представляющая
представляться: представлялись
прекрасный: прекрасных
прелюбодеяние: прелюбодеяние
преобладать: преобладает
признать: признать
применять: применяет
примечание: примечания
примечательно: примечательно
принадлежать: принадлежат
принять: принять принятую
приобрести: приобрела
природа: природа природой
приручать: приручать
про: про
проект: проектах проекту
произведенье: произведений
происхождение: происхождения происхождение
прометей: прометей
промывать: промывал
пропитать: пропитала
пророк: пророк
просмотр: просмотры
просторечие: просторечии
пространство: пространства
протей: протей
против: против
противоположность: противоположностью
протоген: протогены
протогреческий: протогреческий
прошлый: прошлом
прямая: прямыми
псевдо: псевдо
птолемей: птолемей
путать: путали
пытаться: пытался
пьеса: пьеса
пятый: пятый
работа: работы
радамант: радамант
разгореться: разгоревшаяся
раздел: разделе
различный: различных
размещаться: размещается
разнометрический: разнометрическая
разработчик: разработчики
разрывать: разрываемого
разумный: разумные
рана: рану
раскопка: раскопках
раскрасить: раскрашенная
распад: распада
рассеять: рассеял
рассказ: рассказу
расширить: расширив
реальный: реальный
ребенок: дети
редко: редко
рей: рея
река: рек река реке
религия: религия
реньо: реньо
ресурс: ресурсы
решить: решил
римский: римской
робинзоны: робинзоны
рогатый: рогатые
род: рода
родить: рожденные
родиться: родились
родовой: родовых
родственный: родственных
роль: роль
роман: романе роман
российский: российская
россия: россия
рубенс: рубенс
рубить: рубить
русская: русской
русский: русский
русый: рус
рыба: рыбы
рыцарь: рыцаря
ряд: ряда
сайт: сайте сайты
сам: само
самый: самые
санкт: санкт
сантиметр: см
сао: сао
сатира: сатиры
свадебный: свадебном
свадьба: свадьбе
сведение: сведения
свежий: свежие
свирепый: свирепый
свободный: свободной
сводный: сводный
свой: свою
свойство: свойство
связанный: связанные связанного связаны
связаться: свяжитесь
связь: связи связь
себя: собой
северный: северной северных
селить: селена
семантический: семантически
семенить: семени
семеро: семеро
серпуховско: серпуховско
сестра: сестру
силен: силена
символ: символом символы
символизировать: символизирует
символика: символике
сирена: сирены сирен
система: системе
сицилийский: сицилийскому сицилийский
скачать: скачать
скиф: скифов
скотоводство: скотоводство
скрытый: скрытые
скрыть: скрыл
скульптор: скульпторы
следовать: следует
словарь: словари словарь
слово: слова слово
словообразование: словообразованию
служебный: служебные
служилый: служил
случай: случаях
случайно: случайно
случайный: случайная
смертный: смертные
собрать: собрать
событие: события
совершать: совершал
современный: современной
согласно: согласно
содержание: содержание
созвездие: созвездием созвездиях
создание: созданий создание
создать: создать
сообщество: сообщество
сообщить: сообщить
сопровождать: сопровождают
состоять: состоящему
сохранение: сохранением
сохранить: сохранить
сохраниться: сохранившихся
сохранять: сохраняющих
сочетать: сочетающее
спастись: спаслись
спекуляция: спекуляции
способ: способ
справка: справка
сравнение: сравнении
сражаться: сражается
среди: среди
средневековый: средневековой средневековые
средний: средние
српски: српски
српскохрватски: српскохрватски
ссылка: ссылка ссылками ссылки
становиться: становятся
старый: старая старый
статистика: статистика
статуэтка: статуэтка статуэтки
стать: стал
статья: статью статья статьи
стикс: стиксы стикс
стиль: стиля
стихия: стихии
столкнуться: столкнувшихся
страница: страницы страница страницу странице
страсть: страсти
страшный: страшных
стрела: стрелой стрелы
стрелец: стрельца
стрелять: стреляющий
субстратный: субстратного
судьба: судьбы
судья: судьи
существо: существо существ существа существом существами
существование: существовании
существовать: существуют существует существовала
схожий: схожих схожи
сцена: сцена сцены
считать: считают
считаться: считается считались считался
сын: сыновьями сыном
сюда: сюда
сюжет: сюжетах сюжетом
т: т
тавровый: тавров
также: также
талия: талия
танатос: танатос
тапир: тапиров
тартар: тартар
тейя: тейя
текст: текст
текущий: текущие текущую
тело: теле тела
тельхины: тельхины
тематический: тематические
термин: термина термин
терпсихора: терпсихора
терракотовый: терракотовых терракотовая
тесей: тесей
тефида: тефида
тип: тип
тисифона: тисифона
титан: титаны титанов
титаниды: титаниды
тифон: тифон
товарный: товарный
томирис: томирис
торс: торс торсом
торшилова: торшилова
тот: том те тот
тотемический: тотемически
трагедия: трагедии
традиционно: традиционно
традиция: традиции
трактат: трактатов
триптолем: триптолем
тритон: тритон
троянский: троянская
тт: тт
туча: туча
убийца: убийца
убить: убит
угарите: угарите
указание: указанием
указать: указан
умереть: умер умерли
умирать: умирая
упоминать: упоминающие
уран: уран
урания: урания
усиливаться: усиливаться
условие: условий условия
устюг: устюг
утверждение: утверждениями
ухо: уши ушами
участие: участие
учение: учение
учитель: учитель учителя
ф: ф
фаддей: фаддея
фалло: фалло
фантазия: фантазии
фантастика: фантастики
фантастический: фантастической фантастическом
фарж: фарж
фауна: фауна
феба: феба
фемида: фемида
фессалии: фессалии
фетида: фетида
фивы: фив
фигурировать: фигурируют
физически: физически
филира: филира
филиры: филиры
флора: флора
фобос: фобос
фол: фол фола
фолойские: фолойские
фонд: фонд
форкий: форкий
форум: форум
франсис: франсиса
фря: фрей
фуриетти: фуриетти
фэнтези: фэнтези
хаос: хаос
харита: хариты
херемона: херемона
химки: химок
хирон: хирон
хирона: хирона
ход: ходом
хозяйство: хозяйства
хомад: хомад
хоть: хоть
христианство: христианстве
хронология: хронология
хронос: хронос
хтонический: хтонические
художник: художники художников
царить: царя
центавр: центавр
центавра: центавра
центр: центр
центральный: центральной
цивилизованность: цивилизованность
цивилизовать: цивилизованных
циклоп: циклопы
циллара: циллара
цитировать: цитировать
частично: частично
часто: часто
часть: часть
чаща: чащ чаще
чеканиться: чеканившихся
человек: человек человека люди
человеко: человеко
человеческий: человеческими человеческий человеческие
через: через
черта: черты
число: числе
читать: читать
чтобы: чтобы
чувственность: чувственность
чувство: чувствам
шекспир: шекспир
шея: шеи
э: э
эак: эак
эвгемерическому: эвгемерическому
эвномия: эвномия
эволюция: эволюции
эврисфея: эврисфея
эвритион: эвритион
эвтерпа: эвтерпа
эдип: эдип
эйрена: эйрена
экспедиция: экспедиции
элевсине: элевсине
электра: электра
элемент: элементы элемент
элиде: элиде
эллада: элладе
энио: энио
энциклопедия: энциклопедия энциклопедии
эол: эол
эос: эос
эпизодический: эпизодических
эпимелиды: эпимелиды
эпиметей: эпиметей
эпоха: эпох
эрато: эрато
эреб: эреб
эрида: эрида
эринии: эринии
эрифманским: эрифманским
эрот: эрот
эроты: эроты
этимологический: этимологически
этимология: этимологию
это: этом это этим
этот: эта эту
эфир: эфир
южный: южной
юноша: юноши
являться: является являются
яд: ядом
ядовитый: ядовитой
язык: язык языках языка
языковой: языкового языковом
якоб: якобы
январь: января
ясон: ясон ясона
