автор: авторов
авторитетный: авторитетными авторитетные
авторство: авторства
алфавит: алфавиту
англ: англ
английский: английского английские
антропоморфный: антропоморфны
архивировать: архивировано
банк: банке
беларуская: беларуская
бес: бес
бестиарий: бестиарий
библиографический: библиографических
благодаря: благодаря
бояться: боятся
български: български
быть: были
варьироваться: варьируется
век: века
версия: версия версии
взаимозаменяемый: взаимозаменяемые
вид: вид виде
викиданных: викиданных
викимедиа: викимедиа
википедии: википедии
википедия: википедия
викисклад: викисклад
викискладе: викискладе
викисловаре: викисловаре
викисловарь: викисловарь
вклад: вклад
властелин: властелин
внешний: внешние внешний
внешность: внешности внешность
возможно: возможно
войти: войти
волшебный: волшебном
восходить: восходит
впрочем: впрочем
враг: враг
вселенная: вселенной вселенных
вывести: вывел
вэттэ: вэттэ
гарри: гарри
глаз: глазам глаза
гоблин: гоблина гоблин гоблины гоблинов гоблинами
год: году года
гойя: гойи
греча: греч
гринготтс: гринготтс
грубый: грубых
дата: дата
два: двух
действовать: действовать
джон: джону
джордж: джорджа
длинный: длинные
добавить: добавив
долгий: долгие
должен: должна
дополнительный: дополнительные
достоверно: достоверно
доступный: доступен
др: др
другой: другие других
дуэнде: дуэнде
европейский: европейской
жестокий: жестоких
житель: жителей
жить: жили живущее живут
журнал: журнал
заглавный: заглавная
западноевропейский: западноевропейской
запись: запись
заполнить: заполнить
запрос: запрос
зарегистрировать: зарегистрированный
заявление: заявление
знак: знак
значение: значения
избранный: избранные
измениться: изменились
изображение: изображениями
иначе: иначе
инструмент: инструменты
информация: информация информацию информации
использование: использования
использовать: использовал
исправить: исправьте
исследование: исследование исследованием исследований
история: история
источник: источников источники источниками источникам источник
июнь: июня
каталог: каталогах
категория: категории
книга: книгах
кобольд: кобольд
коготь: когти
код: код
кодекс: кодекс
кольцо: колец
конфиденциальность: конфиденциальности
корень: корня
король: король
короткий: короткий
косплей: косплей
который: которое которые который
кошачий: кошачьи
кук: куки
культура: культуре
лата: лат
лицензия: лицензии
макдональда: макдональда
македонский: македонски
марта: марта
материал: материал
мая: мая
медиафайлы: медиафайлы
метр: метров
мир: мир
мифический: мифическое мифические
мифологический: мифологические
мифология: мифологии мифология
мобильный: мобильная
можно: можно
мочь: можете могут
мы: нами
навигация: навигации навигация
называть: называть называют
наличие: наличии
например: например
народ: народ народы
невзлюбить: невзлюбил
недостаток: недостатков
неизменный: неизменными
некоммерческий: некоммерческой
некоторые: некоторых
необходимость: необходимости
никак: никак
новый: новые
об: об
образ: образ
обращение: обращения
обсуждение: обсуждение
один: одно одни
они: им
онлайн: онлайн
описание: описание
описываться: описывается
организация: организации
оригинальный: оригинальное оригинальных оригинальным
орками: орками
орки: орки
оставаться: остаются
ответственность: ответственности
отдельный: отдельных
отказ: отказ
отредактировать: отредактировать отредактирована
ошибка: ошибке
паук: паука
перейти: перейти
перенаправить: перенаправлено
перенаправляться: перенаправляется
переносить: переносящее
персонаж: персонажи
персональный: персональные
перчатка: перчатки
печать: печати
пещера: пещерах
плут: плут
поведение: поведения
поверхность: поверхности
повестить: повести
подземный: подземных
подозревать: подозреваемые
подробный: подробнее
подтвердить: подтвердите
пожертвовать: пожертвовать
поиск: поиск поиску
политик: политика
получить: получить
последний: последняя последний
постоянный: постоянная
поттер: поттера
похожий: похожие
поэтому: поэтому
править: править правил
правка: правка правки
превращаться: превращаться
предание: преданию
представиться: представились
представление: представлении
преимущественный: преимущественно
прийтись: пришлось
примечание: примечания
про: про
проверить: проверьте
проверять: проверяема
продолжение: продолжении
проект: проектах
происходить: происходит
просмотр: просмотры
пространство: пространства
противный: противном
прошлый: прошлом
прятать: прячут
прятаться: прятаться
работать: работают
раздеть: раздел
разный: разные разному
разработчик: разработчики
рекомендация: рекомендации
ресурс: ресурсы
родич: родичи
родственный: родственные родственных
роман: романе
рост: рост
рука: руках
русский: русский
самый: самых
сантиметр: см
сведение: сведения
свежий: свежие
света: света
свободный: свободной
свойство: свойство
связанный: связанные
связаться: свяжитесь
сильный: сильно
система: системе
сказочник: сказочника
скачать: скачать
скрытый: скрытые
скрыть: скрыть
словарь: словари
слово: слова слово
сложиться: сложился
служебный: служебные
случай: случае случаях
случайный: случайная
сноска: сносок
событие: события
современный: современном современной
согласно: согласно
содержание: содержание
содержать: содержит
создание: созданий создание
создать: создать
солнечный: солнечного
солнце: солнца
сообщество: сообщество
сообщить: сообщить
соответствие: соответствие
сохранение: сохранением
справка: справка
ссылка: ссылка ссылками ссылки ссылок
старонормандского: старонормандского
статистика: статистика
стать: стали
статья: статью статья статье статьи
страница: страницы страница страницу странице
страшный: страшные
существо: существа
сюда: сюда
также: также
такой: такими
текст: текст
текущий: текущие
тереть: три
тип: типам
товарный: товарный
толкин: толкин
толкину: толкину
удаленный: удалена
удалить: удалите
узнать: узнать
указание: указанием
уметь: умеют
уродливый: уродливых
условие: условий условия
ухо: уши
участие: участие
ф: ф
фантастика: фантастики
фонд: фонд
форум: форум
фр: фр
фут: фута
фэнтези: фэнтези
хватать: хватает
хоббит: хоббит
хобгоблин: хобгоблин
цитировать: цитировать
человек: человека людей люди
человекоподобный: человекоподобное
человечек: человечки
читать: читать
шаблон: шаблонами
шапка: шапку
шубин: шубин
элемент: элемент элемента
энциклопедия: энциклопедии
этимология: этимология
этот: эта
являться: являющуюся
язык: языках
