абсолютный: абсолютная
авт: авт
авторство: авторства
агатодемон: агатодемон
адам: адам
адепт: адептами
аду: аду
алкагест: алкагест
алхимик: алхимики алхимиков алхимик
алхимический: алхимические алхимических алхимический алхимическая
алхимия: алхимии алхимия
альбедо: альбедо
амон: амон
ангел: ангелы
английский: английский
антропософия: антропософия
анх: анх
артефиус: артефиус
асклепий: асклепий
астральный: астральная астральный
астрология: астрология
ацетат: ацетата
ацетон: ацетона
б: б
багдасарян: багдасарян
баня: бане
бафомет: бафомет
безвкусный: безвкусную
белый: белого белой
бессмертие: бессмертие
библиографический: библиографических
богоматерь: богоматери
божественный: божественной божественную божественная
болезнь: болезни
больший: большая большие
большинство: большинство
большой: большой
брак: брак
брать: берут
брокгауза: брокгауза
бромид: бромид
български: български
бэлза: бэлзы
важный: важный
василиск: василисков
вдоволь: вдоволь
век: веке век
великий: великий
великое: великое великого
великолепный: великолепный
версия: версия версии
весь: вся
вечный: вечная
вещество: веществ вещества вещество
взять: возьмите возьми
викиданных: викиданных
викимедиа: викимедиа
википедии: википедии
википедия: википедия
викисклад: викисклад
викискладе: викискладе
викисловаре: викисловаре
викисловарь: викисловарь
викитеке: викитеке
викитеку: викитеку
викицитатник: викицитатник
викицитатнике: викицитатнике
винный: винным
виноградный: виноградным
вклад: вклад
влиять: влияет
вненаучного: вненаучного
внешний: внешняя внешние
вновь: вновь
внутренний: внутреннего внутренняя
внутрь: внутрь
воды: воды
войти: войти
волшебный: волшебные
восьмой: восьмом
врата: врат
вряд: вряд
все: всего
всеять: всей
вскоре: вскоре
второстепенный: второстепенное
выводиться: выводящихся
выдумка: выдумкой
выложить: выложены выложить
вылупливаться: вылупливаются
выпарить: выпари
вырастать: вырастают
вырастить: вырастить
выращивать: выращивает
высиживание: высиживания
высокий: высшую
выступать: выступает
гадание: гадания
гарри: гарри
гвоздь: гвоздь
гематрия: гематрия
геометрия: геометрия
германий: германии
германубис: германубис
гермафродит: гермафродит
гермес: гермес
герметизм: герметизм
герметизма: герметизма
герметизме: герметизме
герметический: герметический
глава: глава
главное: главные главных
глина: глины глиной
глотать: глотающий
гнозис: гнозис
гном: гномы
гностицизм: гностицизм
говориться: говорится
год: лет год года
годиться: годится
гоетия: гоетия
голем: голем
гомункул: гомункул
гора: гор
горшок: горшки горшок
горючий: горючей
гот: готов
грааль: грааль
грехопадение: грехопадение
гримуар: гримуар
давать: дают
данте: данте
дантовский: дантовские
даосский: даосская
даровать: даруемое
датский: датская
два: два две двух двумя
двенадцать: двенадцати двенадцать
действовать: действовать действует
делание: делание
делать: делать
демон: демоны
демонология: демонология
день: дней
десятый: десятом
джозеф: джозеф
джордж: джорджу джордж
дигерируй: дигерируй
дистиллировать: дистиллируй
добавить: добавив добавьте
добела: добела
добыть: добыть
доварить: доварен
доза: дозах
должен: должно должен
доп: доп
дополнительный: дополнительные
допустить: допустить
дорогой: дорогим
доставать: достают
достигнуть: достигнуть
доступный: доступен
древо: древо
другой: другое другим другие других
дубовый: дубовой
дух: духи
духовный: духовное
душ: душа
дырка: дырки
е: е
енохианская: енохианская
ефрона: ефрона
жаба: жаб
жар: жара
женщина: женщины
животное: животные
животный: животной
жидкость: жидкости жидкостью жидкость
жизненный: жизненным жизненный
жизнь: жизни жизнь
жить: живший
заблуждаться: заблуждающийся
заглавный: заглавная
загореться: загорится
задача: задач
закон: закон
закрывать: закрывают
закрываться: закрываются
западный: западной западная
запись: запись
зарегистрировать: зарегистрированный
зарывать: зарывают
засохнуть: засохнет
затем: затем
заявление: заявление
звать: звали
зелигманн: зелигманн
земля: земли землю
змеиный: змеиные
змея: змей
знак: знак знаки
знание: знания
значение: значения
значительно: значительно
зодиак: зодиака
золото: золото золота
золотой: золотой
иерофант: иерофант
избранный: избранные
извлечение: извлечения
изд: изд
изумрудный: изумрудная
именоваться: именовался
ингредиент: ингредиента
иной: иные иной
инструмент: инструменты инструментом
исида: исида
исключительно: исключительно
искусство: искусства
испанский: испанское
использование: использования
использовать: использующие используют
исследование: исследований
история: история
источник: источник
исцелять: исцелять
июнь: июня
каббала: каббала
кадмон: кадмон
кадуцей: кадуцей
каждый: каждый
камедеобразное: камедеобразное
каменный: каменные
камень: камень камнем камне камня
капля: капли
карбины: карбины
касавин: касавин
каталанский: каталанская
каталог: каталогах
категория: категории
киммерийский: киммерийские
кипеть: кипеть
кипятить: кипятите
кислый: кислым
классический: классические
клеопатра: клеопатра
книга: книги книге
код: код
кодекс: кодекс
комедия: комедия комедии
коми: коми
комната: комната
конец: концов конец конца
конфиденциальность: конфиденциальности
концентрация: концентрациях
концепция: концепции
кора: коры
корма: корма
кормить: кормят
королев: королевы
король: короля
короткий: короткий
корпус: корпус
который: которое которой которые которых которая котором который
красный: красные красной красная красного
краткий: краткий
крепкий: крепким
крест: крест
кровь: крови кровь
круг: круге
круглый: круглые
крышка: крышки крышками
кук: куки
культура: культуре
л: л
лата: лат
лев: льва
левый: лев
легенда: легендах легенды
легко: легко
лекарство: лекарством
лимонный: лимонный
литература: литература
лицензия: лицензии
лишь: лишь
локид: локид
м: м
магистерий: магистерий
магистериум: магистериум
магистериума: магистериума
магический: магического
магия: магия магии
македонский: македонски
маленький: маленькими
малый: малых малого
мантика: мантика
мария: мария
мартинизм: мартинизм
материал: материал
медера: медера
медиафайлы: медиафайлы
медный: медные медными
медь: меди медь
менее: менее
меркурий: меркурий
место: место
месяц: месяцев
металл: металлов металлы
метаэлементов: метаэлементов
метод: методы
микрокосм: микрокосм
минута: минут
мировой: мировая
мистицизм: мистицизм
миф: миф
мифический: мифические
много: более
многообразие: многообразие
многообразный: многообразного
мобильный: мобильная
могучий: могучая
можно: можно
мой: мой
молодить: молодить
молодость: молодости
монах: монах
мочь: могут
мудрец: мудрецов
мужчина: мужчины
мы: нами
мышьяк: мышьяка
мягкий: мягкое
набиваться: набивается
навигация: навигации навигация
название: название
называть: называемый
наиболее: наиболее
накаливать: накаливай
накладывать: накладывают
наконец: наконец
напиток: напиток
например: например
наука: наука
находить: находивших
начинать: начинают
неблагородный: неблагородные
некий: некий
некоммерческий: некоммерческой
некромантия: некромантия
необходимый: необходимый
неоплатонизм: неоплатонизм
непосредственно: непосредственно
нередко: нередко
несовершенный: несовершенные
нигредо: нигредо
низкий: низшей
ничтожный: ничтожных
новый: новые
нож: ножом
норвежский: норвежская
носить: носил носившее
нотарикон: нотарикон
нумерология: нумерология
об: об
облагораживание: облагораживания
облагораживать: облагораживать
обладать: обладает обладать
обмазать: обмазанную
обработка: обработке
обсуждение: обсуждение
общество: общество
общий: общ
объяснять: объясняет
обычный: обычных
огонь: огонь огня
ограничиваться: ограничивалось
одержимость: одержимость
один: одной один
оказаться: окажется
окись: окиси
оккультизм: оккультизм оккультизма
окошко: окошками
олово: олово
они: им них
онлайн: онлайн
оно: оно
описание: описание
определить: определил
опустить: опустить
опытный: опытными
организация: организации
органик: органики
орел: орлов
освобождение: освобождение
основа: основы
основной: основные
оставить: оставьте
остужать: остужают
остыть: остынет
осуществление: осуществления
отв: отв
отверстие: отверстия
ответственность: ответственности
отдельно: отдельно
отдельный: отдельных
отказ: отказ
откладывать: откладывать
отличаться: отличаться
отредактировать: отредактирована
отрицательно: отрицательно
очень: очень
очистить: очищенной
ошибка: ошибке
падший: падшие
палингенезия: палингенезия
панацея: панацеей панацея
пантеон: пантеон
папирус: папирус
парижский: парижской
пентаграмма: пентаграмма
пентаграмматон: пентаграмматон
перейти: перейти
переть: при
персональный: персональные
песчаный: песчаной
петух: петухом
петухов: петухов
петушки: петушки
печать: печать печати
пикатрикс: пикатрикс
пиролиз: пиролизе
питаться: питаются
питьевой: питьевое
пифагореизм: пифагореизм
пифия: пифия
пища: пищей
план: план
планет: планеты
пластинка: пластинки
поведение: поведения
поверхность: поверхности
поглотить: поглощена
поддаваться: поддающееся
подробный: подробнее
пожертвовать: пожертвовать
пожирать: пожирающий
пожрать: пожрал
позволить: позволит
поиск: поисках поиск поиску
поймандр: поймандр
пока: пока
покрывало: покрывалом
покрыть: покроют
пол: полы пол
политиздат: политиздат
политик: политика
полностью: полностью
половина: половиной
положить: положи
полстакана: полстакана
полтора: полтора
получас: получаса
получать: получают
получаться: получается
получение: получение получению получения получении
получить: получишь получить
полчаса: полчаса
пользоваться: пользоваться
помещать: помещают
помощь: помощью
пора: пор
последний: последний
посол: после
постоянный: постоянная
потолок: потолок
поттер: поттер
похожий: похожие
появиться: появятся
появление: появление
появляться: появляющийся
править: править
правка: правка правки
практик: практики
превознесение: превознесение
превратиться: превратится
превращать: превращать
предложить: предложил
представиться: представились
прежде: прежде
препарат: препаратов
пресс: пресс
приготовить: приготовить
приготовление: приготовление
признак: признак
применение: применения
примечание: примечания
принять: приняв принятый
приобрести: приобретет
приписываться: приписывалась
природа: природы
пробить: пробиты
проблема: проблеме
проверить: проверенной
проверка: проверки
проверяться: проверялась
провести: проведена
продолжительный: продолжительной
продукт: продукт
проект: проектах
проекция: проекция
производная: производные
прокипятить: прокипятите
просмотр: просмотры
пространство: пространства
профетисса: профетисса
процесс: процессе
психический: психических
пятый: пятый
пять: пять
рабинович: рабинович
работа: работы работу
раз: раза
разбухнуть: разбухнет
разводить: разводят
разжигать: разжигают
разжиреть: разжиреют
различный: различной различные
размельчать: размельчают
разработчик: разработчики
разум: разум
райт: райт
раскалиться: раскалятся
распад: распада
раствор: раствор
растворяться: растворяются
растереть: растереть
реактив: реактив
реактор: реактора
ребис: ребис
редакция: ред
резать: резать
результат: результате
ректифицировать: ректифицируй
рептилия: рептилий
ресурс: ресурсы
реторта: реторту
рецепт: рецепт рецепте
рипли: рипли
ров: рве
розенкрейцерство: розенкрейцерство
розовый: розовой
ртутный: ртутно
ртуть: ртути ртуть
рубедо: рубедо
русский: русский
рыжий: рыжего
сажать: сажают
сажи: сажи
сакральный: сакральная
саламандра: саламандры
сам: самого
санкт-петербург: спб
сантиметр: см
сварить: сварен
сведение: сведения
свежий: свежей свежие
сверхъестественный: сверхъестественном
свинец: свинец свинца
свобода: свобода
свободный: свободной
свое: своим
свой: свой своей
свойство: свойством свойствам
связанный: связанные
связаться: свяжитесь
святой: святой
сгореть: сгорели
сделать: сделай
север: севере
секрет: секреты
серебро: серебро
серный: серная
серый: серы
сила: сила
сильф: сильфы
символ: символом символы
символизировать: символизировал
символика: символика
синархии: синархии
система: системе
скачать: скачать
сквозь: сквозь
скрижаль: скрижаль
скрытый: скрытые
следовать: следует
словарь: словари словарь
слой: слой
служебный: служебные
служить: служит служить
случай: случаях
случайный: случайная
смывать: смывают
смысл: смысле
снимать: снимайте снимают
снова: снова
собор: собора
собрать: собери
событие: события
содержание: содержание
содержимое: содержимое
соединение: соединения
создание: создания
создать: создать
созреть: созревших
солнце: солнце
соломон: соломона
соль: соли
сообщество: сообщество
сообщить: сообщить
сопоставление: сопоставления
сост: сост
состав: составу состава состав составе составом
сосуд: сосуде
сохранение: сохранением
спагирия: спагирия
спариваться: спариваться
спешить: спеша
спиритизм: спиритизм
спиритуализм: спиритуализм
спиритуалистический: спиритуалистическая
спирт: спиртом спирт
способ: способ
способность: способностью
справка: справка
среди: среди
средневековый: средневековых
средство: средство средству
српски: српски
ссылка: ссылка ссылками ссылки
ставить: ставят
стадий: стадии
стальной: стальной
старое: старым старое старых
статистика: статистика
статья: статья статье статьи
стен: стены
степень: степени
стихия: стихии
стокгольмский: стокгольмский
страница: страницы страница страницу странице
стремиться: стремились
существовать: существуют
считать: считает
считаться: считалось
сын: сын
сюда: сюда
т: т
таинственный: таинственных таинственное
также: также
таковой: таковых
такой: такой такими
тапхнутия: тапхнутия
таро: таро
тарология: тарология
текст: текст тексты
текущий: текущие текущая
телицын: телицын
телицына: телицына
тело: теле тело
тем: тем
темура: темура
тень: тени
теоретический: теоретические
теория: теория
теософия: теософия
теофиль: теофиль
тереть: три
термин: термина
тетраграмматон: тетраграмматон
тетрасомата: тетрасомата
теургия: теургия
течение: течение
тинктура: тинктура тинктуры тинктурой
товарный: товарный
тонкий: тонкие тонкий
тот: том тех те тот тому
точный: точнее
трактат: трактатах
трансмутация: трансмутации трансмутация трансмутацию
требовать: требует
треть: треть
трисмегист: трисмегист
труд: труды труде
туда: туда
тусклый: тусклым
тщательно: тщательно
убирать: убирают
увидеть: увидеть увидишь
узкий: узкими
узнать: узнать
указание: указанием
уксус: уксусом
ундина: ундины
универсальный: универсальным
унция: унции унцию
уроборос: уроборос
услать: ушли
условие: условий условия
усовершенствование: усовершенствования
успешный: успешного
участие: участие
участник: участниками
учение: учения
ф: ф
фальшивомонетчик: фальшивомонетчиков
февраль: февраля
феникс: феникс
физиогномика: физиогномика
философ: философов
философский: философский философского философском философской
флегма: флегму
флюид: флюид
фонд: фонд
форум: форум
фунт: фунта фунт
футарк: футарк
хвост: хвост хвосты
химера: химеры
хлеб: хлебом
холодный: холодной
хорошо: хорошо
христианский: христианская христианский
царить: царя
цвет: цвет
цель: целью цели
церемониальный: церемониальная
церковь: церковь
цитата: цитаты
цитировать: цитировать
цитринитас: цитринитас
цыпленок: цыплят цыплята
час: час
часто: часто
человек: человека людей
человеческий: человеческой
через: через
четыре: четыре
чинтамани: чинтамани
чистый: чистом
читать: читать
чтение: чтения
чтобы: чтобы
шесть: шесть
э: э
эзотеризм: эзотеризм
эзотерический: эзотерическом
экзорцизм: экзорцизм
экю: экю
элемент: элементов элемент
элементали: элементали
эликсир: эликсир эликсиром эликсира
эмблема: эмблемы
энциклопедический: энциклопедический
энциклопедия: энциклопедия энциклопедии
это: этом это этому
этот: этих эта
эфир: эфир
являться: является
ядерный: ядерного
язык: языках
яйцо: яйца яиц
ятрохимия: ятрохимия
