автор: автор авторе автором
авторство: авторства
азкабана: азкабана
актер: актеров
актриса: актриса
алфавит: алфавиту
альбус: альбус
альбусом: альбусом
англ: англ
английский: английский
апрель: апреля
архивировать: архивировано
барда: барда
бежать: бегущая
белизна: белизна
бестиарий: бестиарий бестиарии
библиографический: библиографических
библиотека: библиотеки
бидля: бидля
благодаря: благодаря
благотворительный: благотворительный
блумсбери: блумсбери
български: български
вакансия: вакансия
вальд: вальд
вальда: вальда
введение: введение
вд: вд
ведьма: ведьмы
версия: версия
вид: видов
визит: визита
викиданных: викиданных
викии: викии
викимедиа: викимедиа
википедии: википедии
википедия: википедия
вклад: вклад
власть: власти
вместе: вместе
внешний: внешние
возвращение: возвращение
войти: войти
волан: волан
волшебный: волшебные волшебный
восторженный: восторженного
время: время
все: всему
вселенная: вселенная вселенной
встречаться: встречается
второй: второй
выйти: вышло вышел
вымыслить: вымышленные вымышленный вымышленная
выпуск: выпуск
выпустить: выпущенная
выручка: выручка
гарри: гарри
геллерт: геллерт
гера: герой
гермиона: гермиона
героизм: героизме
герой: героях
гиппогриф: гиппогрифов
главное: главных
главный: главный главную
год: году годах лет годы года
грейнджер: грейнджер
грин: грин
дамблдор: дамблдор
дамблдора: дамблдора
дамблдором: дамблдором
дар: дары
дата: дата
дать: дано
два: два
де: де
действие: действия действие
действовать: действовать
декабрь: декабря
день: дней
дж: дж
джоан: джоан
дилогия: дилогия
дисциплина: дисциплине
дитя: дитя
док: док
домашние: домашних
дополнительный: дополнительные
дорсете: дорсете
достаться: досталась
доступный: доступен
драко: драко
древность: древности
другой: другие других
дурмстранг: дурмстранг
дурной: дурная
жанр: жанр
жена: женой
женский: женскую
животное: животным
жмырами: жмырами
заглавный: заглавная
заниматься: занимался
запись: запись
запрет: запрет
зарегистрировать: зарегистрированный
затем: затем
заявление: заявление
зверь: зверь зверей звери
зло: зла
знак: знак
зов: зов
зоолог: зоологом
зоология: зоологии
игра: игра игры
избранный: избранные
известно: известно
известный: известным
издатель: издатель
издательство: издательстве
издать: издан
икабог: икабог
имя: имена
инструмент: инструменты
интерес: интереса
информация: информация
использование: использования
история: история
источник: источник
июнь: июня
йорк: йорке
камень: камень
картина: картина
карточный: карточная
каталог: каталогах
категория: категории категория
квиддич: квиддич
квиддичу: квиддичу
киностудия: киностудия
классификация: классификация
книга: книги книгой книге книга
код: код
кодекс: кодекс
коллекционный: коллекционная
комната: комната
конструктор: конструктор
континент: континентам
контроль: контроля
конфиденциальность: конфиденциальности
копия: копия
корморане: корморане
короткий: короткие короткий
который: которой которого
кровь: кровь
кубок: кубок
кук: куки
кукушка: кукушки
курс: курса
кэтрин: кэтрин
лахути: лахути
лицензия: лицензии
лишение: лишениях
локация: локации
магический: магической магических магическим магическими
магия: магия магии
маглов: маглов
маглы: маглы
майя: майя
макгонагалл: макгонагалл
малфой: малфой
материал: материал
мать: матери
махаон: махаон
мерлина: мерлина
место: места
миллион: млн
минерва: минерва
министерство: министерством министерство министерстве
мир: мира миру мир
миссис: миссис
многие: многих
мобильный: мобильная
могила: могила
можно: можно
морт: морт
мочь: могут
музыка: музыка
мы: нами
наблюденье: наблюдений
навигация: навигации навигация
над: над
назойливый: назойливых
найти: найдена найденных
написать: написанная написано написан написанной
направить: направлены
например: например
находиться: находится
наш: наших
невероятный: невероятным
недостоверный: недостоверный
некоммерческий: некоммерческой
неполный: неполный
никогда: никогда
новый: новые
норрис: норрис
носитель: носитель
ноябрь: ноября
нью: нью
ньют: ньют
ньютом: ньютом
об: об
обитание: обитания
обитать: обитают
обложка: обложке
оборотень: оборотней
обратный: обратным
обращение: обращения
обсуждение: обсуждение
обязательный: обязательным
огонь: огня
оказаться: оказалась
около: около
окончить: окончил
они: них ними
онлайн: онлайн
опасный: опасных
описание: описание
описать: описано описана
определение: определение
организация: организации
орден: ордена орден
оригинал: оригинала оригинал
основной: основная
особенность: особенностью
оставить: оставленные
ответственность: ответственности
отдел: отделе
отдельный: отдельных отдельные
отказ: отказ
отличие: отличия
отредактировать: отредактирована
отряд: отряд
отсчет: отсчетом
официально: официально
оффе: оффе
ошибка: ошибке
парк: парк
пародия: пародии
пенсия: пенсию
первое: первого
первый: первый
переводчик: переводчик
перейти: перейти
персонаж: персонажи
персональный: персональные
печать: печати
поведение: поведения
поддержка: поддержке
подробный: подробнее
пожертвовать: пожертвовать
пожиратель: пожиратели
поздний: позже
поиск: поиск поиску
политик: политика политике
полтергейст: полтергейстах
полукровка: полукровка
получить: получил получить
пометка: пометки
понятие: понятиям
популяция: популяций
порпентиной: порпентиной
портал: портал
поскольку: поскольку
последний: последний
пособие: пособием
постоянный: постоянная
поттер: поттер поттера поттеру поттере
править: править
правка: правки
предмет: предметы
представиться: представились
предыдущий: предыдущая
предыстория: предыстория
премьер: премьеры премьера
преступление: преступления
прибыть: прибыли
привести: приведена
примечание: примечания
примечательный: примечательной
принадлежать: принадлежащей
принц: принц
принять: принятая
продажа: продажи
продолжение: продолжение
проект: проектах проекта
произведение: произведения
производство: производство
происходить: происходит
прокат: прокате
проклясть: проклятое
просмотр: просмотры
пространство: пространства
прочий: прочее
псевдоним: псевдонимом
путеводитель: путеводитель
путешествие: путешествий
работа: работу
работать: работал
разворачиваться: разворачиваются
различный: различных
размножение: размножение
разработчик: разработчики
ранее: ранее
распределять: распределяющая
рассказ: рассказы
рассмотреть: рассмотрена
регулирование: регулирования
редмэйн: редмэйн
реестр: реестра
религиозный: религиозные
ресурс: ресурсы
родиться: родился
рождественский: рождественский
роль: роль
роман: романов романы
рон: роном рон
росмэн: росмэн
роулинг: роулинг
рубеус: рубеус
русский: русский
русый: рус
ручной: ручными
саламандер: саламандер
саламандером: саламандером
сам: самой
сантиметр: см
саундтрек: саундтрек
сведение: сведения
свежий: свежие
свободный: свободной
свой: своей
свыше: свыше
связанный: связанные
связаться: свяжитесь
северус: северус
секция: секции
селекционер: селекционера
сердце: сердце
сериал: сериал
серия: серии серию серия
система: системе
сказка: сказки
скачать: скачать
скрывать: скрывала
следующий: следующая
словарь: словари
служба: службе
служебный: служебные
случай: случаях
случайный: случайная
смертельный: смертельная
смерть: смерти
снегг: снегг
снять: снимет
собрать: собрав собрана
собственный: собственного
событие: события
согласно: согласно
содержание: содержание
содержаться: содержащаяся
создание: созданием
создать: создать
сокрытие: сокрытия
сообщество: сообщество
сообщить: сообщить
составить: составила
состояться: состоялась
сохранение: сохранением
спина: спин
список: список
спора: споры
справка: справка
српски: српски
српскохрватски: српскохрватски
ссылка: ссылка ссылки
статистика: статистика
стать: стал стало
статья: статья статьи
степень: степени
стерлинг: стерлингов
страйке: страйке
страница: страницы страница страницу страниц странице
страничка: страничка
студент: студентов
существо: существо существа существами
сценарий: сценарий
счесть: счесть
сша: сша
сыграть: сыграл
сын: сыном
сюда: сюда
сюжет: сюжету
тайный: тайная тайны
также: также
татарча: татарча
тварь: твари
текст: текст
текущий: текущие
тематический: тематический
технически: технически
течение: течение
тизер: тизер
тина: тины
товарный: товарный
тот: тот
трейлер: трейлер
три: тремя
удостоить: удостоен
узник: узник
уизли: уизли
уйти: уйдя
указание: указанием
указать: указанный указаны
уотерстон: уотерстон
урок: уроки
условие: условий условия
успешный: успешной
уход: уход
участие: участие
учебник: учебником
учебный: учебным
факт: факт
фан: фан
фантастический: фантастические фантастический фантастическое
феникс: феникса
философский: философский
фильм: фильм фильме фильмов фильма фильмы
фонд: фонд
форум: форум
фунт: фунтов
хагрид: хагрид
хобби: хобби
хогвартс: хогвартс
хогвартса: хогвартса
цикл: цикл
цитировать: цитировать
чемпионат: чемпионат
чернильный: чернильно
читать: читать
чуть: чуть
шармбатон: шармбатон
шелкопряд: шелкопряд
шляпа: шляпа
шотландия: шотландии
эдди: эдди
экранизация: экранизация
экспериментальный: экспериментальное
элемент: элемент
эльф: эльфов
энциклопедия: энциклопедия энциклопедии
это: это
этот: этой эта
являться: является являются
язык: язык языках
