аватар: аватар
август: августа
автор: автор
авторство: авторства
азад: азад
азкабана: азкабана
айзекс: айзекс
айнесон: айнесон
актриса: актриса
аладдин: аладдин
алан: алан
аластор: аластор
александер: александер
александр: александра александр
алекто: алекто
алфавит: алфавиту
альберт: альберт
альбус: альбус
альфред: альфред
амбридж: амбридж
америка: америке
амикус: амикус
англ: англ
английский: английский английское английском
анимированную: анимированную
анна: анна
антонин: антонин
арбен: арбен
арестовывать: арестовывая
артур: артур
архивировать: архивировано
архивный: архивная
ассоциация: ассоциация
афшан: афшан
байрактарай: байрактарай
балл: баллов
барда: барда
баррон: баррон
батильда: батильда
батильды: батильды
бауэр: бауэр
беларуская: беларуская
белла: белл
беллатриса: беллатриса
бен: бен
бербидж: бербидж
берег: берега
бессмертие: бессмертия
библиографический: библиографических
бидля: бидля
билл: билл
бирн: бирн
битва: битве
блейз: блейз
близкий: ближе
бодрый: бодрой
боевик: боевик
боль: боли
больший: большая большую
большой: большой
бонни: бонни
бонэм: бонэм
бояться: боялись
брат: братьях
браун: браун
брендан: брендан
бросить: бросила
бруствер: бруствер
будущее: будущего будущее
бузинный: бузинную
български: български
быть: будут были
бэгшот: бэгшот
бюджет: бюджет
важный: важную
вальд: вальд
вальда: вальда
введение: введением
вд: вд
ведьма: ведьмы
вейн: вейн
великобритания: великобритания великобритании
вернон: вернон
вернуться: вернулся
версия: версия версии
взрослый: взрослый
виграмом: виграмом
визуальный: визуальные
викиданных: викиданных
викимедиа: викимедиа
викиновости: викиновости
википедии: википедии
википедия: википедия
викисклад: викисклад
викискладе: викискладе
викицитатник: викицитатник
викицитатнике: викицитатнике
виккери: виккери
вклад: вклад
включать: включала
включение: включении
власть: власти власть
внешний: внешние
вовлечь: вовлечена
возвращение: возвращение
возглавлять: возглавляли
возможность: возможность возможностью
война: войны война
войти: войти
волан: волан
волшебник: волшебников
волшебный: волшебные волшебный
воспользоваться: воспользоваться
враг: врагов
временить: времени
время: временем
все: всех
вскрывать: вскрывает
вспыхнуть: вспыхнет
входить: входили
выбирать: выбираем
выбор: выбор
выжить: выжил
выкапывать: выкапывает
выполнение: выполнению
выполнить: выполнить
выпускать: выпускает
выпустить: выпущен
высокий: высшей высшую
выход: выхода
выходной: выходные
гай: гай
галактика: галактики
гарри: гарри
геллерт: геллерт
генри: генри
гермиона: гермиона
героизм: героизме
герой: герои
гиббс: гиббс
главное: главные главных
глаз: глаз
глисон: глисон
говорить: говоря
год: лет год годы года
гойл: гойл
голодный: голодные
голос: голос
гость: гости гостям
готовить: готовили
грегор: грегорович
грегори: грегори
грейнджер: грейнджер
грин: грин
гринт: гринт
гриффитс: гриффитс
гробница: гробницу
грозный: грозный
грюм: грюм
гэмбон: гэмбон
дадли: дадли
дамблдор: дамблдор
дамблдора: дамблдора
дар: даров дарах дары
дата: дата даты
дать: дать
два: две двух
де: де
девон: девон
дейв: дейв
действовать: действующие действовать
декабрь: декабря
декорация: декорации декораций
делакур: делакур
день: дней дня дни
деспла: деспла
деть: день
дж: дж
джейми: джейми
джеймс: джеймс
джейни: джейни
джейсон: джейсон
джеральдин: джеральдин
джесси: джесси
джинни: джинни
джоан: джоан
джон: джон джона джоном
джонс: джонс
джордж: джордж
джорджина: джорджина
джошуа: джошуа
джули: джули
дизайн: дизайна дизайн
дизайнер: дизайнером дизайнер
дилогия: дилогия
дина: дин
дистрибьютор: дистрибьютор
дитя: дитя
длительность: длительность
добби: добби
добыча: добыча
довольный: довольно
догадываться: догадывается
дож: дож
дойла: дойла
док: док
долгий: долго
долгопупс: долгопупс
должен: должны
доллар: долларов
долорес: долорес
долохов: долохов
дома: дома
домовик: домовика
донал: донал
дополнительный: дополнительные
дорогой: дороги
доставить: доставить
достигать: достигая
доступный: доступен
драко: драко
драма: драма драмы
древность: древности
друг: друг друзей друга
другой: другой другие других
дружба: дружбу
дуглас: дуглас
дурмстранг: дурмстранг
дурсль: дурсль
дымовой: дымовые
дымчатый: дымчатым
дэвид: дэвида дэвид
дэвис: дэвис
дэниел: дэниел
дэниэл: дэниэл
ева: ева
единственный: единственная
жанр: жанры
желанный: желанную
женщина: женщина
живой: живым
жидкий: жидким
забини: забини
забирать: забирает
забытый: забытой
загадка: загадок
заглавный: заглавная
задание: задания
заключительный: заключительной
закончить: закончил
закончиться: закончилась закончились
занять: занять
запись: запись
запугивать: запугивая
зарегистрировать: зарегистрированный
захватить: захватил
захватывать: захватывающей
захоронение: захоронения
защита: защиты
заявить: заявил
заявление: заявление
зверь: звери
знак: знак
значение: значения
значительно: значительно
иванс: иванс
игра: игра игры
идея: идея идею
изабелла: изабелла
избранный: избранные избранный
икс: икс
имельда: имельда
империя: империя
инструмент: инструменты
интервью: интервью
интернет: интернет
исп: исп
исполнитель: исполнители
исполнительный: исполнительным
использование: использовании использования использованием
использовать: использовал использовать использующие
использоваться: использовалась
истец: истец
история: история истории
источник: источники источник
июль: июля
июнь: июня
йейтс: йейтс
йейтса: йейтса
йена: йен
какой: каким
камень: камень
каро: каро
картер: картер
картина: картину
карточный: карточная
кассовый: кассовые кассовых
каталог: каталог каталогах
категория: категории
каф: кафе
квиддич: квиддич
квиддичу: квиддичу
кейв: кейв
келли: келли
кикимер: кикимер
кингсли: кингсли
кинематограф: кинематографа
кинжал: кинжал
киноафиши: киноафиши
кинокомпания: кинокомпании
кинокритик: кинокритиков
кинопремия: кинопремия
класть: кладут
клеманс: клеманс
кловис: кловис
кловисом: кловисом
клубок: клубок
книга: книги книгу
код: код
кодекс: кодекс
коко: коко
коллекционный: коллекционная
коллекция: коллекции
колтрейн: колтрейн
коляска: коляской
команда: команду
комната: комната
компания: компания
композитор: композитор
конец: конца
конрад: конрад
конструктор: конструктор
контакт: контакте
контролировать: контролируют
конфиденциальность: конфиденциальности
копирование: копировании
копия: копия
корбан: корбан
кордис: кордис
кормак: кормак
короткий: короткие короткий
костюм: костюмов костюмы
который: которое которому которой которую которые которая котором который
красавица: красавица
красный: красной
крейг: крейг
крестражи: крестражи
кроткотт: кроткотт
крэйг: крэйг
крюкохват: крюкохват
ксенофилиус: ксенофилиус
ксенофилиуса: ксенофилиуса
кубок: кубок
кук: куки
кыргызча: кыргызча
кэмпбелл: кэмпбелл
кэролин: кэролин
кэрроу: кэрроу
кэти: кэти
ла: ла
лабиринт: лабиринт
лаванда: лаванда
лавгуд: лавгуд
лавгуда: лавгуда
ларусса: ларусса
лафлэнд: лафлэнд
легенда: легенда легендой
леджено: леджено
леонидас: леонидас
лери: лери
лес: лесу леса
лесной: лесные
лестрейндж: лестрейндж
лететь: летящим летели
лето: летом лето
лианный: лианна
лили: лили
линден: линден
линч: линч
лионелем: лионелем
лицензия: лицензии
лицо: лицо лица
лишение: лишениях
логотип: логотип
локация: локации
лондон: лондоне
лорд: лорд
лоуглан: лоуглан
луи: луи
лучино: лучино
льюис: льюис
льюнг: льюнг
любой: любой
люпин: люпин
люциус: люциус
магический: магических
магия: магия магии
маглы: маглы
майкл: майкл
макберни: макберни
маккрори: маккрори
маккуина: маккуина
маклагген: маклагген
максим: максим
маленький: маленьком
маллан: маллан
малфой: малфой
мальчик: мальчиком
марк: марк
марта: марта
материал: материал
мая: мая
медиафайлы: медиафайлы
международный: международного
меллинг: меллинг
мера: мере
место: местах места местом месту месте
месть: месть
миллион: миллионов млн
мина: мин
министерство: министерства министерство министерству
минувший: минувшего
минь: мини
мир: мира мир
мировой: мировая
миссис: миссис
миссия: миссию
мистер: мистер
мишель: мишель
многие: многих
много: много
мобильный: мобильная
могила: могилу
могущество: могущества
модуль: модулем
молли: молли
молния: молнию
молодость: молодости
момент: моментах момент
монгол: монгол
монстр: монстра
монтаж: монтажа
моран: моран
морт: морт
морта: морта
мортом: мортом
морту: морту
мотоцикл: мотоцикл
мочь: можете могут
мститель: мститель
музыка: музыки музыкой музыку музыка
муфалда: муфалда
мы: нами нас
мэтилок: мэтилок
мэттью: мэттью
мюриэль: мюриэль
мюррей: мюррей
навигация: навигации навигация
награда: награды
над: над
надежда: надежда
название: названия название
назвать: назвал
наземникус: наземникус
назойливый: назойливых
наиболее: наиболее
найджел: найджел
найи: найи
найти: найти
нападение: нападения
написать: написал
нарцисс: нарцисса
настоящее: настоящие
настроение: настроению
наталия: наталия
научный: научная научно
находиться: находятся
начаться: началась начались
наш: наших
небо: небо
невилл: невилл
негативный: негативно
недостаточно: недостаточно
недостоверный: недостоверный
нежданный: нежданное
некоммерческий: некоммерческой
немного: немного
неопр: неопр
неполный: неполный
никнуть: ник
никогда: никогда
николас: николаса
нимфадора: нимфадора
новолуние: новолуние
новый: нового новые
номинирован: номинирован
нора: норы норе
норрис: норрис
нос: носа
ностальгический: ностальгическими
ноябрь: ноября
об: об
обвинить: обвинили
обзор: обзоров
обитание: обитания
обитать: обитают
образ: образом
обращение: обращения
обсудить: обсудив
обсуждение: обсуждение
общий: общие общая
огонь: огня
огорчать: огорчало
один: одна одном
одновременно: одновременно
озеро: озера
оказаться: окажется
окружать: окружающей
окружение: окружения
октябрь: октября
оливер: оливер
олимпий: олимпия
олливандер: олливандер
они: им них
оно: оно
опасность: опасности
опасный: опасных опасен опасным
оператор: оператор
описание: описание
опытный: опытными
организация: организации
орден: орден
оригинал: оригинала
оркестр: оркестр оркестром
оскар: оскар
основа: основе
основное: основном
основной: основные основную основная
особо: особо
оставаться: остаются
остальное: остальных
остров: острове
ответственность: ответственности
отдельный: отдельных отдельные
отзыв: отзывы
отказ: отказ
отличаться: отличаться
относительно: относительно
отправляться: отправляются
отражать: отражающими
отреагировать: отреагировал
отредактировать: отредактирована
отряд: отряд
официальный: официальный
официантка: официантка
оценить: оценила
ошибка: ошибке
падма: падма
палочка: палочку
пантера: пантера
параметр: параметра
парвати: парвати
парк: парк
паркинсон: паркинсон
пародия: пародии
парселтанг: парселтанг
патил: патил
патрик: патрика
патронуса: патронуса
пембрукшире: пембрукшире
первое: первые первыми
первый: первой первая первый
перейти: перейти
перемещаться: перемещаются
перенаправить: перенаправлено
пересмешница: пересмешница
переступить: переступил
переть: при
перечитать: перечитав
персонаж: персонажи персонажей
персонал: персонал
персональный: персональные
петтигрю: петтигрю
петунья: петунья
печать: печати
пий: пий
пиклз: пиклз
писать: пишу
питер: питер
пламя: пламя
платье: платья платьем платье
поведение: поведения
повсюду: повсюду
подобный: подобного
подробный: подробнее
подходить: подходит
пожертвовать: пожертвовать
пожиратель: пожирателями пожирателей пожиратели
позволить: позволит позволило
поиск: поиск поиску
пока: пока
показ: показа
показать: покажут
политик: политика политике
полнометражный: полнометражных
положительный: положительных положительные
полтергейст: полтергейстах
полукровка: полукровка
полумна: полумна
получить: получил получить
порог: порог
портал: портал
посадка: посадке
поскольку: поскольку
последний: последняя последний последних последней
посол: после
постановщик: постановщик
постоянно: постоянно
постоянный: постоянная
построить: построили
потеря: потерю
поттер: поттер поттера поттере
поттерианы: поттерианы
поуп: поуп
похоронить: похоронить
почтить: почти
поэзи: поэзи
поэтому: поэтому
правда: правдой
править: править
правка: правки
праздник: праздников
превратить: превратили
превратиться: превратился
превысить: превысили
предложить: предложена предложено
предмет: предметы
предопределить: предопределено
представить: представить
представиться: представились
предстоять: предстоит
предыдущий: предыдущих предыдущий
предыстория: предыстория
прежний: прежнему
премия: премия премию
премьер: премьере премьер премьера
преподаватель: преподавателей
прерывать: прерывает
преследовать: преследуют
преступление: преступления
призрак: призраки
приключенческий: приключенческий
примечание: примечания
принц: принц
присутствие: присутствием
присутствовать: присутствовать
причина: причине
проблема: проблемы
пробуждение: пробуждение
проверить: проверенной
проверка: проверки
проверяться: проверялась
проводить: проводили
продавец: продавцы
продюсер: продюсером продюсер продюсеры
проект: проектах
произвести: произвела
производство: производство
пройти: прошла
проклясть: проклятое
прокомментировать: прокомментировал
просмотр: просмотры
пространство: пространства
противостояние: противостояние
противостоять: противостоять
профессор: профессора
проходить: проходили
прочий: прочее
прошлый: прошлом прошлое
пустошь: пустошь
путеводитель: путеводитель
путешествие: путешествие
путешествовать: путешествовали
путь: путь пути
пыль: пыль
пытаться: пытается
пэнси: пэнси
работа: работы работа работу
работать: работая работал
работник: работники
рада: раде
разделить: разделить
разлучить: разлучить
разматывать: разматывает
разработать: разработаны
разработчик: разработчики
разрушить: разрушить
разыскивать: разыскиваемого
райалл: райалл
райт: райт
ральф: ральф
ранкорн: ранкорн
распределять: распределяющая
рассвет: рассвет
рассказ: рассказы
рассчитывать: рассчитывать
расширение: расширение
расширять: расширяя
ребята: ребят
реджинальд: реджинальд
религиозный: религиозные
релиз: релиз
ресурс: ресурсы
рецензия: рецензия рецензий
решающий: решающей
ржаветь: ржавеющий
рика: рик
рикман: рикман
римус: римус
рискованный: рискованное
рисунок: рис
ричард: ричард
робби: робби
род: род
родри: родри
родственный: родственных
роль: роль ролях
роман: романов романа
ромильда: ромильда
рон: рон
роули: роули
роулинг: роулинг
роулинс: роулинс
рубеус: рубеус
рука: рук руках
руководитель: руководителем
руководить: руководящим
руководство: руководства
руперт: руперт
русский: русский
русый: рус
руфус: руфус
рэдклифф: рэдклифф
рэйф: рэйф
сага: сага
саймон: саймон
сайт: сайт сайты
сам: самого сами
самый: самую самых
сантиметр: см
саундтрек: саундтрека саундтрек
сбор: сборы
свадебный: свадебным
свадьба: свадьбу
сведение: сведения
свежий: свежие
свободный: свободной
связанный: связанные
связаться: свяжитесь
связывать: связывающую
сделать: сделали сделать сделаю
северный: северной
северус: северус
седьмой: седьмой
семейство: семейство
сентябрь: сентябре сентября
сериал: сериал
серия: серии серию серия
серра: серра
сивый: сивый
сиквелы: сиквелы
сила: силы
симус: симус
система: системе
ситуация: ситуации
ситхов: ситхов
сказать: сказала сказал
сказка: сказки сказку сказкой
сказочный: сказочную
скарлетт: скарлетт
скачать: скачать
скримджер: скримджер
скрытый: скрытые
следующий: следующий
словарь: словари
служебный: служебные
случай: случаях
случайный: случайная
смауга: смауга
смерть: смерть смерти
смотреть: смотрит
смочь: сможет
сначала: сначала
снегг: снегг
снять: снят снятые
событие: события
совершенно: совершенно
согласиться: согласился
содержание: содержание
создание: создания созданию создание
создать: создала создал создали создать
сойка: сойка
сомервилль: сомервилль
сообщество: сообщество
сообщить: сообщить
соответствовать: соответствуют соответствовать
составить: составили составленную
состояние: состоянием
софи: софи
сохранение: сохранением
сочинение: сочинении
спецэффект: спецэффектов
список: списке список
сполл: сполл
спора: споры
справка: справка
спродюсированные: спродюсированные
среда: среды
српски: српски
српскохрватски: српскохрватски
ссылка: ссылка ссылками ссылки ссылкой
стадий: стадии
сталкиваться: сталкивается
становиться: становится
старость: старости
старый: старой
статистика: статистика
стать: стал
статья: статья статьи
стефан: стефан
стив: стивом стив
стонтон: стонтон
страж: стражи
страна: странах страны
страница: страницы страница страницу странице
стремиться: стремился стремятся стремится
стренкс: стренкс
строить: строили
строма: строма
строчок: строчку
струпьяр: струпьяр
студент: студенты
студия: студии
стюарт: стюарт
сумерки: сумерки
супервайзер: супервайзер
супервайзером: супервайзером
существо: существ существа
существовать: существуют
сцена: сцена сцен
сценарий: сценария
сценарист: сценаристом
сша: сша
сюда: сюда
сюжет: сюжет
сюзанна: сюзанн
тайна: тайн
тайный: тайная тайна тайные тайны
также: также
такой: такая
тарзан: тарзан
татарча: татарча
тварь: твари
текст: текст
текущий: текущие текущая
телевидение: телевидение
тем: тем
тема: тему тема темы
тематический: тематический тематические
тен: тена
тереть: три
термин: термина
терроризировать: терроризируя
тесный: тесном
тим: тимом
тимайм: тимайм
тимоти: тимоти
тичборн: тичборн
тоби: тоби
товарный: товарный
толстоватый: толстоватый
томас: томас
томпсон: томпсон
тон: тон
тонкс: тонкс
тора: тор
торфинн: торфинн
тот: том ту тех тот
тоус: тоус
точка: точки
трагический: трагический
требовать: требуют
три: тремя
трое: трое
туда: туда
тур: тур
тьюлис: тьюлис
убийство: убийство
уважительный: уважительной
удовольствие: удовольствием
узник: узник
уизли: уизли
уильям: уильям
уильямс: уильямсом уильямс уильямса
указание: указанием
указать: указан
уничтожить: уничтожить
уолперт: уолперт
уолтерс: уолтерс
уорик: уорик
уотсон: уотсон
упомянуть: упомянул
урок: уроки
условие: условий условия
устройство: устройств
уходить: уходит
участие: участие
участник: участниками
уэльс: уэльс
фавн: фавна
файнс: файнс
фантастический: фантастические
февраль: февраля
фелпс: фелпс
фелтон: фелтон
феникс: феникса
фенрир: фенрир
философский: философский
фильм: фильму фильм фильме фильмами фильмов фильмах фильма фильмы фильмом
финальный: финального
финниган: финниган
фиона: фиона
флетчер: флетчер
фонд: фонд
формат: форматах
форум: форум
фред: фред
фредди: фредди
фрэнсис: фрэнсис
фурор: фурор
фэйрли: фэйрли
фэнтези: фэнтези
хагрид: хагрид
хант: хант
харрис: харрис
хейман: хейман
хелен: хелен
хелена: хелена
хердман: хердман
хибон: хибон
хмелкирк: хмелкирк
хобби: хобби
хоббит: хоббит
хогвартс: хогвартс
хогвартса: хогвартса
хогвартсе: хогвартсе
хороший: лучший
хотеть: хотел хотела
хронометраж: хронометраж
художник: художник
хупера: хупера
хэйзел: хэйзел
хэллоуина: хэллоуина
цель: цель
ценный: ценная
цитата: цитаты
цитировать: цитировать
чанг: чанг
чарити: чарити
частить: части
часть: частью частей часть частях
чаща: чаще
чей: чей
человек: человека людей люди
чемпионат: чемпионат
честь: честью
чжоу: чжоу
чистый: чисто
читать: читать
чоудхури: чоудхури
чтобы: чтобы
чувство: чувство
чувствоваться: чувствовалось
чудо: чудо
чудовище: чудовище
шаблон: шаблоны
шарлотта: шарлотта
шармбатон: шармбатон
шаффер: шаффер
шербеджия: шербеджия
шефали: шефали
шляпа: шляпа
шон: шон
шоу: шоу
эванна: эванна
эдриан: эдриан
эдуард: эдуарду
экранизация: экранизации
элемент: элемент
элфиас: элфиас
эльф: эльфа
эмма: эмма
эмоциональный: эмоциональных
энди: энди
энох: энох
энциклопедия: энциклопедии
эпизод: эпизод
это: этом это этим
этот: эта эту
эффект: эффекты
ю: ю
язык: язык языки языках языке
яксли: яксли
январь: января
