авад: авада
август: августа
австралия: австралия
автор: автор
авторство: авторства
агрессивный: агрессивно
азад: азад
азкабан: азкабан
азкабана: азкабана
азкабане: азкабане
айзекс: айзекс
академия: академии
актриса: актриса
акцио: акцио
алан: алан
аластор: аластор
алисе: алисе
алфавит: алфавиту
альбус: альбус
альбусом: альбусом
альфред: альфред
амос: амос амоса
англ: англ
английский: английский английских
англия: англии
анимагом: анимагом
апрель: апреля апрель
аргус: аргус
арестовывать: арестовывают
артур: артуром артур
архив: архив
архивировать: архивировано
архивный: архивная
афшан: афшан
бал: бал балу
балл: баллом
барда: барда
бартемий: бартемий
барти: барти
башмак: башмак
бежать: бежит
беларуская: беларуская
белац: белац
белый: белый
берт: берта
библиографический: библиографических
бидля: бидля
билл: билл
благородство: благородство
близиться: близится
близкие: близкими
близнец: близнецами
блэк: блэк
блэком: блэком
болгария: болгарии болгарию
болеть: болеют
боль: боль
больший: большим большие больше
большой: большое
бомж: бомж
бонни: бонни
брайс: брайс
брайса: брайса
браско: браско
брендан: брендан
британский: британские британской
бросать: бросал
бросить: бросил
брэдли: брэдли
будить: будит
български: български
бывалый: бывалый
быстро: быстро
быстрый: побыстрее
быть: будут были
бэгмен: бэгмен
бэгмэн: бэгмэн
бюджет: бюджет
важный: важную важные
ванна: ванне
варить: варит
ведьма: ведьмах
великобритания: великобритания великобритании
венгерский: венгерская
верить: верит
вернуться: вернуться
верный: верного
версия: версия
веселиться: веселиться
вести: ведущего
вестник: вестник
весть: весть
ветвь: ветви
взобраться: взобравшись
взять: взять взяли
вид: виду виде
видеть: видит видя видел
визуальный: визуальные
викиданных: викиданных
викимедиа: викимедиа
викиновости: викиновости
википедии: википедии
википедия: википедия
викисклад: викисклад
викискладе: викискладе
викицитатник: викицитатник
викицитатнике: викицитатнике
виктор: виктор виктором
винки: винки
вино: вине
винсент: винсент
вклад: вклад
власть: власти
вместе: вместе
вмешиваться: вмешивается
вне: вне
внезапно: внезапно
внешний: внешние
вновь: вновь
вода: водой
возвращаться: возвращается
возвращение: возвращение возвращения возвращении
возглавлять: возглавлять
возникнуть: возникнет
возраст: возраста
возрастной: возрастное
возрождать: возрождает
возрождение: возрождение
войти: войти
волан: волан
волшебник: волшебников
волшебный: волшебные волшебном волшебный
вопрос: вопрос вопросом
ворваться: ворвавшиеся
воровать: ворует
воскрешение: воскрешение
воссоединяться: воссоединяются
враг: врага
временить: времени
временной: временному
время: время
все: всех всем
всеобщий: всеобщим
вспоминать: вспоминает
встать: встала
встреча: встречи
встречать: встречают
вступление: вступления
второе: вторым второе второго
входить: входят
выбирать: выбирает
выбрасывать: выбрасывает
выбрать: выбраны выбрал
выводить: выводит
выглядеть: выглядит
выдержать: выдержав
вызывать: вызывает
выйти: выйти вышел
вылетать: вылетает
вымыслить: вымышленной
вынуждать: вынуждает
выпить: выпить
выручать: выручает
высовывать: высовывает
высокий: высокие высокое
выстреливать: выстреливает
габриэль: габриэль
галлеонов: галлеонов
гарри: гарри
гермиона: гермиона гермионой гермионе гермиону
героизм: героизме
герой: герои
гибель: гибель
глава: главе
главное: главных главное
главный: главный
глисон: глисон
глумиться: глумится
глумление: глумлений
го: го
говорить: говорит
год: лет год годы года
гойл: гойл
голос: голос
голубой: голубой
горазд: гораздо
гостиная: гостиной
гостить: гостит
грандиозный: грандиозного
график: графики графика
грегори: грегори
грейнджер: грейнджер
гринвуд: гринвуд
гриндилоу: гриндилоу
гринт: гринт
гриффиндора: гриффиндора
гриффиндорцев: гриффиндорцев
группа: группе группы
грюм: грюм
грюма: грюма
грюму: грюму
гэмбон: гэмбон
гэри: гэри
давать: давал дают
дамблдор: дамблдор
дамблдора: дамблдора
дамблдором: дамблдором
дамблдору: дамблдору
дар: дары
дата: дата даты
два: два
двигаться: движется
де: де
девон: девон
девушка: девушек
действие: действие
действительно: действительно
действовать: действовать
декабрь: декабря
декорация: декорации
делакур: делакур
делать: делает
дело: делу
дементора: дементора
день: дней
держать: держащий
деталь: деталь детали
дж: дж
джарвис: джарвис
джейми: джейми
джеймс: джеймс
джейсон: джейсон
джеральдин: джеральдин
джефф: джефф
джинни: джинни
джоан: джоан
джон: джон
джонни: джонни
джордж: джордж джорджем
джоркинс: джоркинс
джошуа: джошуа
диалог: диалог
диггори: диггори
дилогия: дилогия
дина: дин
директор: директор
дистрибьютор: дистрибьютор
дитя: дитя
длительность: длительность
дно: дно
добавить: добавил
добавление: добавлении
добби: добби
добровольно: добровольно
догадливый: догадливее
дойл: дойл
дойлом: дойлом
док: док
долгопупс: долгопупс
долгопупсах: долгопупсах
должен: должны должен
дом: дом доме
домовой: домовой
домыть: домой
донни: донни
доплыть: доплыть
дополнительный: дополнительные
дорога: дороге
дорогой: дорогому дорого
доставить: доставленного
достигнуть: достигшие достигнуто
доступный: доступен
драко: драко
дракон: драконам драконом драконах
драма: драмы
древность: древности
друг: друзья друзьями
другой: другие других
думать: думать
дурмстранг: дурмстранг
дурмстранга: дурмстранга
дурмстрангцы: дурмстрангцы
дух: духи
дуэль: дуэль
дэвид: дэвид
дэвис: дэвис
дэниел: дэниел
единый: единое
жабра: жабры
жабросли: жабросли
жаброслях: жаброслях
жанр: жанры
железный: железной
жестокость: жестокости
живой: живой
забирать: забирает
забросить: заброшенный
заваривать: заваривает
заглавный: заглавная
задавать: задавая
задание: задание заданием задания
задача: задача
заканчиваться: заканчивается
заклинание: заклинанием заклинания заклинание
заклясть: заклятого
заклятие: заклятие заклятием
заколдовать: заколдовал
заколдовывать: заколдовывает
закончить: закончить
заменить: заменить заменил
замешательство: замешательством
замысел: замыслами
замять: замять
запад: запад
записка: записку
запись: запись записи
зарегистрировать: зарегистрированный
заседание: заседания
заставать: застают
заставлять: заставляют
затем: затем
заточение: заточении
затыкать: затыкает
захват: захват
захватывать: захватывают
защита: защиты
защищать: защищает
заявление: заявление
зверь: звери
звук: звука звуки
зеландия: зеландия
зелье: зелье зелья
злой: злейшего
змеиный: змеиному
знак: знак
знать: знает знают
значение: значения значение
ивена: ивена
игорь: игорь игоря
игра: игра игры
избранный: избранные
извиняться: извиняется
изгородь: изгороди
издание: издания
издеваться: издеваются
изначально: изначально
именно: именно
иметь: имел имеющие
имя: именем имя
ингредиент: ингредиенты
инструмент: инструменты
ирландец: ирландцев
ирландия: ирландии
искупаться: искупаться
искусство: искусств
исполнять: исполняющие
использование: использования
использовать: использованной использовать использующие
испуг: испуг
испытание: испытании испытание испытанию
история: историей история
источник: источник
итог: итоге
июль: июля
июнь: июня
кабинет: кабинет кабинета
каждый: каждой
какой: какие
камень: камень
камин: камин
канада: канаде канада
капля: капель
капюшон: капюшоном
каркаров: каркаров
каркарова: каркарова
картофельный: картофельных
карточный: карточная
каталог: каталог каталогах
категория: категории
качество: качестве
квадриквелы: квадриквелы
квиддич: квиддич
квиддича: квиддича
квиддичу: квиддичу
кедавра: кедавра
кинокомпания: кинокомпании
кинопрессы: кинопрессы
кинотеатр: кинотеатрах
кинофестиваль: кинофестивале
кладбище: кладбища кладбище
клеманс: клеманс
кловис: кловис
клуб: клуб
кляп: кляпом
книга: книг книги книгу книге книга
когтеврана: когтеврана
код: код
кодекс: кодекс
кокер: кокер
кокера: кокера
колдовской: колдовской
коллекционный: коллекционная
колтрейн: колтрейн
комната: комната
композитор: композитора композитор
композиция: композицию
компьютерный: компьютерной
конец: конце
конечный: конечном
конструктор: конструктор
конфета: конфет
конфиденциальность: конфиденциальности
копия: копия
корень: корни
корнелиус: корнелиус корнелиусом
королевство: королевства
короткий: короткие короткий
кос: косу
коснуться: коснуться
кость: кость кости
котелок: котелок
который: которое которой которую которого которые которых которая котором который
крам: крам
крама: крама
крамом: крамом
красный: красный красным
крауч: крауч
крауча: крауча
крауче: крауче
краучем: краучем
крик: крики
критик: критиков
кричать: кричит
кроваво: кроваво
кровь: крови кровь
кроме: кроме
круциатус: круциатус
круциатусом: круциатусом
крылатый: крылатый
крэбб: крэбб
крэйг: крэйг
кто: кого кому
кубок: кубка кубок кубке кубку
кук: куки
кыргызча: кыргызча
кэти: кэти
ла: ла
лабиринт: лабиринте лабиринт лабиринта
лагерь: лагерь
лакричный: лакричных
ларусса: ларусса
лейтмотив: лейтмотив
лес: лесу лес
лестрейндж: лестрейндж
лето: летом
лиза: лизы
ликование: ликования
лили: лили
линия: линий
листок: листок
лицензия: лицензии
лишение: лишениях
лишний: лишнего
лишь: лишь
ллойд: ллойд
ловец: ловец
ловушка: ловушек ловушками
локация: локации
лондон: лондоне
лорд: лорда лорд
лучить: луча
льюис: льюис
льюнг: льюнг
любитель: любителей
любовь: любовь
людо: людо
люциус: люциус
магический: магических магическим
магия: магия магии
магла: магла
маглы: маглы
мадам: мадам
майк: майк
майка: майка
майкл: майкл
макгонагалл: макгонагалл
макгонаггл: макгонаггл
македонский: македонски
максим: максим
маленький: поменьше
малфоем: малфоем
малфой: малфой
мальчик: мальчике мальчик
мантия: мантию
марджери: марджери
марк: марк
маска: маске
материал: материал материалом
матч: матч
медиафайлы: медиафайлы
международный: международном международных
мейсон: мейсон
мелкий: мелкую
менять: меняло
место: место места местом
меткий: метки
метла: метлу
метод: методы
мешать: мешают
миллион: млн
мина: мин
минерва: минерва
министерство: министерства министерство министерстве
министр: министр министру министром
миновать: минуя
мир: мира мир
миранда: миранда
мировой: мировая мировой
миртл: миртл
миссис: миссис
мистер: мистера мистер
младший: младшем младшего младший
многие: многие
множество: множество
мобильный: мобильная
могила: могилы могиле могилу
могильный: могильный могильному
можно: можно
молодой: молодому
момент: момент
мона: моны
монгол: монгол
морт: морт
морта: морта
мочь: могут
мракоборец: мракоборец
мракоборцах: мракоборцах
мраморный: мраморное
мужчина: мужчина
музыка: музыка
музыкант: музыканты музыкантов
мчаться: мчатся
мы: нами нас
мэгги: мэгги
мэттью: мэттью
мюррей: мюррей
набрасываться: набрасывается
навигация: навигации навигация
награда: награду награды
над: над
надгробие: надгробие
надежда: надежды
назад: назад
назойливый: назойливых
называть: называет
найти: найти
намекать: намекая
нападать: нападают нападает
написание: написания
напрямую: напрямую
нарцисс: нарцисса
насколько: насколько
наставник: наставники
настоящий: настоящий
настроение: настроение
наутро: наутро
находиться: находится находились
начинать: начинает
начинаться: начинается
наш: наших
неадекватный: неадекватно
невилл: невилл
невиллу: невиллу
недостоверный: недостоверный
недоумевать: недоумевает
нежелательный: нежелателен
незарегистрированный: незарегистрированным
незнакомец: незнакомцем
неизвестный: неизвестному неизвестный
некий: некоем некую
некоммерческий: некоммерческой
некоторые: некоторые
некоторый: некоторое
немного: немного
необходимо: необходимо
необъяснимый: необъяснимому
неожиданно: неожиданно
неопр: неопр
неоспоримо: неоспоримо
неполный: неполный
несколько: несколько
несмотря: несмотря
нестерпимый: нестерпимая
неудавшийся: неудавшейся
неуклюжий: неуклюжим
нечисть: нечисть
новый: новая новые новое
нож: ножа
номинация: номинация номинации
нора: норе
норрис: норрис
ночь: ночью
ноябрь: ноября
нравиться: нравится
нужно: нужно
нырнуть: нырнуть
ньюэлл: ньюэлл
ньюэлла: ньюэлла
об: об
оба: обоим
обвинять: обвиняет обвиняют
обещать: обещает
обижаться: обижается
обитание: обитания
обитать: обитают
облик: облик
обнаруживать: обнаруживает
обнаружить: обнаружил
оборотный: оборотное оборотного
образ: образов образом
образовать: образуя
обратный: обратно
обращаться: обращаясь
обращение: обращения
обсуждать: обсуждали
обсуждение: обсуждение
обучение: обучения
обходить: обходит
объединить: объединены
объявлять: объявляют объявляет
объявляться: объявляется
объяснять: объясняет
объясняться: объясняется
огонь: огня
ограничение: ограничение
ограниченность: ограниченности
огромный: огромной
одетый: одет
один: одну одна одном одного одному одно одним одни
однако: однако
одновременно: одновременно
одобрять: одобряют
озеро: озере озера
оказаться: оказался оказавшегося
оказываться: оказывается
октябрь: октября
окунаться: окунается
олдмен: олдмен
оливер: оливер
олимпий: олимпия
омут: омут омуте
он: нему
они: им них
оно: оно
опасно: опасно
опасный: опасных
оператор: оператор
описание: описание
описать: описал
оправдать: оправдан
организация: организации
орден: орден
оригинальный: оригинальная
оскар: оскар
основа: основе
основной: основная
особый: особые
оставлять: оставляя
остаться: осталась
отбрасывать: отбрасывает
отведать: отведать
ответ: ответ
ответственность: ответственности
отвечать: отвечает
отводить: отводит
отдавать: отдавал
отдать: отданная
отдельный: отдельных отдельные
отец: отца отцом отец
отзыв: отзывы
отказ: отказом отказа отказ
отказываться: отказывается
открытие: открытии
открыть: открыть
откуда: откуда
отличие: отличия
отойти: отойти
отправляться: отправляются
отредактировать: отредактирована
отрезать: отрезал
отрекаться: отрекается
отряд: отряд
отсутствовать: отсутствует отсутствуют
отчитывать: отчитывает
официальный: официальный
охранять: охраняемое
оценка: оценки
очень: очень
очередной: очередной
очистки: очистков
ошибка: ошибке ошибки
падма: падма
пак: пак
памятник: памятник памятнику памятников
память: памяти
парвати: парвати
парк: парк
пародия: пародии
партитура: партитуры партитур партитурой
патил: патил
патрик: патрик
паттинсон: паттинсон
первое: первых первом
первоначальный: первоначальная
первый: первый
перед: перед
перейти: перейти
перенести: перенести
переносить: переносит
переноситься: переносятся
перепонка: перепонки
переть: при
персия: персии
персонаж: персонажи персонажей
персонал: персонал
персональный: персональные
песнь: песни
песня: песню
песок: пески
петтигрю: петтигрю
печать: печати
пирогов: пирогов
питер: питер питеру питера
плавательный: плавательные
плакса: плакса
плащ: плащ
пленник: пленника пленников
плечевой: плечевая
плечо: плечи
плотный: плотного
плоть: плоти плоть
побаиваться: побаиваются
победа: победу победе победы
победитель: победитель победителем
побеждать: побеждает
поведение: поведения
повод: поводу
повышать: повышая
подбросить: подбросил
подвергнуть: подвергнут
подводной: подводную
поддерживать: поддерживали
поделиться: поделился
подлинный: подлинный
подождать: подождать
подробно: подробно
подробный: подробнее подробное
подручный: подручный
подсказать: подсказал
подсказка: подсказку подсказка
подсказывать: подсказывает
подумать: подумать подумав
поезд: поезде
пожертвовать: пожертвовать пожертвованная
пожиратель: пожирателя пожирателей пожиратели
поздний: позже
поздравление: поздравления
поиск: поиск поиску
показательный: показательную
показать: показан
показывать: показывает
пол: поле
политик: политика политике
полнометражный: полнометражных
положить: положенную
полтергейст: полтергейстах
полукровка: полукровка
получать: получал получают
получаться: получается
получить: получил получить
пользоваться: пользуясь
поместье: поместья
помешать: помешали
помощь: помощью помощь
понимать: понимает
понять: поняв понять
попадание: попадании
попадать: попадает
попасть: попало
попытка: попытки
поражать: поражает
портал: портал порталом
портить: портит
поручение: поручения
послание: послание
последний: последний последние последнем
последователь: последователем
посоветовать: посоветовал
посол: после
пост: пост
постановщик: постановщик постановщика
постоянный: постоянная
посчитать: посчитали
потрясти: потрясены
поттер: поттер поттера поттеру поттере
похороны: похороны
поцелуй: поцелую
почтить: почти
поэзи: поэзи
появиться: появился появившегося
появляться: появляются появляется
правда: правды
правило: правилами
править: править
правка: правки
пратт: пратт
прах: праха
превращать: превращая
предлагать: предлагает
предложить: предложив
предмет: предметы
предраг: предраг
представиться: представились
предупредить: предупредив предупредить
предыдущий: предыдущих предыдущей предыдущий
предыстория: предыстория
премия: премия премию
премьер: премьеры премьера
преподаватель: преподавателя преподаватели
преступление: преступлений
приватный: приватный
привести: привело привести
привидение: привидение
приводить: приводит
привязывать: привязывает
пригласить: пригласить приглашена приглашенных приглашены
приглашать: приглашает приглашают
приехать: приехавшая
призрак: призраки
приказ: приказу приказ
приключение: приключения приключениями приключение
приключенческий: приключенческий
прикрытие: прикрытия
применение: применение
примечание: примечания
принимать: принимает
принц: принц
принять: принять
приплыть: приплывет
припоминать: припоминая
прислать: пришли
приспешник: приспешники
притягивать: притягивает
прихватить: прихватив
прихвостень: прихвостне
причина: причинам
про: про
проблема: проблему
проведение: проведения
проверить: проверьте
прогулка: прогулки
продавщица: продавщица
продержаться: продержаться
продюсер: продюсерами продюсер
проект: проектах
прозвище: прозвищу
прозвучать: прозвучит
производство: производство
произношение: произношении
произойти: произошедшем произошла произошедшее
происходить: происходит
пройти: пройти
проклясть: проклятое
проклятие: проклятья проклятием
пропасть: пропавшем
просить: просит
просмотр: просмотр просмотры
просто: просто
пространство: пространства
просыпаться: просыпается
просьба: просьба
противник: противник
проходить: проходит
прохождение: прохождения
прочий: прочее
прочуять: прочую
проявить: проявленное
прямой: прямо
пугать: пугающих
путеводитель: путеводитель
путь: путь
пуффендуй: пуффендуй
пытать: пытает
пытаться: пытается
работа: работе работа
работать: работал работавший
раз: раза
разговор: разговор
размещаться: размещался
разный: разных
разоблачать: разоблачает
разорвать: разорвать
разоружать: разоружают
разработчик: разработчики
разрывать: разрывает
райт: райт
рамка: рамки
распределять: распределяющая
рассвет: рассвете
рассказ: рассказы
рассказывать: рассказывает рассказывают
расспрашивать: расспрашивает
расширение: расширение
расшифровать: расшифровать
ребенок: детям
ревность: ревности
реддла: реддла
рейтинг: рейтинг
религиозный: религиозные
релиз: релиз
ресурс: ресурсы
рецензия: рецензий
решать: решают решает
решаться: решается
решение: решение
решить: решили
рикман: рикман
рита: риту рита
ричардсон: ричардсон
робби: робби
роберт: роберт
роджер: роджер
родитель: родителей
родственный: родственных
рождество: рождество
розье: розье
рок: рок
роль: роль ролях роли
роман: романов романа
рон: роном рона рон
рот: рот
роул: роул
роулинг: роулинг
роулинс: роулинс
рубеус: рубеус
ругать: ругает
рука: руке руку
руквуда: руквуда
руперт: руперт
русалка: русалок русалки
русский: русский
рэдклифф: рэдклифф
рэйф: рэйф
садовник: садовника
сайкс: сайкс
сайт: сайте сайт сайты
сам: самого самих
самый: самый самые
сантиметр: см
саундтрек: саундтрека саундтрек
сбор: сборы
сборная: сборную сборной
свадьба: свадьбы
сведение: сведения
свежий: свежие
свести: сведены
свободный: свободной
сводить: сводить
свое: своего своим своими
свой: свой своей свою
связанный: связанные связанных связанными
связаться: свяжитесь
святочный: святочный
сделать: сделал
себя: собой
северус: северус
северуса: северуса
седрик: седрика седриком седрик седрику
секунда: секунд
селвей: селвей
семейство: семейство
семестр: семестр
семья: семьи
сентябрь: сентября
середина: середине
сериал: сериал
серия: серии серию серия
сестра: сестру
сжатие: сжатие
сидеть: сидит сидят
сила: силой силы
симус: симус
сириус: сириус сириусом
система: системе системах
ситуация: ситуацию ситуация
сказка: сказки
скачать: скачать
скачок: скачку
скелет: скелет
скитер: скитер
скорый: скорее
скрываться: скрывается
скрытый: скрытые
скрыть: скрыть
сладость: сладостей
следующий: следующем следующему следующий последующее следующего
словарь: словари
сложиться: сложившуюся
слуга: слуги слуг
служебный: служебные
случай: случаях
случайно: случайно
случайный: случайная
слушание: слушание
сменяться: сменяются
смерть: смерти
смит: смит
смотреть: смотрели
смотритель: смотрителя
смочь: смог
снегг: снегг
снегга: снегга
сниться: снится
сновидение: сновидениях
снять: снятые
собираться: собирался
собрать: собрав собрал
событие: события
советовать: советует советуют
согласие: согласия
согласно: согласно
согласный: согласен
содержание: содержание
содержаться: содержится
создание: создания
создать: создать
сокурсник: сокурсников
солист: солист
сомервилль: сомервилль
сон: сон сне снах
сообщать: сообщает
сообщаться: сообщалось
сообщество: сообщество
сообщить: сообщить
соответствие: соответствии
соратник: соратникам
состав: состав
составлять: составляет
состоять: состояла
состояться: состояться состоялась
состязание: состязания состязаний
сосуд: сосуд
сотрудник: сотрудники
сохранение: сохранением
спасать: спасает
спасти: спасти
список: список
спокойный: спокойно
сполл: сполл
спора: споры
спорить: спорят
справка: справка
спрашивать: спрашивая спрашивает
спросить: спросив спросил
среди: среди
средний: средним
српски: српски
српскохрватски: српскохрватски
ссылаться: ссылаясь
ссылка: ссылка ссылками ссылки
стажировка: стажировке
сталкиваться: сталкиваются
станислав: станислав
становиться: становятся становится
старое: старого старые
староста: старост
старшекурсник: старшекурсника
старший: старшего
старый: старый
статистика: статистика
статуя: статуя статую
стать: станет
статья: статья статьи
стен: стены
стив: стив
стихать: стихает
стоить: стоит
сторонник: сторонники
страна: странах страны
страница: страницы страница страницу странице
странный: странно странный
страшный: страшный страшную
строить: строя
струить: струя
студент: студенты
стычка: стычке
стюарт: стюарт
субстанция: субстанций
судья: судья
сундук: сундуке сундук
супруг: супругов
существо: существа
существовать: существуют
схватка: схватке
схлопываются: схлопываются
сцена: сцена сцен сцену сцены
сценарий: сценария
сценарист: сценаристами
считать: считает
сша: сша
сыворотка: сыворотку
сын: сына
сюда: сюда
сюжет: сюжет сюжета
сюжетный: сюжетных
тайный: тайная
также: также
такой: таким такие
танец: танец
текст: текст
текущий: текущие
тело: тела тело
тема: тема
тематический: тематический тематические
темный: темных
теннант: теннант
тереть: три
термин: термина
тесно: тесно
тимоти: тимоти
тисовый: тисовой
товарный: товарный
том: тома
томас: томас
торопливый: торопливым
тот: том тех те тот та
тотчас: тотчас
традиционный: традиционных
трезубец: трезубцами
третье: третьем
три: трех
труд: трудом
труп: труп
тур: тура тур
турнир: турнир турнира турнире
убивать: убивает
убийство: убийстве убийством убийство
убить: убил убей убить убит
уважение: уважение
увидеть: увидел увиденного увидев
уводить: уводит
уговаривать: уговаривать
уголок: уголке
угрожать: угрожать угрожают
угрюмо: угрюмо
уезжать: уезжают
ужас: ужасом
ужасно: ужасно
ужаснуться: ужаснувшись
ужасный: ужасные
узник: узник
уизли: уизли
уильямс: уильямс уильямса
уйти: уйти
указание: указания указанием
указать: указан
уклончивый: уклончиво
укоротить: укорочены
украсть: украсть
укусить: укусила
улица: улице
улыбка: улыбка
уорик: уорик
уотсон: уотсон
упоминать: упоминает
упоминаться: упоминается
употребление: употребления
управлять: управляя
упрашивать: упрашивает
упростить: упростить
урок: уроки
условие: условий условия
успешный: успешного
успокаивать: успокаивает
устраивать: устраивает
утверждать: утверждает
уходить: уходят
участвовать: участвовал участвовать
участие: участие
участник: участниками участникам участники участником участнику участников
учебный: учебный
ученик: ученики
уэйлетт: уэйлетт
фадж: фадж
фаджем: фаджем
файнс: файнс
факультет: факультета
фанатичный: фанатичным
фантастический: фантастические
февраль: февраля
фелпс: фелпс
фелтон: фелтон
феникс: феникса
филип: филип
филиус: филиус
философский: философский
филч: филч
фильм: фильм фильме фильмов фильмах фильма фильмы фильмом
финал: финала финалом
финниган: финниган
флитвик: флитвик
фонд: фонд
форум: форум
фред: фредом фред
фрэнк: фрэнке фрэнк фрэнка
фрэнсис: фрэнсис
фэнтези: фэнтези
фэнтезийный: фэнтезийный
хагрид: хагрид
хагридом: хагридом
хагриду: хагриду
харди: харди
хвалить: хвалит
хватать: хватает
хвост: хвост хвоста хвосту
хвосторога: хвосторога
хедвиги: хедвиги
хейман: хейман
хендерсон: хендерсон
хердман: хердман
хихикать: хихикая
хобби: хобби
хогвартс: хогвартс
хогвартса: хогвартса
хогвартсе: хогвартсе
холера: холеры
холм: холм
хорек: хорька
хороший: лучшие лучшая лучший хороший
хронометраж: хронометража
художник: художник художника
цвет: цвет
целый: целое
цепь: цепь
цитата: цитаты
цитировать: цитировать
чанг: чанг
чарли: чарли
час: час
часть: часть
человек: человек человеку
чемпионат: чемпионат чемпионата
через: через
четыре: четыре
четырнадцатилетнего: четырнадцатилетнего
чжоу: чжоу
число: числе
читать: читать
чоудхури: чоудхури
чтобы: чтобы
чуть: чуть
шармбатон: шармбатон
шармбатона: шармбатона
шармбатонцы: шармбатонцы
шефали: шефали
ширли: ширли
школа: школы школ
шляпа: шляпу шляпа
шрам: шраме шрам
эдриан: эдриан
экран: экран
экранизация: экранизация экранизации
экспеллиармус: экспеллиармус
элемент: элемент
эльф: эльф
эмма: эмма
энох: энох
энциклопедия: энциклопедии
эпизод: эпизод
эпизодический: эпизодические
эрик: эрик
это: этом это
этот: этих эта эту
эффект: эффекты
юноша: юноши
являться: являются
ядовито: ядовито
язык: язык языках
яйцо: яйцо яйце
якоб: якобы
январь: января
яневский: яневский
