август: августа августе
автокатастрофа: автокатастрофе
автор: автор авторов
авторитетный: авторитетные
авторский: авторских
авторство: авторства
агент: агент
азкабана: азкабана
алфавит: алфавиту
альбус: альбус
амер: амер
америка: америке
американизм: американизмов
американский: американскую американском американским
анализ: анализа
англ: англ
английский: английский
англоязычный: англоязычных
апрель: апреля
армия: армии
архивировать: архивировано
архивный: архивная
аукцион: аукционе
балл: баллы
банк: банк банка
бар: баре
барда: барда
барри: барри
басинский: басинский
бежать: бегущая
беларуская: беларуская
белизна: белизна
бессмертие: бессмертие
бессмертный: бессмертным
бестселлер: бестселлером
библиографический: библиографических
бидля: бидля
благодаря: благодаря
благоприятный: благоприятными
близкие: близких
блумсбери: блумсбери
богатый: богатой
болеть: болит
боль: болью
больничный: больничном
больший: больше
большинство: большинство
брат: брата брату
британский: британских британской британского
брожение: брожение
букля: буклей
бумага: бумагу
български: български
быть: были
важный: важной
вакансия: вакансия
вдохновляться: вдохновлялась
великий: величайших
великобритания: великобритания великобритании
вернуться: вернуться
версия: версия версии
весить: весь
вето: вето
вечер: вечер
взять: взяв
вид: виде
видеть: видит
визит: визита
викиданных: викиданных
викимедиа: викимедиа
википедии: википедии
википедия: википедия
викисклад: викисклад
викискладе: викискладе
викицитатник: викицитатник
викицитатнике: викицитатнике
викторианский: викторианской викторианских
вклад: вклад
включать: включающую
власть: власти
вместе: вместе
вместо: вместо
внезапно: внезапно
внешний: внешние
вовсе: вовсе
возвращение: возвращение возвращения
воздух: воздухе
возникнуть: возникла
войти: войти
вокзал: вокзала
вокруг: вокруг
волан: волан
волшебник: волшебника волшебников волшебник
волшебный: волшебные волшебных волшебная волшебный волшебными
волшебство: волшебства волшебством
воображение: воображение
восьмилетняя: восьмилетняя
впервые: впервые
впоследствии: впоследствии
время: временем время времен
вручать: вручает
все: всех всего всем
всезнайка: всезнайкой
вскоре: вскоре
встречать: встречает
встречаться: встречается
второе: второго
вход: входа
выбирать: выбирает
выводить: выводят
выйти: вышел
вылупляться: вылупляется
вынудить: вынуждена
выпивать: выпивая
выпуск: выпуске
вырваться: вырвался
выскочка: выскочкой
высокий: высшей
высокомерный: высокомерного
выходной: выходных
выясняться: выясняется
газета: газете газета
гарри: гарри
гермиона: гермиона гермиону
героизм: героизме
герой: героя герои
глава: главах главы
главное: главного
глаз: глазах
говорить: говорит
год: году лет год годами годы года
годовалый: годовалого
гомером: гомером
гоняться: гоняться
горячий: горячую
готовый: готовый
грамотность: грамотности
грант: грант
грейнджер: грейнджер
гринготтс: гринготтс
гриффиндор: гриффиндор
группа: группами
гулять: гуляя
давать: дающий
давно: давно
давным: давным
дадли: дадли
далекий: дальше
даль: далем
дальнейший: дальнейших
дамблдор: дамблдор
дамблдора: дамблдора
дар: дары
дарита: дарит
дата: дата
дать: дал
два: двух
двадцать: двадцать
двоюродный: двоюродного
де: де
дебютный: дебютные дебютный
девяносто: девяноста
девять: девять
действие: действия
действовать: действовать
декабрь: декабря
дело: делам делом
демонстрировать: демонстрирует
день: дней дня
деньги: денег
держаться: держась
детская: детские детских
деть: день
дж: дж
джеймс: джеймса
джейн: джейн
джо: джо
джоан: джоан
джоанн: джоанн
дилогия: дилогия
директор: директор директора
дитя: дитя
длинный: длинная
добавить: добавив
добраться: добраться
добывать: добывает
догадываться: догадываются
док: док
должен: должна
доллар: долларов
доминировать: доминировали
дополнительный: дополнительные
дорога: дороге
достать: достать
доступный: доступен
дочь: дочь
драко: драко
дракон: драконами драконах дракон
древнегреческий: древнегреческим
древность: древности
друг: друзья друзьями друзей другом
другой: другим другие других
думать: думали
дурмстранг: дурмстранг
дурной: дурная
дурслей: дурслей
дурсли: дурсли
дух: духа
душ: душа
дырявый: дырявый
дьявольский: дьявольскими
дядя: дяди
европа: европа
единорог: единорога
единственный: единственными
еиналеж: еиналеж
жаловаться: жаловаться жаловались
жанр: жанр
желание: желания
жена: жена
жизнь: жизни
житель: жителей
жить: жившей
журнал: журнал
забирать: забирает
забрало: забрал
забредать: забредают
завладеть: завладеть
заводить: заводит
загадочный: загадочное
заглавный: заглавная
задержаться: задержавшись
заключительный: заключительных
замена: замены
заметка: заметку
замечать: замечает
замок: замку
занять: заняла
запасть: запала
запись: запись
заполучить: заполучившим
запретить: запрещен
запретный: запретном
запрос: запросы
зарегистрировать: зарегистрированный
заслонить: заслонил
затем: затем
затылок: затылке
захотеть: захотела
зачисление: зачислении
защита: защиты защите
защищать: защищала
заявить: заявила
заявление: заявление
заявлять: заявляли
зверь: звери
зелье: зельями
зельеварения: зельеварения
зеркало: зеркала зеркало
зло: зла
злой: злого
злоумышленник: злоумышленником
знак: знак
значение: значения
зов: зов
зоопарк: зоопарк
зрение: зрения
игра: игра игры
идея: идея
идти: идут
избаловать: избалованного
избежание: избежание
избежать: избежать
избранный: избранные
известный: известна
издание: издания издании
издатель: издателям
издательство: издательством издательстве издательство
икабог: икабог
именно: именно
иметь: имел
имя: имя имени
иначе: иначе
инструмент: инструменты
интернат: интернатах интернат
информация: информация
искренний: искренней
искусство: искусств
исполнительный: исполнительного
использование: использования
использовать: использована использовал использующие
история: история истории
источник: источников источники источника источник
исчезнуть: исчезло
июль: июля
июнь: июня
каждый: каждый
кажется: кажется
казаться: кажутся
какой: какие
камень: камень камнем камне камня
каникулы: каникулы
каннингем: каннингем
капюшон: капюшоном
карман: кармане
карточный: карточная
каталог: каталогах
категория: категории
качество: качестве
квартира: квартиры квартиру
квиддич: квиддич
квиддиче: квиддиче
квиддичу: квиддичу
квиррелл: квиррелл
квиррелла: квиррелла
квирреллу: квирреллу
кентавр: кентавров
кингс: кингс
кличка: кличку кличке
ключ: ключами
книга: книг книги книгу книга
книжный: книжных
когтевран: когтевран
код: код
кодекс: кодекс
колдовской: колдовской
коллекционный: коллекционная
комма: комм
комментарий: комментарии
комментатор: комментаторы
комментировать: комментировали комментируя
комната: комната
конструктор: конструктор
конфиденциальность: конфиденциальности
конфликтовать: конфликтует
конь: коня
копия: копия
корморане: корморане
король: короля
короткий: короткие короткий
корыстный: корыстных
косой: косой
который: которому которой которую которого которые которых которая котором который
крещеный: крещена
криптоним: криптоним
критика: критике критика
кровь: кровь
кроме: кроме
кросс: кросс
круг: кругах
крыло: крыле
кубок: кубок
куда: куда
кук: куки
кукушка: кукушки
кыргызча: кыргызча
лаборатория: лаборатория
лачуга: лачугу
легенда: легенда
лежать: лежит
лексический: лексические
лес: лесу
лесничий: лесничим
летать: летающими
летний: летней летние
либо: либо
лили: лили
литература: литературы
литературный: литературные литературный литературное
лицензия: лицензии
лицо: лицо
личность: личность
лишение: лишениях
лишь: лишь
лоб: лбу
ловец: ловцом
ловить: ловит
локация: локации
лондон: лондон
лондонский: лондонским лондонском
лорд: лорд
любить: любимых
любовь: любви любовь
любопытно: любопытно
люк: люк
маг: магов
магазин: магазине магазина
магический: магическом магический
магия: магия магию магии
маглам: маглам
магловской: магловской
маглы: маглы
макгонагалл: макгонагалл
македонский: македонски
макса: макс
маленький: маленький
малфоем: малфоем
малфой: малфой
малфою: малфою
мальчик: мальчик мальчика
манчестер: манчестере
маркетинг: маркетинга
марта: марта
материал: материал
мать: мать матери
мая: мая
медиафайлы: медиафайлы
менее: менее
местный: местных
место: место места
месяц: месяцев
метла: метле
миг: миг
миллион: миллионов
мимо: мимо
минервой: минервой
министерство: министерство
мир: мира мир мире
миссис: миссис
много: более
множество: множество
мобильный: мобильная
могила: могила
молния: молнии
момент: момент
монгол: монгол
морт: морт
морта: морта
морту: морту
мочь: можете могут
мы: нами
навигация: навигации навигация
наглядный: наглядных
награда: наград
над: над
назад: назад
название: названия названием название
назначать: назначает
назойливый: назойливых
называть: называли называет
наказание: наказание
наконец: наконец
наложить: наложила
намереваться: намеревается намереваясь
намного: намного
наоборот: наоборот
написание: написания
написать: написан
наряд: наряду
наследство: наследство
настоящий: настоящий
наступить: наступил
находить: находят находит
начало: начала
начинать: начинает
наш: наших
небытие: небытии
недостоверный: недостоверный
незнакомец: незнакомцем
некий: некая неким
некоммерческий: некоммерческой
некоторые: некоторыми некоторых некоторые
некоторый: некоторое
ненавидеть: ненавидел
необитаемый: необитаемый необитаемом
неопр: неопр
неполный: неполный
неприязненный: неприязненно неприязненное
неприятный: неприятное
несколько: несколькими несколько
несмотря: несмотря
неудача: неудачу
нещадно: нещадно
николас: николас николаса
новый: новый новые новых
норберт: норберт норберта
норрис: норрис
носитель: носителя
ночь: ночам ночь ночью
нужный: нужен
об: об
обвинение: обвинений
обитание: обитания
обложка: обложка
обнаруживать: обнаруживает
оборот: оборот
образец: образцы
образовательный: образовательных
обратный: обратно
обращение: обращения
обсуждение: обсуждение
обучаться: обучаясь
обходить: обходят
объявление: объявления
объявлять: объявляет
огонь: огня
огромный: огромную огромное
одежда: одежды
один: одной один
одиннадцатый: одиннадцатого одиннадцатый
одиночка: одиночки
однажды: однажды
однако: однако
одноименный: одноименный
ожог: ожоги
оказывать: оказывают
оказываться: оказывается
около: около
окончательно: окончательно
октябрь: октября октябре
олливандер: олливандер
олливандера: олливандера
он: нему
они: им них
онлайн: онлайн
опасный: опасных
опередить: опередить
описание: описание
опубликовать: опубликован опубликована
организация: организации
орден: орден
оригинал: оригинала
оригинальный: оригинальное
освещать: освещая
оскорблять: оскорбляя
основа: основе
оставаться: оставалась
оставить: оставили
остальное: остальными
останавливать: останавливает
остин: остин
остров: остров острове
отбывать: отбывая
ответственность: ответственности
отдельный: отдельных отдельные
отец: отца
отзыв: отзывов
отказ: отказ
отказываться: отказываются
отменить: отменила
отмечать: отмечали
относиться: относится
отношение: отношение
отправить: отправить
отправлять: отправляют отправляет
отправляться: отправляются отправляется
отпускать: отпускать
отрастить: отрастил
отредактировать: отредактировать отредактирована
отряд: отряд
отстаивать: отстаивать
охранять: охраняет
охраняться: охраняется
очень: очень
очки: очках
очнуться: очнувшись
ошибка: ошибке
павел: павел
падение: падение
палочка: палочку палочек палочка
пар: пару
парк: парк
пародия: пародии
первое: первого первое первые первом
первый: первой первая
перебираться: перебираются
перевести: переведен
перевод: перевод перевода
передавать: передают
переехать: переехать
перейти: перейти
переломный: переломный
перенести: перенесла
переть: при
переулок: переулок
период: период
перо: пером пера
персонаж: персонажи
персональный: персональные
печать: печати
пилотаж: пилотаж
писательница: писательницы писательниц писательницу
писать: писали писать
письмо: письмо письма
питомец: питомца питомец
пить: пьющим
платформа: платформы платформу
плащ: плаще
победа: победы
побежалый: побежал
поведение: поведения
повышение: повышении
погибать: погибает
погибнуть: погибли погибшей
поговорить: поговорить
подарок: подарок
подвергаться: подвергался
подвергнуть: подвергнут
поддержание: поддержания
подземелье: подземелья
подозревать: подозревает
подробный: подробнее
поединок: поединке
поезд: поезд
пожертвовать: пожертвовав пожертвовать
пожиратель: пожиратели
позволить: позволило
поздний: позже
позиция: позиции
поиск: поисках поисков поиск поиску
пойти: пошли
пока: пока
показывать: показывающее показывает
политик: политика политике
полнометражный: полнометражный
полный: полное полная
положение: положении
положительный: положительными
полтергейст: полтергейстах
полукровка: полукровка
получать: получает получают
получить: получила получил получить
полярный: полярную
поместить: поместила
помимо: помимо
помочь: помочь
помощь: помощью помощь
поначалу: поначалу
понимать: понимает
попадать: попадает
попечение: попечение
популярность: популярности
попытаться: попытается попытался
попытка: попыток попытку
порекомендовать: порекомендовал
порт: порт
портал: портал
португальский: португальского
портфолио: портфолио
порядок: порядок
посадить: посадил
поскольку: поскольку
последний: последний последние
последующий: последующих
пособие: пособие
посол: после
поспешный: поспешными
поставить: поставила
постепенно: постепенно
постоянно: постоянно
постоянный: постоянная
построение: построение
потратить: потратил
поттер: поттером поттер поттера поттере
поттерианы: поттерианы
похитить: похитить
похожий: похожи
поэт: поэт
поэтому: поэтому
появиться: появился
появление: появления
правда: правду
править: править
правка: правок правки
правый: прав
праздновать: праздновал
практик: практики
предлагать: предлагает
предложить: предложила
предмет: предметы предмет
предпочитать: предпочитала
представиться: представились
предупреждать: предупреждает
предыдущий: предыдущей
предыстория: предыстория
премия: премий
преобладать: преобладали
преодолевать: преодолевая
преподаватель: преподавателя
препятствие: препятствия
привести: привести
приказ: приказу
приказывать: приказывает
прикосновение: прикосновений
пример: примером
примечание: примечания
принадлежать: принадлежала
принадлежность: принадлежности
приносить: приносить
принц: принц
принять: принята приняли принять
приобретать: приобретают
присуждать: присуждаемых
приходить: приходит
про: про
проблема: проблемы
проболтаться: проболтался
проверять: проверяема
провести: провела
проговариваться: проговаривается
продавать: продаваемых
продать: продан проданы продать
продолжать: продолжают
продолжение: продолжения
продукт: продукт
проект: проектах проекту
прожить: прожил
произведение: произведения произведениях произведение
произведенье: произведений
производство: производство
происхождение: происхождении
пройти: пройти
проклясть: проклятое
проклятие: проклятие
просмотр: просмотры
просто: просто
простота: простоту
пространство: пространства
противник: противнику
профессор: профессором профессора профессор
прочий: прочее
прочный: прочно
прямая: прямой
прямолинейный: прямолинейный
публикация: публикация публикации
путеводитель: путеводитель
пуффендуй: пуффендуй
пушок: пушок пушка
пытаться: пытался пытается пытаясь
работать: работая работает
развитие: развитие
разговор: разговоре
раздел: разделами разделе
различный: различных
размер: размере
разработчик: разработчики
разъезжаться: разъезжаются
распределять: распределяющая
распускание: распускание
рассказ: рассказами рассказы
рассказывать: рассказывали рассказывает
раствориться: растворилась
расширить: расширив
ребенок: детьми
ребята: ребята
результат: результате результатов
рекламировать: рекламируют
рекомендация: рекомендации
рекордный: рекордные
религиозный: религиозные религиозными
ресурс: ресурсы
решать: решает
решение: решение решения
роальд: роальдом
родитель: родителей родители родителях
родственник: родственниками
рождение: рождения
рождественский: рождественский
роль: роль
роман: романов романа роман романы
рон: рону роном рона рон
российский: российская
роулинг: роулинг
рубеус: рубеус
рубеусом: рубеусом
рука: руку руками
румыния: румынии
русский: русский
сайт: сайты
сам: самом сама самое
самобытный: самобытных
самопожертвование: самопожертвования
самостоятельно: самостоятельно
самый: самых самые
сантиметр: см
саундтрек: саундтрек
сборная: сборной
сведение: сведения
свежий: свежие
свиной: свиной
свободный: свободной
свое: своих своему своего
свой: своей свою
связанный: связанные
связаться: свяжитесь
связывать: связывают
сделать: сделала сделало
себя: собой
северус: северус
северуса: северуса
сейф: сейфа
семья: семье семьи
сентябрь: сентября
сердце: сердце
сердцевина: сердцевиной
сериал: сериал
серия: серии серию серия
сесть: села
сжигать: сжигают
сила: силу сила
силок: силками
сирота: сироты сироту
система: системе
сказать: сказала
сказитель: сказителем
сказка: сказках сказки
сказочник: сказочником
скачать: скачать
склонить: склонить
скорый: поскорее
скрывать: скрывающим
скрытый: скрытые
скрыть: скрыть
следующий: следующее
слизерин: слизерин
слишком: слишком
словарь: словари
слово: слов словам слово
служба: службе
служебный: служебные
служилый: служил
слух: слухов
случай: случаях
случайно: случайно
случайный: случайная
смертельный: смертельная
смерть: смерти
смотреть: смотрит
смочь: смог
смысл: смыслу
снегг: снегг
снегга: снегга
снимать: снимают
сноска: сносок
снять: снят
собака: собаки собаку собака
собирать: собирал
собственный: собственные
событие: события событий
сова: сову совы
совершенно: совершенно
совет: совета
современный: современном современный современные
содержание: содержание
содержать: содержит содержать
сожалеть: сожалеет
создание: создание
создать: создала создал создать
сознание: сознание сознания
сокровенный: сокровенные
сообщать: сообщает
сообщество: сообщество
сообщить: сообщить
сопереживать: сопереживает
соревнование: соревновании
сохранение: сохранением
социальный: социальные социальное
социологический: социологического
сочинение: сочинениями
спасать: спасают
спасти: спасти
специалист: специалистам
список: списке список
спланировать: спланировать
спора: споры
спорт: спорте
способ: способы
справиться: справиться
справка: справка
спустя: спустя
сравнивать: сравнивали
сразу: сразу
среди: среди
српски: српски
српскохрватски: српскохрватски
ссылка: ссылка ссылки ссылок
сталкиваться: сталкиваются сталкивается
становиться: становятся становится становился
старший: старшему
статистика: статистика
стать: стала стать
статья: статью статья статьи
стаффордшире: стаффордшире
стебль: стебль
стекло: стеклом
степанов: степанов
стерлинг: стерлингов
стиль: стиль
сторона: стороны сторону
страдание: страдания
страйке: страйке
страна: странах стран
страница: страницы страница страницу страниц странице
страх: страхе
стремительный: стремительное
строиться: строится
суметь: сумел
существенный: существенную
существо: существа
существовать: существуют
считать: считает считали считают
сша: сша
сын: сына сыну
сюда: сюда
сюжет: сюжет сюжета
т: т
тайна: тайну
тайный: тайная тайно
также: также
такой: такие
татарча: татарча
твердый: твердо
тейлор: тейлор
текст: текст
текущий: текущие текущую
тело: тела тело
тем: тем
тематический: тематический тематические
темный: темных
тереть: три
термин: термина
терпеть: терпит
терять: теряет
тетя: тети
технология: технологиях
течение: течение
тип: тип
тираж: тиражом
товарный: товарный
тот: том тот тому той
точка: точки
тощий: тощий
травля: травле травля
третье: третьим
тролль: троллем тролль тролля
туда: туда
тысяча: тысяч
убивать: убивает
убить: убить убившего
увести: уведя
удаленный: удалена
уезжать: уезжает
ужасать: ужасающим
узкий: узких
узнать: узнает
узник: узник
уизли: уизли
указание: указанием
указать: указано указан
украсть: украсть
умереть: умереть умерла
умный: умное
уничтожить: уничтожить
упомянуть: упомянул
урок: уроке уроки уроков
условие: условий условия
успешный: успешных успешно
участие: участие
ученик: учеников ученики
учитель: учителя учителями
факультет: факультетов факультета
фантазия: фантазий
фантастика: фантастики
фантастический: фантастические
февраль: февраля
феникс: феникса
философский: философский философским философском
фильм: фильм фильмов
фламель: фламель
фламеля: фламеля
флитвик: флитвик
флитвика: флитвика
фонд: фонд
форма: формы
формировать: формируют
форум: форум
фунт: фунтов
фэнтези: фэнтези
фэнтезийный: фэнтезийный
хагрид: хагрид
хагрида: хагрида
хагридом: хагридом
хагриду: хагриду
характерный: характерной
хвалить: хвалили
хватать: хватает
хвост: хвост
хижина: хижине
хобби: хобби
хогвартс: хогвартс
хогвартса: хогвартса
хогвартсе: хогвартсе
хороший: лучше лучшим
хорошо: хорошо
хотеть: хотел
хоть: хоть
христианский: христианские христианской
художественный: художественной
худой: худ
цель: целях
цикл: цикл
цитата: цитаты
цитировать: цитировать
чарли: чарли
чародейство: чародейства
часто: часто
часть: частями часть
чей: чьи
человек: людей
чемпионат: чемпионат
чернильный: чернильно
черноволосый: черноволосый
черта: чертой
четверть: четверти
четыре: четыре
читать: читать
чтобы: чтобы
чуть: чуть
шармбатон: шармбатон
шахматный: шахматном
шахматы: шахматами
шелкопряд: шелкопряд
шесть: шесть
школа: школу школе школах школы
школьный: школьные
шляпа: шляпа
шотландский: шотландского
шрам: шрам
штрафовать: штрафует
эдвардианский: эдвардианских
эдинбург: эдинбурге
эдуард: эдуарда
экзамен: экзаменов
экземпляр: экземпляров
элемент: элемент
энциклопедия: энциклопедии
эпоха: эпохи
эстония: эстонии
этический: этические
этнический: этнические
это: этом это
этот: эта
юмор: юмор
являться: является являющихся являются
язык: язык языках языка
языковой: языковом
яйцо: яйцо
январь: января
