аберфорт: аберфорт
аберфорта: аберфорта
аберфортом: аберфортом
авад: авада
август: августа
автор: автора автор
авторство: авторства
агент: агентом
адальберт: адальберта
адвокат: адвоката
азкабана: азкабана
азкабане: азкабане
акцент: акцент
алкогольный: алкогольной
алфавит: алфавиту
алхимик: алхимика
алхимия: алхимии
альбус: альбус
альбуса: альбуса
амбридж: амбридж
американский: американский
аналогичный: аналогичен аналогичного
англ: англ
английский: английской
апрель: апреля
ариан: ариана ариану ариане арианы
ариана: арианой
армандо: армандо
архив: архив
архивировать: архивировано
архивный: архивная
астрономический: астрономической
астрономия: астрономии
аурелиус: аурелиус
барда: барда
батильду: батильду
батильды: батильды
башня: башня башне башни
безграничный: безграничной
безумие: безумия
бейл: бейл
беларуская: беларуская
белый: белый
бенедикт: бенедикт
бессильный: бессилен
бессмертие: бессмертия
библиографический: библиографических
бидля: бидля
биография: биография
битва: битвы
благой: блага
блестеть: блестящим блестящей
боггарт: боггарт
болезнь: болезни
больница: больницу
больной: больной
больший: больше
большой: велик большой
борода: бороды
борьба: борьбы
ботинок: ботинки
боязнь: боязни
бояться: боясь боялся
брайан: брайан
брат: брата брат брату
бритый: брит
бузина: бузина
бузинный: бузинной бузинная
буквальный: буквально
бунт: бунт
български: български
бытность: бытность
быть: бывшим будучи бывшее бывшего были
бэгшот: бэгшот
бэрбоун: бэрбоун
вальд: вальд
вальда: вальда
вальдом: вальдом
вд: вд
великанский: великанская
великий: величайшей величайшим величайший
великобритания: великобритания
вернуть: вернуть
вернуться: вернулся
версия: версия версии
верховный: верховного верховный
весь: вся
весьма: весьма
вещь: вещи
взгляд: взгляды
взглянуть: взглянуть
взять: взял
вид: вид виде
видеть: видит видел
визенгамота: визенгамота
викиданных: викиданных
викимедиа: викимедиа
википедии: википедии
википедия: википедия
викисклад: викисклад
викискладе: викискладе
викицитатник: викицитатник
викицитатнике: викицитатнике
викия: викия
вино: вину
висеть: висящем
вклад: вклад
включать: включая
владелец: владельца
владеть: владеть владел
властелин: властелин
власть: власти властью власть
вместе: вместе
вместо: вместо
вмешиваться: вмешиваться
вне: вне
внешний: внешние
внешность: внешность
внимание: внимание
вничью: вничью
вновь: вновь
внутренний: внутренние
внучатый: внучатый
внучек: внучка
вовсе: вовсе
возвращение: возвращение
возможность: возможность
возможный: возможных
возраст: возраст
возрождение: возрождении возрождения
воистину: воистину
война: войну
войти: войти
вокруг: вокруг
волан: волан
волос: волос
волшебник: волшебником волшебника волшебников волшебник волшебнику волшебниками волшебникам
волшебный: волшебные волшебных волшебного волшебная волшебный
волшебство: волшебства волшебство
воплотить: воплотил
воплощение: воплощение воплощением
вопреки: вопреки
вопрос: вопросы
воскрешать: воскрешающий
воскрешение: воскрешения
воспламенить: воспламенили
воспоминание: воспоминания воспоминаниях
воспринимать: воспринимать
воспротивиться: воспротивился
воссоединить: воссоединить
восстановить: восстановлен восстановили
восхищение: восхищением
впадина: впадину
впоследствии: впоследствии
временить: времени
временно: временно
временной: временной
время: временем время
все: всех всего всеми
вселенная: вселенная
всеять: всей
вскоре: вскоре
вставить: вставлен
встать: встал
встретиться: встретился
встреча: встреча встречах встречи
вступать: вступает
вступить: вступил вступивший
всякая: всякой
всякий: всяким
второе: втором вторых
второй: второй
вульфрик: вульфрик
выбрать: выбрала выбран
вывод: вывод
выгода: выгоды
вызвать: вызвало
вызывать: вызывало
вылечить: вылечить
вымыслить: вымышленные
вынудить: вынужден
выпить: выпил
выпустить: выпустил выпущено
вырасти: вырос
высказать: высказали
высказывание: высказываний
высмеивать: высмеиваемое
высокий: высоком высок
высокоорганизованный: высокоорганизованного
выступать: выступает выступал
выступить: выступил
выход: выход
выясняться: выясняется
гарри: гарри
геллерт: геллертом геллерт
гениальный: гениальным
гений: гением
гера: герой
гермиона: гермиона
героизм: героизме
герой: героя героев
гея: гей гея
гибель: гибели гибель
гилгудом: гилгудом
глава: главе главы
главное: главных главное
главый: главой
глаз: глаз глаза глазах
гнев: гнева
говорить: говорит говорил говоря
говориться: говорится
год: году лет год годы годом года
годрикову: годрикову
голубой: голубыми
гомосексуал: гомосексуал
гомосексуалист: гомосексуалистом
гонорий: гонория
господство: господстве
готовить: готовил
готовиться: готовились
грегор: грегоровича
грейнджер: грейнджер
грин: грин
гриндевальд: гриндевальд
гриффиндор: гриффиндор
груз: груз
гэмбон: гэмбон
гэмбону: гэмбону
гэндальфа: гэндальфа
далее: далее
далекий: дальше
дальнейший: дальнейшем
дамби: дамби
дамблдор: дамблдор
дамблдора: дамблдора
дамблдором: дамблдором
дамблдору: дамблдору
дар: дарами даров дары
дата: дата
дать: данный данных
два: два двух
двенадцать: двенадцати
двойной: двойным
де: де
девочка: девочка
действие: действия
действительность: действительности
действовать: действовать
декабрь: декабря
дело: деле
дементоров: дементоров
день: дней дня
держать: держащего
деть: дела
дж: дж
джаред: джаред
джеймс: джеймс джеймса
джоан: джоан
джон: джоном
джуд: джуд
джудом: джудом
диагноз: диагноз
дилогия: дилогия
диппета: диппета
директор: директором директоров директор директора
дитя: дитя
длинный: длинным длинных длинный
дневник: дневника
добиться: добилось
доброта: доброты
добыть: добыть
доверить: доверил
доверять: доверял
довольный: довольно
дож: дожем дожа
док: док
доказать: доказать
долгий: долгое
долгожитель: долгожители
должен: должны должен
должность: должностях должность
долорес: долорес
дома: дома
домыть: домой
дополнительный: дополнительные
достаться: досталась
достижение: достижении
доступный: доступен
дочь: дочь
драка: драки
драко: драко
дракон: дракона
древность: древности
друг: друзья другом
другой: другое другой другими другие других другого
думать: думать
дурмстранг: дурмстранг
душ: душу души
душевнобольная: душевнобольной
душевный: душевные душевное
дуэль: дуэли дуэль
дэвид: дэвида
единственный: единственное единственный
еиналеж: еиналеж
жалость: жалость
желание: желание
жестокость: жестокости
живой: жив живыми
жизненный: жизненных
жизнеописание: жизнеописание
жизнь: жизни жизнь жизнью
жила: жилах
жительство: жительства
жить: жить
журнал: журналами
забрало: забрал
завершить: завершил
зависнуть: зависнув
заглавный: заглавная
загубить: загублена
задавать: задавать
задание: задание
задний: задним
заинтересовать: заинтересован
заканчивать: заканчивал
заклинание: заклинание
заключаться: заключалась
заключение: заключение
заклятие: заклятие
закончиться: закончилась
закрепить: закреплена
замена: замены
заменить: заменить
заменять: заменять
заместитель: заместитель
заметить: заметил
замысел: замыслу
занятие: занятий
записаться: записалась
запись: запись
запоздалый: запоздалая
заполучить: заполучить
заправить: заправить
запрет: запрет запретам
запретить: запретить запрещено
запрос: запрос
зарегистрировать: зарегистрированный
заседание: заседании
заставить: заставили
заставлять: заставлять
затем: затем
защита: защиты защитой защиту
защититься: защититься
защищаться: защищаться
заявить: заявил заявила
заявление: заявление
заявлять: заявляла
звание: звание звания
зверь: звери
здание: здании
здоровье: здоровьем
зелье: зелье
зельеварения: зельеварения
земля: землю
зеркало: зеркале зеркало
зловещий: зловещего
злодей: злодеем
злой: злой
змея: змеи
знак: знак
знаменитый: знаменитыми знаменит
знать: знает зная
зрение: зрения
ибо: ибо
игра: игра игре игры
играть: играть
идея: идеи идее идей
избавиться: избавиться
избегать: избегал
избранный: избранные
избыточный: избыточный
известно: известно
известный: известна известного известен
изначально: изначально
изображение: изображения изображением
изобразить: изобразив
изумрудный: изумрудное
изучать: изучая
изучить: изучить
изъявить: изъявил
именно: именно
имя: именем имя имени
иначе: иначе
инструмент: инструментами инструменты
интервью: интервью
интересный: интересное
информация: информация информацию
ирландский: ирландский
искать: искал
исключение: исключением
искриться: искрящимися
искусство: искусств
искушение: искушению
исполнение: исполнении исполнения
исполнить: исполнил
использование: использовании использования
использовать: использовал использовать использующие
истина: истина
историк: историка
история: история историй истории
источник: источниками источник
итог: итоге
иэну: иэну
июль: июля
июнь: июня
й: й
кабинет: кабинет кабинете
каблук: каблуке
кавалер: кавалер
казаться: казалось
какой: какие
камбербэтч: камбербэтч
камень: камень
камерный: камерная
канон: каноном
карда: кард
карточка: карточке
карточный: карточная
карьер: карьере
касаться: касающиеся
кастинг: кастинг
каталог: каталогах
категория: категории категория
качество: качество качестве
каштановый: каштановый
квиддич: квиддич
квиддичу: квиддичу
кегель: кегли
кедавра: кедавра
кендра: кендра
кендры: кендры
кентавр: кентавра
книга: книг книгах книги книгой книге
код: код
кодекс: кодекс
колдовать: колдует
колено: коленом
количество: количество
коллекционный: коллекционной коллекционная
кольцо: колец кольцо
коммерческий: коммерческие
комната: комната
компания: компанию
конец: концов конце конца
конструктор: конструктор
контролировать: контролирующей
конфедерация: конфедерации
конфиденциальность: конфиденциальности
конфликт: конфликт
копия: копия
короткий: короткие короткий
который: которым которое которой которую которого которые котором который
крайне: крайне
крайний: крайней
красивый: красивым
красоваться: красовались
кресло: кресло
крест: крест
крестраж: крестраж
крестражах: крестражах
крестражей: крестражей
кривой: кривым
криденс: криденс
кристиан: кристиан
критик: критиков
критика: критики критика
кровь: крови кровь
кроме: кроме
кружок: кружок
круциатус: круциатус
кто: кем
кубок: кубок
куда: куда
кук: куки
культурный: культурного
курс: курса
лагерь: лагерь
латынь: латыни
левый: левым
лесничий: лесничим
летний: летняя
лето: летом
лили: лили
лиловый: лиловая
лицемерный: лицемерным
лицензия: лицензии
лицо: лицам
личной: личных личное
личность: личность личности
лишение: лишениях
лишь: лишь
ложный: ложный
локация: локации
ломать: ломали
лондон: лондоне
лондонский: лондонской
лорд: лордом лорде лорду лорд
лоу: лоу
любить: любимых
любовь: любовью любви любовь
люпин: люпина
маг: магов маги магом маг
магический: магической магическую магических магическими
магия: магия магии магией
маглов: маглов
магловским: магловским
маглы: маглы
майкл: майкл майклу
макгонагалл: макгонагалл
македонский: македонски
макиавеллиевский: макиавеллиевской
маккеллену: маккеллену
маленький: меньше мало
малфой: малфой
малфою: малфою
малфоя: малфоя
мальчик: мальчиком мальчика мальчику
мантия: мантия мантию мантии
марволо: марволо
марк: марк
марта: марта
мастер: мастера
материал: материал
материнский: материнской
мать: мать матери
маховик: маховиком
мая: мая
мгновенно: мгновенно
медальон: медальон
медиафайлы: медиафайлы
международный: международной
менее: менее
мера: мере
мерлин: мерлин
мерлина: мерлина
место: место места месте
месяц: месяца
меткий: метки
минерва: минерва
минерву: минерву
министерский: министерских
министерство: министерства министерство министерством министерству
министр: министра
минута: минуту
мир: мира мир мире
мировой: мировом
миссис: миссис
младший: младшим
мнение: мнению мнение
многие: многие
многий: многом
много: более
мобильный: мобильная
можно: можно
молодая: молодой
молодой: молодого
мольба: мольбы
момент: моменту момента моментом
морт: морт
морта: морта
морте: морте
мортом: мортом
морту: морту
мотив: мотивов
мочь: мог могут могло
мракса: мракса
мудрый: мудрым
мужской: мужской
музей: музее
музыка: музыка
мунго: мунго
мучение: мучения
мучительный: мучительной
мы: нами
мысль: мысль
наблюдать: наблюдает
набросить: наброшена
навигация: навигации навигация
нагайны: нагайны
нагорье: нагорье
награда: награды
нагрузка: нагрузки
над: над
надежда: надежде
надеть: надел
название: названием
названый: назван
назвать: назвал
назначить: назначил
назойливый: назойливых
называть: называет называть
называться: назывались
найти: найти
наконец: наконец
налагать: налагает
наложить: наложенное
намереваться: намеревался
намерение: намерении
нанести: нанести
нападение: нападения
нападки: нападок
напасть: напали
напевать: напевая
напиток: напитком
напомнить: напомнил
например: например
нарисовать: нарисованному
наследство: наследству
настоящее: настоящим
наступать: наступающего
наступить: наступит
насыпной: насыпное
наука: наука
научный: научными
находить: находит
находиться: находятся находящийся
начало: начало начале начал начала
начать: начали
начаться: начался
наш: наших нашего
небольшой: небольшое
невидимка: невидимки невидимка
невидимость: невидимости
невозможно: невозможно
невыполнение: невыполнение
невыполненный: невыполненное
неделя: недель
недостоверный: недостоверный
недостойный: недостоин
недоступный: недоступная
незадолго: незадолго
незримый: незримую
некий: некую
некоммерческий: некоммерческой
некоторые: некоторые
некоторый: некоторое
необходимость: необходимости
необходимый: необходимого
необычный: необычным
неоднозначность: неоднозначность
неоднократно: неоднократно
неопр: неопр
неполный: неполный
неприятный: неприятные
нерабочий: нерабочими
несколько: несколько
несмотря: несмотря
несоответствие: несоответствие
неспособность: неспособность
несчастный: несчастный
неуправляемый: неуправляемой
нецелесообразный: нецелесообразным
нечаянно: нечаянно
нижеследующий: нижеследующая
никакой: никаких никакой
никогда: никогда
николас: николасом николаса
новость: новость
новый: новым новые новое
нога: ногах
норрис: норрис
нос: нос
носок: носков
ночь: ночь
ноябрь: ноября ноябрь
нужно: нужно
ньют: ньют
об: об
обвинить: обвинил
обвинять: обвиняли
обезоружить: обезоружившего обезоружил
обитание: обитания
обитать: обитают
обладатель: обладателем
обладать: обладать
обнаружить: обнаружив
оборотень: оборотня
образ: образ
образование: образование
образовать: образована
обратиться: обратился
обращать: обращал
обращение: обращения
обсуждать: обсуждали
обсуждение: обсуждение
обуглить: обугленная
обучение: обучения
общаться: общается
общий: общего
объявить: объявлен
объясняться: объясняющиеся
обязательно: обязательно
оглушить: оглушил
огонь: огня
оградить: оградить
огромный: огромную
одетый: одет
один: одна один одним
однажды: однажды
однако: однако
означать: означает означающего
оказаться: оказался оказавшись
окончание: окончании
окончательно: окончательно
окружать: окружающих
октябрь: октября октябре
она: ею
они: им них
оно: оно
опасаться: опасаясь
опасность: опасности
опасный: опасных
описание: описание
описывать: описывая
описываться: описывается
организация: организации организацию
организовать: организованного
орден: ордена орден
оригинал: оригинала
ориентация: ориентация
орсон: орсон
осколок: осколки осколок
ослабеть: ослабел
основа: основой
основатель: основатель
оставаться: оставалось оставаться
оставлять: оставляет
остановить: остановить
осуществление: осуществлению
ответ: ответ
ответственность: ответственности ответственность
отвечать: отвечая
отдельный: отдельную отдельных отдельные
отец: отца отец
отзываться: отзывается
отказ: отказа отказ
отказаться: отказался
отказываться: отказывался
отклонить: отклонить
откровенный: откровенен
открытие: открытием
открыть: открытую
отличаться: отличался отличающуюся
отличие: отличие
относительно: относительно
отношение: отношения отношение
отомстить: отомстил
отправиться: отправился отправиться
отредактировать: отредактирована
отрицать: отрицать
отряд: отряд
отсутствие: отсутствия
отчаяние: отчаяния
охватить: охватила
очень: очень
очередной: очередное
очки: очками
ошибка: ошибке ошибках ошибки
ошибочность: ошибочность
павший: попавшее
палец: палец
палочка: палочек палочка палочки палочкой
паника: панику
пар: пару
параметр: параметр
парк: парк
пародия: пародии
патронус: патронус
первое: первое первых
первоначальный: первоначальному
первый: первой первую первый
перевод: переводе
перед: перед
передавать: передавало
передаваться: передающийся
передать: передал передать
переехать: переехала
перейти: перейти
переломный: переломным
перенаправляться: перенаправляется
переписка: переписку
пересиливать: пересиливали
переть: при
персиваль: персиваль
персиваля: персиваля
персонаж: персонажа персонажами персонаже персонажи персонажей
персональный: персональные
перстень: перстень
печать: печати
пещера: пещере
писательница: писательницы писательница
питер: питер
питье: питья
план: планов
планировать: планировал
племянник: племянник
плечо: плеч
плюс: плюс
победа: победой победы победа
победить: победив победить
поведение: поведения
поверх: поверх
поворотный: поворотной
повторить: повторил
погибнуть: погибнуть
поддаться: поддался
поделиться: поделился
подземок: подземки
подметать: подметающая
подобно: подобно
подозревать: подозревал
подпольный: подпольный
подражать: подражать
подрасти: подросшему
подробный: подробнее
подросток: подростки
подчинение: подчинение
поединок: поединок поединка
пожертвовать: пожертвовать
пожизненный: пожизненное
пожиратель: пожирателя пожиратели
позволить: позволено
позволять: позволяет позволять
поздний: позднее позже
поиск: поиски поиск поиску
пока: пока
покидать: покидает
покинуть: покинул
поклонник: поклонников
пол: пол
политик: политика политике
политкорректность: политкорректность
полномочие: полномочий
полностью: полностью
полноценный: полноценным
полный: полное полной полную
положение: положения
полтергейст: полтергейстах
полукровка: полукровки полукровка
получить: получил получить
пользоваться: пользоваться
поместить: поместив поместили
помешать: помешала
помощь: помощь
понимать: понимая
понять: понять понял
попробовать: попробовать
попросить: попросил попросить
попытка: попытке
поражение: поражение
порой: порой
портал: портал
портрет: портретом
поручение: поручений
поручить: поручил
поселиться: поселился
посему: посему
поскольку: поскольку
последний: последнее последний последнего
последователь: последователей
последствие: последствия
последующий: последующих
послужить: послужил
посол: после
пост: поста пост
поставить: поставлен
постепенно: постепенно
посторонний: посторонних
постоянно: постоянно
постоянный: постоянная
поступать: поступать
поступить: поступил поступило
поступок: поступки поступка
посчитать: посчитав
потасовка: потасовка
поттер: поттер поттера поттеров поттере
поттерианы: поттерианы
поттеромания: поттеромания
похороны: похоронах
почернеть: почернела
почтить: почти
поэтому: поэтому
появиться: появились появился
появление: появление
появляться: появляется
пояс: пояс
правильно: правильно
править: править
правка: правки
практик: практика
превосходство: превосходстве
преданность: преданности
предвидеть: предвидел
предел: пределах
предлагаться: предлагается
предложение: предложение
предмет: предметы
предполагать: предполагал
предпринять: предпринять
предрассудок: предрассудкам
представить: представить
представиться: представились
представлять: представляла представляет
предыстория: предыстория предысторию
прежний: прежнего
президент: президент
преподавание: преподавание преподавании
преподаватель: преподаватель преподавателя преподавателем
преподавать: преподавать
преследовать: преследовал
преступление: преступления
пригласить: пригласить
пригрозить: пригрозила
придать: придав
приемлет: приемлет
признаваться: признавалась
признать: признал
прийтись: пришлось
приказ: приказа
приключение: приключение
прикончить: прикончит
применение: применения применение
примечание: примечания
принадлежность: принадлежность
принимать: принимает
принц: принц
принцип: принципов
принять: приняты
приняться: принялся
приписать: приписала
присматривать: присматривать
присмотр: присмотра
приспешник: приспешников
приступ: приступа
приступить: приступивший приступил
притворный: притворной
приходить: приходил
причина: причины причинах причина причиной
приют: приюте
про: про
проблема: проблемы проблемах
провидица: провидицу
продажа: продажу
продолжать: продолжал
продукция: продукции
проект: проектах
прозвище: прозвище
произведенье: произведений
производство: производство
произносить: произносит
произойти: произошла
происхождение: происхождение
проклясть: проклятое
проклятие: проклятия проклятие
промежуток: промежутке
пророчество: пророчество пророчества
прославить: прославленного
просмотр: просмотры
просто: просто
пространство: пространства
просьба: просьбой просьбу
против: против
противник: противники
противостояние: противостояние
протяжение: протяжении
профессор: профессора профессор
прочий: прочее
прошествие: прошествии
прошлый: прошлом
прощение: прощения
пряжка: пряжками
прямая: прямых
публикация: публикации
путеводитель: путеводитель
путешествие: путешествие
путь: путь
пытаться: пытался
пята: пятой
пятый: пятым
работа: работе работу
работать: работать
ради: ради
раз: раза
разговаривать: разговаривать
разговор: разговор
разгореться: разгорелась
разделять: разделять разделяющим
раздражать: раздражает
разработчик: разработчики
разрешение: разрешения
разум: разума
расколоть: расколола
раскрыть: раскрыл
расположить: расположен
распределять: распределяющая
распространение: распространение
рассердиться: рассердился
рассказ: рассказы
рассказать: рассказал
рассказывать: рассказывал
рассматриваться: рассматривались
расширение: расширение
ребенок: дети
регбо: регбо
реддл: реддл
реддла: реддла
реддлом: реддлом
редко: редко
результат: результате
рекламный: рекламным
религиозный: религиозные
ресурс: ресурсы
речь: речью
решительный: решительно
решиться: решился
римуса: римуса
ричард: ричарда ричард
род: род
родитель: родителей родители
родиться: родился
родные: родным родных
родственник: родственники родственникам
родственный: родственных
рождение: рождения
роль: роль роли
роман: романов
рон: рон
ротштейна: ротштейна
роулинг: роулинг
рубеус: рубеус
рука: рука руках руки
русский: русский
рыжий: рыже
саламандер: саламандер
сам: самого самой самом самому сама
самопожертвование: самопожертвование
самый: самая самыми самым
сантиметр: см
саундтрек: саундтрек
сбросить: сбросившее
сведение: сведения
свежий: свежие
свидетель: свидетелем
свободный: свободной
свое: своих свои своему своего своим своими
свой: своей свою
свойство: свойства
связанный: связанные
связаться: свяжитесь
святой: святого
сделать: сделали сделать сделавшую
себя: собой
северус: северус
северуса: северуса
сегодня: сегодня
седой: седой
седьмой: седьмой
секрет: секретами
сексуальный: сексуальная
семью: семью
семья: семья семьи
сентябрь: сентябрь сентября
сердиться: сердится
сердцевина: сердцевиной
серебристый: серебристо
серебро: серебру
сериал: сериал
серия: серии серию серия
сестра: сестра сестры сестру
сеять: сеет
сивилла: сивиллу
сила: силы
сильнейший: сильнейшее сильнейший
сильный: сильнее сильно сильному
система: системе
сказать: сказать сказал
сказка: сказки
скачать: скачать
сквиб: сквиб
склонность: склонность
скотт: скотт
скрывать: скрывала скрывать скрывал
скрытный: скрытен
скрытый: скрытые
скрыться: скрылся скрыться
слабость: слабостью
следовательно: следовательно
следующий: следующее
слизерина: слизерина
слизнорта: слизнорта
слишком: слишком
словно: словно
слово: словам слова
сломать: сломал
служебный: служебные
служить: служить
случай: случае случаях
случайно: случайно
случайный: случайная
случиться: случиться случилось
смертельный: смертельный
смерть: смертью смерть смерти
смочь: смог
снабдить: снабдив
снегг: снегг
снегга: снегга
снеггом: снеггом
снова: снова
снять: снят сняли
соавторство: соавторстве
собирать: собирать
соблазн: соблазн
собственный: собственно
событие: события
совершеннолетие: совершеннолетия
совершить: совершить
советовать: советует
совместный: совместной
согласиться: согласился
соглашаться: соглашался
содержание: содержание
содержаться: содержится
создание: созданию создание
создатель: создатель
создать: создал создали создать
создаться: создавшегося
сознание: сознания
сообщать: сообщает
сообщество: сообщество сообщества
сообщить: сообщить
соответствовать: соответствовать
сосед: соседи
соседство: соседству
составлять: составляющих
состоять: состоит
состояться: состоявшихся
сохранение: сохранением
социальный: социальный
спас: спас
спасти: спасти
список: список
спокойный: спокойно спокойное
спокойствие: спокойствие
спора: споры
способ: способ способов
способность: способностью способностями
способный: способный способен
справка: справка
спустя: спустя
сработать: сработало
сравнивать: сравнивала
среди: среди
српски: српски
српскохрватски: српскохрватски
ссылка: ссылка ссылками ссылки
становиться: становится
староанглийский: староанглийского
старое: старому старым старого
старый: стар
статистика: статистика
статус: статус
стать: стал стало стала стать ставшее став
статья: статью статья статьи
стезя: стезе
стен: стен
степень: степени
стоить: стоило
сторона: стороны стороне
страница: страницы страницах страница страницу странице
странный: странные
страшный: страшная
строгий: строгим
строжайше: строжайше
стронг: стронг
студия: студии
суд: суду
судить: судя
судно: суда
сужденный: суждено
суть: сути
существо: существа
схватка: схватке
схема: схемы
сцена: сцены
считаться: считается считаются
сыграть: сыгравшему сыграл сыграть
сын: сын
сюда: сюда
сюртук: сюртук
табачный: табачной
таинственный: таинственные
тайный: тайная тайны
такой: такими такому такая таких такие
талант: талант
татарча: татарча
тварь: твари
твой: твоей твоя
текст: текст текстов
текущий: текущие
тело: тело
тем: тем
тема: тему
тематический: тематический
теоретик: теоретика
тереть: три
терять: теряет
течение: течение
течь: текло
тирания: тирании
тоби: тоби
товарный: товарный
толстый: толстых
том: томом тома
тот: том те тот тому
точка: точкой точку
точный: точной
традиционный: традиционное
трансфигурации: трансфигурации
трансфигурацию: трансфигурацию
трансфигурация: трансфигурация
трелони: трелони
третье: третьем третьих третьего
трилогия: трилогии
трое: троих
труд: трудами
трудный: трудную
тщательно: тщательно
убедить: убедил убедить
убеждение: убеждение
убийство: убийства убийство
убить: убитой убил убить
увидеть: увидевшие
удар: удар
удаться: удалось
ужасный: ужасным ужасные
узнать: узнать узнал
узник: узник
уизли: уизли
указание: указанием указаний
указать: указан
украсить: украшенные
украсть: украл
укрепление: укрепление
укрепляться: укрепляться
умереть: умер
умный: умным
умолкать: умолкает
уничтожение: уничтожение уничтожения
уничтожить: уничтожил уничтожен уничтоженного
уоффлинга: уоффлинга
урок: уроки
условие: условий условия
установиться: установились
утаивать: утаивал утаивать
утверждать: утверждала утверждает
участие: участие
учебный: учебного
ученик: учениками учеников ученики ученику ученика учеником
учитель: учителя учителем
учиться: учиться
учредить: учреждены
факт: факт факты
факультет: факультет
фамилия: фамилия фамилию
фанат: фанатов
фантастический: фантастические
февраль: февраля
феникс: феникса феникс
фестрала: фестрала
фигура: фигуре
физический: физические
философский: философский
фильм: фильм фильме фильмов фильмах фильмы фильмом
фламелем: фламелем
фламеля: фламеля
флоренца: флоренца
фонд: фонд
формальность: формальностей
форум: форум
фраза: фраза
фундаментальный: фундаментальное
хагрид: хагрид
хагриду: хагриду
характер: характером характер характера
характеристика: характеристики
харрис: харриса харрис
хеймана: хеймана
хобби: хобби
хогвартс: хогвартс
хогвартса: хогвартса
хогвартсе: хогвартсе
ход: ходом ходе
ходжкина: ходжкина
ходить: ходит
хозяин: хозяином
хотеть: хотели
худой: худ хуже
цвет: цвет
целый: целей целом
цель: цели
цикл: цикла
цитата: цитаты
цитировать: цитировать
чароведения: чароведения
чародей: чародея чародей
чародейство: чародейства
часто: часто
часть: часть
человек: человек
чемпионат: чемпионат
через: через
черта: черта черт черту
честь: честь
четыре: четыре
число: числом числе
чистокровок: чистокровок
чистота: чистота
читатель: читателю читателям
читать: читать
член: членов
чтобы: чтобы
чувство: чувством чувства
чудачество: чудачества
чуждый: чужд
шаблон: шаблоном
шаг: шаг
шармбатон: шармбатон
шерстяной: шерстяных
шестая: шестым
шесть: шесть
школа: школу школе школы школ
шляпа: шляпа
шмель: шмель
шотландия: шотландия
шрам: шрам
эдварда: эдварда
элемент: элемент
элфиаса: элфиаса
элфиасом: элфиасом
энциклопедия: энциклопедии
это: этом это этому этим
этот: этой эта эту
юмор: юмора
юноша: юношей
юный: юным юного
являться: являлся являться является
язык: язык языках
якоб: якобы
январь: января
яркий: яркими
ясный: ясно
