аберфорт: аберфорт
аберфорта: аберфорта
аберфортом: аберфортом
август: августа
австралия: австралию
автор: автора автор
авторский: авторского
авторство: авторства
адский: адского
азкабан: азкабан
азкабана: азкабана
акция: акцию
ала: ала
аластор: аластор
алекто: алекто
аллюзия: аллюзией
алфавит: алфавиту
альбус: альбус
альбуса: альбуса
альбусом: альбусом
альбусу: альбусу
альтернативный: альтернативное
амбридж: амбридж
американский: американской
амикус: амикус
амикуса: амикуса
англ: англ
английский: английскому английский английском
антиоху: антиоху
апрель: апреля
арестовать: арестованную
ариан: ариана арианы
арктурус: арктурус
архивировать: архивировано
архивный: архивная
атака: атаки
атаковать: атакуют
б: б
банк: банка
бар: бара
барда: барда
батильда: батильда
батильду: батильду
батильды: батильды
башня: башне
бегство: бегством
беда: беды
бежать: бегут бегущая
безболезненно: безболезненно
безграничный: безграничной
безуспешно: безуспешно
беларуская: беларуская
белизна: белизна
беллатрисса: беллатрисса
беллатриссы: беллатриссы
беречь: берег
бесконечный: бесконечный
бесповоротно: бесповоротно
беспокоить: беспокоил
бестселлер: бестселлеров
библиографический: библиографических
бидля: бидля
билл: билла
битва: битва битвы
благодаря: благодаря
благой: блага
близкие: близких
блэк: блэк
блэка: блэка
боготворить: боготворил
бой: бою бой
боль: боли
больший: большим большая больше
большой: большое
бояться: боялись
брат: брата братьях брат брату
британия: британии
бросить: бросить
бруствер: бруствер
бузинный: бузинной бузинную бузинная
букля: букля
български: български
быстро: быстро
быть: суть бывший бывшего
бэгшот: бэгшот
вадим: вадим
важный: важное
вакансия: вакансия
василиск: василиска
вбросом: вбросом
вдали: вдали
великан: великан
великобритания: великобритании
великое: великих
вернуть: вернуть
вернуться: вернуться
верный: верным
версия: версия версии
весить: весь
вести: вели
вечно: вечно
вещь: вещей вещи
вид: виду виде
видение: видения
видеть: видит видят видел
визжать: визжащей
викиданных: викиданных
викимедиа: викимедиа
википедии: википедии
википедия: википедия
викисклад: викисклад
викискладе: викискладе
викицитатник: викицитатник
викицитатнике: викицитатнике
виктор: виктор виктора
виктория: викторией
виктуар: виктуар
вино: вине
виновник: виновник виновником
виновный: виновного
вклад: вклад
владеть: владеть
власть: власти
влияние: влиянием
влюбить: влюблена
вместе: вместе
внешний: внешние
внутренний: внутреннем
внутри: внутри
внушать: внушает
вовремя: вовремя
возвращение: возвращение
возглавлять: возглавляемое
возможно: возможно
возможность: возможности
возмущать: возмущает
возникнуть: возникли
война: войны войне
войти: войти
вокзал: вокзал
волан: волан
волшебник: волшебника
волшебный: волшебные волшебный
воля: воли
воплощение: воплощение воплощении
вор: вором
воскрешать: воскрешающий воскрешающего
воспоминание: воспоминания воспоминаниями
воссоздание: воссоздания
впадина: впадина
впалый: впал
вписать: вписаны
впоследствии: впоследствии
враг: врагов
вранье: вранье
вред: вред
временить: времени
временной: временным
время: временем время
вручать: вручает
все: всех всего всем
всепожирающий: всепожирающий
всеять: всей
вспоминать: вспоминает вспоминая
встреча: встречу
встречать: встречают встречает
встречаться: встречается
вступать: вступает вступают
второй: вторая
выбираться: выбираются
выбор: выбор
выглядеть: выглядело
выдавать: выдают
выдать: выдавшего выдаст
выживать: выживает
вызов: вызов
вызывать: вызывали вызывая
выйти: выйти вышла выйдет
выкрасть: выкрав выкрал
вынудить: вынуждены вынуждена
выполнить: выполнить
выполнять: выполнять
выпускать: выпускает
выражать: выражает
выручать: выручай
выскочить: выскочить
выслать: выслал
вытаскивать: вытаскивает вытаскивают
выход: выход выхода
выясниться: выяснилось
выяснять: выясняет
выясняться: выясняется
гарри: гарри
геллерт: геллерта
генри: генри
гермиона: гермиона гермионы гермионе гермиону
героизм: героизме
герой: героя героев
гибель: гибели
глава: главы
главное: главных
глаз: глазах
гнев: гнев
гоблин: гоблин
год: лет год годы года
годрика: годрика
годрикова: годрикова
гойл: гойл
гойла: гойла
голова: голову голова
горбинка: горбинка
горький: горькую
гостиная: гостиной
гот: готов
готовиться: готовится
гп: гп
грамматический: грамматических
грегор: грегоровича
грейнджер: грейнджер
гринвич: гринвичу
гринготтс: гринготтс
гриндевальд: гриндевальд
гриндевальда: гриндевальда
гриндевальдом: гриндевальдом
гриффиндора: гриффиндора
гриффиндорец: гриффиндорец
гробница: гробнице гробницы
грохх: грохх
группа: группы групп
грюм: грюм
дабы: дабы
давать: дают давать
давний: давний
дама: даму
дамблдор: дамблдор
дамблдора: дамблдора
дамблдорах: дамблдорах
дамблдоре: дамблдоре
дамблдоров: дамблдоров
дамблдором: дамблдором
дамблдору: дамблдору
дар: даров дарах дары
дата: дата даты
дать: дал
два: два двух
де: де
девятнадцать: девятнадцать
дед: дед
действительно: действительно
действовать: действовать действует
декабрь: декабря
делакур: делакур
делать: делать
дело: деле
делюминатор: делюминатор
делюминатору: делюминатору
день: дней дне
депрессия: депрессию
деревня: деревне деревню
деть: день дело
деятель: деятели
дж: дж
джеймс: джеймса
джинни: джинни
джоан: джоан
джордж: джорджу
диадема: диадему диадема
дикий: диким
дилогия: дилогия
дина: дин
директор: директором директоре директора
дитя: дитя
днями: днями
добби: добби
добровольно: добровольно
добыть: добытый добыл
довершить: довершить
довольный: довольно
догадываться: догадываются догадывается
док: док
докладывать: докладывает
долгий: долгое
долгопупс: долгопупс
долгопупсом: долгопупсом
должен: должен
долорес: долорес
дом: дом доме
дома: дома
домовик: домовик домовики домовика
дополнительный: дополнительные
допустить: допустил
дословный: дословный
доставлять: доставляет
достать: достать
достаться: достался досталась
доступный: доступен доступная
дочь: дочь дочерью
драко: драко
дракон: драконе
драма: драма
древность: древности
друг: друзья друзей
другой: другие других
дурмстранг: дурмстранг
дурной: дурная
душ: душу души
душа: душой
душить: душит
дуэль: дуэли дуэль
дэниел: дэниела
дядя: дядю
егерь: егеря
елена: еленой
ехать: едут
жанр: жанр
желание: желание
желать: желая
жестокий: жестоко жестокими
живой: жив живым
жизнь: жизни
жить: жили
журнал: журнал
забирать: забирает
забрало: забрал
забыть: забыв
заварушка: заварушке
завершаться: завершается
завещать: завещанные
завладеть: завладеть завладел
загадать: загадать
заглавие: заглавие
заглавный: заглавная
задание: задание
задержать: задержать
заклинание: заклинанием заклинание
заключительный: заключительная
заклятие: заклятие
закончить: закончила
замечать: замечает
замок: замку
занять: занял
записать: записала
запись: запись
запретный: запретном
запытывая: запытывая
зарегистрировать: зарегистрированный
заставлять: заставляет
застать: заставшие
затем: затем
защита: защиту
защищать: защищать
заявить: заявила
заявление: заявление
звать: звали
зверь: звери
зелье: зельем зелье
зельеварения: зельеварения
зло: зла
змеиный: змеиный
змея: змея
знак: знак
знакомый: знакома
знать: знает знал знала
значение: значения значений
значит: значит
значительно: значительно
зов: зов
золотой: золотому
ибо: ибо
игнотус: игнотус
игнотуса: игнотуса
игнотусу: игнотусу
игра: игра игры
идеология: идеологию
идея: идея
избежать: избежать
избить: избил
избранный: избранные
издание: издания изданиях
издательство: издательство издательства
изложить: изложена
изначально: изначально
икабог: икабог
именно: именно
иметь: имела имеет
имя: именем имя
инакомыслие: инакомыслие
иностранный: иностранного
инструмент: инструменты
интервью: интервью
интерес: интерес
интернет: интернет интернете
инферналов: инферналов
искать: ищет искать искал
исключать: исключают
искусство: искусств
исполниться: исполнится
использование: использования
использовать: использовав
история: историю история истории
источник: источник
итог: итоге
июль: июля
июнь: июня
й: й
кабаний: кабанья
кабинет: кабинета
кадмус: кадмус
кадмусу: кадмусу
какой: какая какие
калифорний: калифорнии
камень: камень камня
кандиды: кандиды
караулить: караулит караулят
картина: картину
карточный: карточная
каталог: каталогах
категория: категории
квеста: квест
квиддич: квиддич
квиддичу: квиддичу
кентавр: кентавры
кикимер: кикимер
кикимера: кикимера
кикимеру: кикимеру
кингс: кингс
кингсли: кингсли
киноадаптация: киноадаптация
клык: клыков
клятва: клятву
книга: книги книгу книгой книге книга
когтевран: когтевран
когтеврана: когтеврана
код: код
кодекс: кодекс
колдовать: колдовать
колдовство: колдовства
колин: колин
количество: количество
коллекционный: коллекционная
кольцо: кольцо кольца
команда: команды команда
комментарий: комментарии
комната: комнате комнату комната комнаты
конец: конец
конечный: конечном
конкурс: конкурс
конструктор: конструктор
контролировать: контролируют
контроль: контроль
конфиденциальность: конфиденциальности
координатор: координатору
копить: копить
копия: копии копию копия
копье: копий
корбен: корбен
корморане: корморане
королевский: королевском
короткий: короткие короткий
который: которое которой которую которого которые которых которая котором который
кража: краже
крам: крам
крестраж: крестраж
крестража: крестража
крестражей: крестражей
крестражем: крестражем
крестражи: крестражи
кривить: криви
кровь: кровь
кроме: кроме
кросс: кросс
круг: круг
круциатус: круциатус
крэбб: крэбб
крюкохват: крюкохват
ксенофилиус: ксенофилиус
ксенофилиуса: ксенофилиуса
кто: кого кому
кубок: кубок
куда: куда
кук: куки
кукушка: кукушки
кулон: кулоне кулон
кусок: кусок
кыргызча: кыргызча
кэрроу: кэрроу
лаборатория: лаборатория
лавгуд: лавгуд
лавгуда: лавгуда
лань: лань лани
легенда: легенде легенду
лезвие: лезвию
лень: лень
лес: лесу
лестрейндж: лестрейндж
лето: лето
либо: либо
ликовать: ликуют
лили: лили
линия: линия
литература: литература
литературный: литературные литературного
лицензия: лицензии
личина: личиной
личной: личной
лишать: лишают
лишение: лишениях
лишиться: лишилась
лишь: лишь
ловить: ловят
локация: локации
ломать: ломает
лорд: лордом лорда
любитель: любителей
любить: любящей любил любимая
любой: любое
люпин: люпин
люциуса: люциуса
маг: магов
магазин: магазинов магазин
магический: магической магическим
магия: магия магию магии магией
маглам: маглам
маглов: маглов
магловедение: магловедение
магловедения: магловедения
маглы: маглы
макгонагалл: макгонагалл
македонский: македонски
малоприятный: малоприятным
малфоев: малфоев
малфой: малфой
малфоя: малфоя
мальчик: мальчика
мальчишка: мальчишки мальчишек
мама: маму мамы
мантия: мантией мантия мантию
марволо: марволо
марта: марта
мастер: мастер мастера
материал: материал
мать: мать
мая: мая
медальон: медальон медальона
медиафайлы: медиафайлы
медленный: медленно
менее: менее
менять: меняет
мерка: меркам
мертвец: мертвецом
место: место места месте
метить: мечу
меч: мечом меч
миллион: миллионов миллиона
милость: милость
министерство: министерство министерстве
министр: министр министра министром
минь: мини
мир: мира мир мире
миссис: миссис
младший: младшему
много: более много
мобильный: мобильная
могила: могиле могила
молли: молли
момент: момент моменты
монгол: монгол
морт: морт
морта: морта
мортом: мортом
морту: морту
москва: москва
московский: московскому
мочь: мог могут
мошенник: мошенником
мощный: мощную
мощь: мощи
мракса: мракса
мучительный: мучительной
мы: нами
мюриэль: мюриэль
набирать: набирают
навигация: навигации навигация
наводить: наводя
навредить: навредить
нагайна: нагайна
нагайной: нагайной
нагайну: нагайну
над: над
надевать: надевают
надругаться: надругались
название: названия названии название
названый: назван
наземникусом: наземникусом
назначить: назначенной назначен
назойливый: назойливых
называть: называет называющих
наиболее: наиболее
найти: найти найден
наказывать: наказывая
наконец: наконец
наложить: наложено
наносить: наносит
нападать: нападают
нападение: нападения
написание: написания
наполеоновский: наполеоновские
напоминать: напоминающем
например: например
наружу: наружу
нарушить: нарушив
нарцисс: нарцисса
наслаждаться: наслаждается
наследство: наследству
наставлять: наставляет
настоящее: настоящему
настоящий: настоящий
настраиваться: настраивается
находить: находят
находиться: находящемуся находится
начало: начала
начинать: начинает
начинаться: начинается
наш: наших
небольшой: небольшое
неважно: неважно
невидимка: невидимка невидимку
невилл: невилл
невилла: невилла
невиллом: невиллом
негласный: негласное
негодование: негодование
недостоверный: недостоверный
недоступный: недоступная
неизбежный: неизбежной
некий: некие некоей
некогда: некогда
некоммерческий: некоммерческой
некролог: некролог
ненавидеть: ненавидел
ненароком: ненароком
неопр: неопр
неосторожность: неосторожности
неполный: неполный
неправота: неправоту
неприятный: неприятных
нерабочий: нерабочими
несколько: несколько
нестер: нестеров
неудача: неудачу
нечаянно: нечаянно
никто: никто
нимфадора: нимфадора
нимфадоры: нимфадоры
новость: новостями новости
новый: нового новым новый новые
нож: ножа
нора: нору
норрис: норрис
нос: нос носу
носить: носил
ночь: ночь ночей
ноябрь: ноябрь
нужно: нужно
нужный: нужный
об: об
обвинять: обвиняет обвиняя
обезглавливать: обезглавливает
обезоруживать: обезоруживает
обезоружить: обезоружены
обитание: обитания
обложка: обложка
обманный: обманные
обмен: обмен
обнаруживать: обнаруживает
оборванный: оборван
оборона: оборону
оборотный: оборотное оборотным
образ: образами образы
обращение: обращения
обстоятельный: обстоятельно
обсуждение: обсуждение
обусловить: обусловлен
общий: общего общем
объявить: объявлено
объявлять: объявляет
обычный: обычного
огонь: огне огонь огня
ограбить: ограбить
огромный: огромный
один: одну одном одного один
однажды: однажды
однако: однако
озеро: озера
означать: означало
оказаться: оказались
оказываться: оказываются оказывается
около: около
окончание: окончания
окончательно: окончательно
окончательный: окончательный
октябрь: октября
олливандер: олливандер
олливандера: олливандера
омут: омут
они: им них ними
онлайн: онлайн
опасный: опасных
операция: операции операция
описание: описание
определение: определения
опрос: опрос
опубликовать: опубликовано опубликовала
опытный: опытными
организация: организации
организовать: организовало
орден: ордена орден
оригинал: оригинала
оригинальный: оригинальный
орфографический: орфографических
осколок: осколок
ослушаться: ослушался
основной: основные
особняк: особняка особняк
оставаться: оставался оставалась
оставить: оставивший
оставлять: оставляет
остальное: остальные
остаться: осталось осталась
отбирать: отбирает
ответственность: ответственности
отвозить: отвозят
отдавать: отдавать
отдать: отдал
отдельный: отдельных отдельные
отель: отеле
отец: отец
отказ: отказ
отказаться: отказалась
отказываться: отказывалась отказывается
открывать: открывают открывает открывал
откуда: откуда
отличаться: отличаться
относиться: относиться
отправить: отправить
отправиться: отправиться
отправляться: отправляются
отражать: отражает
отредактировать: отредактирована
отрывать: отрывает
отряд: отряд
отслеживать: отслеживали
отстоять: отстоять
отсутствовать: отсутствовал
оттуда: оттуда
отчаяние: отчаянии
официальный: официальном официального
охватываться: охватывается
охранник: охраннике
очень: очень
очередь: очередь
ошибка: ошибке ошибок ошибку ошибки
ошибочно: ошибочно
палатка: палатку палатке
палочка: палочку палочек палочка палочки палочкой
палый: пало
память: памяти память
паника: панику
параллельно: параллельно
парк: парк
пародия: пародии
патронус: патронус
патронусом: патронусом
пафосный: пафосную
певерелла: певерелла
певереллах: певереллах
певереллы: певереллы
пенелопа: пенелопы
первое: первого первое первых первыми
первокурсник: первокурсник
первоначальный: первоначальной
первый: первой первая первый
перебегать: перебегая
перевезти: перевезти
перевес: перевес
перевести: перевести переведена
перевод: переводе переводу перевод перевода
переводчик: переводчиков
переворот: переворот
перед: перед
передать: передал передать
перейти: перейти
перемирие: перемирие
переносить: переносит
переть: при
переходить: переходила
персонаж: персонажи
персональный: персональные
петтигрю: петтигрю
печатный: печатная
печать: печати
пещера: пещере
пий: пий
писать: писать
письмо: письмо письма
питер: питера
пламя: пламени пламенем
план: планы плане
планировать: планируют
плен: плен плену
пленить: пленить
пленница: пленницей
победить: победить
поведение: поведение поведения
повод: повод поводу
повсеместно: повсеместно
повстречаться: повстречались
погиб: погиб
погибать: погибает погибают
погибнуть: погибшем погибнут погибла
поговорить: поговорить
погоня: погони
погубить: погубил
подавить: подавить
подарить: подаренная
подарок: подарки подарков
поддаться: поддался
подделка: подделкой
поддержка: поддержку
поджигать: поджигают
подлинный: подлинным подлинными
поднять: поднявшего
подобный: подобных
подоспевать: подоспевает
подпольный: подпольной
подразумеваться: подразумеваются
подробность: подробностей
подробный: подробнее
подходить: подходят
подчинение: подчинению
пожертвовать: пожертвовать
пожиратель: пожирателями пожирателям пожирателей пожиратель пожирателем пожиратели
позволить: позволит
поздний: позже
поиск: поисках поиск поиску
поймать: пойманный
пойти: пойти
пока: пока
покарать: покарал
поклонник: поклонников
поклясться: поклялся
покупатель: покупателям
политик: политика политике
положить: положен
полтергейст: полтергейстах
полукровка: полукровка
полумна: полумна
полумной: полумной
полумну: полумну
получать: получает
получить: получило получить
поместье: поместье
помешать: помешать
помогать: помогал
помочь: помочь
помощь: помощью
понимание: понимании
понимать: понимает
понятно: понятно
пообещать: пообещал
попадать: попадают
попросить: попросили
попытка: попытка попытке
пора: пор
поражение: поражение
портал: портал порталом
портрет: портрету
посещать: посещают
поскольку: поскольку
последний: последнее последними последний последнего последние
последующий: последующих
посол: после
постоянно: постоянно
постоянный: постоянная
пострадать: пострадал
поступить: поступила
поступок: поступок
потерять: потерявшая
поттер: поттер поттера поттерах поттеров поттеру поттере
поттерца: поттерца
похищать: похищают
похожий: похожий
похоронить: похоронен
похороны: похоронах
почему: почему
почта: почта почте
почтить: почти
поэтому: поэтому
появиться: появились появилась
появление: появлением появления
появляться: появляется
правда: правду
правильно: правильно
правильный: правильного
править: править
правка: правки
право: праву
правый: право
превращаться: превращаются
предмет: предметы
предназначаться: предназначается
предполагаться: предполагалась
представиться: представились
представлять: представляющем представлял
предъявлять: предъявляя
предыдущий: предыдущее
предыстория: предыстория
презрение: презрения
преподаватель: преподаватели
преподавать: преподавать
прерывать: прерывает
прибывать: прибывают
привести: привести
придумать: придумай
признавать: признавая признававшей признавать
призрак: призрак
призыв: призывом
прийти: пришла
приказ: приказа
приказать: приказав
прикрыться: прикрылся
прилетать: прилетают
примечание: примечания
принадлежать: принадлежавший принадлежит
принимать: принимает принимают
принц: принц
притворяться: притворяется
приходить: приходят приходит
причинить: причинить
про: про
пробираться: пробираются
проблема: проблем
проболтаться: проболтался
проверить: проверенной проверить
проверка: проверки
проверять: проверяющая проверял
проверяться: проверялась
проводить: проводит
проводиться: проводился
провожать: провожают
проговориться: проговорилась
продажа: продаж продажу
продать: продано
проект: проектах
проживать: проживая
прозвище: прозвищу
произведение: произведения
производство: производство
произносить: произносить произносит
происходить: происходящем
прокат: прокат
проклясть: проклятого проклятое
проклятие: проклятия проклятие
проникать: проникают
проникнуть: проник
прорвать: прорвав
просить: просит прося
просмотр: просмотры
простить: простил простить
просто: просто
пространство: пространства
против: против
противник: противника
профессор: профессором профессора
процесс: процессе
прочий: прочее
прошлый: прошлом
прощение: прощения
прямая: прямая
прятаться: прячутся
публикация: публикации
путеводитель: путеводитель
пуффендуй: пуффендуй
пытать: пытает
пытаться: пытаются пытался пытается пытались
пытка: пытками
пять: пять
р: р
работа: работы
равнозначный: равнозначно
равный: равно
ради: ради
радиостанция: радиостанции
радовать: радуют
раз: разом
разгадать: разгадать
разгар: разгар
раздражительный: раздражительным
разлетаться: разлетаются
разный: разные
разобраться: разобраться
разорвать: разорвать
разоружить: разоружил
разработчик: разработчики
разрушать: разрушают
ранее: ранее
ранение: ранение
раскрывать: раскрывает
раскрыть: раскрыл раскрыть
расположение: расположение
расправляться: расправляется
распределять: распределяющая распределяющую
распространение: распространение распространением
рассказ: рассказы
рассказать: рассказал рассказала
рассказывать: рассказывает рассказывая
рассудок: рассудка
рваться: рваться
регулус: регулус
регулусу: регулусу
редакция: редакции
реддл: реддл
результат: результате
рекордный: рекордные
религиозный: религиозные
реликвия: реликвиями реликвии
ресурс: ресурсы
речь: речь
решать: решает
решающий: решающей
решить: решено
римус: римус
рита: риты
родитель: родителей
родной: родная
родные: родных
родовой: родовое
родственный: родственных
рождественский: рождественский
роза: роза
роковой: роковые роковую
роль: роль
роман: романов романа роман романы
рон: рону рона рон
росмэн: росмэн
роулинг: роулинг
рубеус: рубеус
рука: руку рука рук руки
руководство: руководством
русская: русских русская
русский: русском русский
русскоязычный: русскоязычных
русый: рус
руфус: руфус
рэдклиффа: рэдклиффа
сайт: сайта сайте сайты
сам: самого самой самом самих самим сама самое
самый: самую самый
сантиметр: см
саундтрек: саундтрек
сбегать: сбегает
сбежать: сбежал
сбить: сбить
сбросить: сбросить
свадьба: свадьбы свадьбе свадьбу
свалить: свалить
сведение: сведения
свежий: свежие
света: свет
свободный: свободной
сводный: сводный
свое: своих своему своего своими
свой: свой своей свою
связанный: связанные
связаться: свяжитесь
сгорать: сгорает
сгубить: сгубило
сдать: сдать
сдаться: сдаться
себя: собой
северус: северус
северуса: северуса
седьмой: седьмая седьмой
сейф: сейфа сейфе
секунда: секунду
семейство: семейством
семеро: семеро
семь: семь
семья: семье семьи
сентябрь: сентября
сердце: сердце
серебряный: серебряная
сериал: сериал
серия: серии серию серия
серый: серую
сестра: сестра
сесть: сел
сеть: сети
сидеть: сидящего
сила: силой сил силы
сильнейший: сильнейшая
символ: символом символ
символизировать: символизируя
сириус: сириуса сириусу
система: системе
ситуация: ситуацию
сказать: сказав
сказка: сказок сказки
скандальный: скандальное
сканер: сканера
скачать: скачать
скитаться: скитается
скитер: скитер
склад: склад
скончаться: скончался
скоро: скоро
скоропостижный: скоропостижно
скорпиус: скорпиус
скорый: скорой
скотт: скотта
скримджер: скримджер
скрывать: скрывает
скрываться: скрывается
скрытый: скрытый скрытые
скрыться: скрыться
следующий: следующее
слепой: слепом
слизерина: слизерина
слизерине: слизерине
слишком: слишком
словарь: словари
слово: слов слово
словосочетание: словосочетания
сломать: сломав
служба: службе
служебный: служебные
случай: случае случаях случай
случайный: случайная
слышать: слышал
смертельный: смертельное смертельные смертельная
смерть: смертью смерть смерти
смысл: смысл
снегг: снегг
снегга: снегга
снеггу: снеггу
снитч: снитч
снова: снова
снять: сняли
собираться: собирается
соблазн: соблазну
соблюдение: соблюдением
собственный: собственную
событие: события
сова: сова
совершеннолетие: совершеннолетия
совершеннолетний: совершеннолетним
совиный: совиная
совместно: совместно
согласно: согласно
содержание: содержание
сожаление: сожалению
создание: созданию
создать: созданные создать
сознание: сознание
сознаться: сознаться
сообщать: сообщает
сообщение: сообщение
сообщество: сообщество
сообщить: сообщила сообщить
сопровождать: сопровождавший
сопротивление: сопротивление сопротивления
соратник: соратникам
соседский: соседские
состояние: состоянии
сохранение: сохранением
союзник: союзников
спасать: спасая спасает
спасаться: спасаются
спасти: спасти
специальный: специально
список: списке список
спойлер: спойлеров
спокойствие: спокойствие
спора: споры
способный: способен
справка: справка
спрятать: спрятать спрятан
спустя: спустя
сработать: сработала
среди: среди
средний: среднего среднему
српски: српски
српскохрватски: српскохрватски
ссора: ссоры
ссылка: ссылка ссылками ссылки
становиться: становится
старт: старта
старший: старшего старшему
статистика: статистика
статуя: статуи
стать: стал стало станет
статья: статья статьи
стереть: стерев
стиль: стиля
стихотворение: стихотворение
стоить: стоят
сторона: стороны стороне
страйке: страйке
страница: страницы страница страницу страниц странице
странный: странное
странствие: странствий
страх: страх
страшный: страшную страшные
строить: строить
студент: студенты
стычка: стычки
суббота: субботу
суметь: сумел
сундук: сундук
существенный: существенными
существо: существа
существовать: существуют существовали существовала
счет: счете
считаться: считалось
сша: сша
сымитировать: сымитировав
сын: сына сын сыну
сюда: сюда
сюжет: сюжет
табу: табу
тайком: тайком
тайный: тайному тайная тайно тайную тайны
также: также
такой: такая таком
татарча: татарча
тедди: тедди
текст: текст
текущий: текущие текущая
тело: тела тело
телохранитель: телохранители
тем: тем
тематический: тематический тематические
тереть: три
термин: термина
терпеть: терпит
терять: теряет
тираж: тиражом
товарный: товарный
толк: толку
толстоватый: толстоватый
томас: томас
тонкс: тонкс
тонуть: тонет
тот: том ту тех те тот
точно: точно
травологию: травологию
требовать: требует требуя требуют
третий: третьей
треугольник: треугольник треугольника
тридцать: тридцать
трио: трио
трое: троих трое
троица: троицу троице троица
трофей: трофей
труд: трудом
трудность: трудности
туда: туда
тюрьма: тюрьме
убеждать: убеждает
убежище: убежище
убивать: убивая
убийство: убийством
убить: убитого убил убили убить убиты убила
уважение: уважением
уверять: уверяет
удачный: удачный
уехать: уехать
узнать: узнают узнать
узник: узник
уизли: уизли
указание: указанием
указать: указан
украсть: украден украсть украл
улетать: улетают
ультиматум: ультиматум
умереть: умереть
уметь: умела
умирать: умирал умирает
уничтожать: уничтожали уничтожает
уничтожение: уничтожение уничтожением
уничтожить: уничтожить уничтожен уничтожена
упырь: упыря
урок: уроки
условие: условий условия
успевать: успевают
успешный: успешно
устроить: устроили
утвердить: утверждено
утверждать: утверждает
утечка: утечки
ухо: ухо
уходить: уходит
участие: участие
участник: участниками участники
учащийся: учащиеся
учебник: учебника
ученик: ученики
учиться: учится учился
факт: факт
факультет: факультетов
фальшивый: фальшивый
фанат: фанаты
фантастика: фантастики
фантастический: фантастические
февраль: февраля
феникс: феникса
философский: философский
фильм: фильм фильмов фильма
финальный: финальная
финеаса: финеаса
фирменный: фирменная
флакон: флакон
флетчера: флетчера
флетчером: флетчером
фонд: фонд
форма: форме
форум: форум
фотография: фотографии
фраза: фразой
фред: фред
фэнтези: фэнтези
хагрид: хагрид
хагрида: хагрида
хвост: хвост хвоста
хижина: хижине
хобби: хобби
хогвартс: хогвартс
хогвартса: хогвартса
хогвартсе: хогвартсе
хогвартсу: хогвартсу
хогсмид: хогсмид
ход: ходу ходе
ходить: ходя
хозяин: хозяин хозяином
холланда: холланда
хороший: хорошими
хорошо: хорошо
хотеть: хочет хотел
храбрый: храбрейший
художник: художник
хьюго: хьюго
хэллоуинскую: хэллоуинскую
цель: целью цели
цикл: цикл
цитата: цитаты
цитировать: цитировать
час: час
частить: части
часть: частях часть
часы: часов
чаша: чашу
человек: человек людей
чемпионат: чемпионат
чердак: чердака
через: через
чернильный: чернильно
честный: честном
чинить: чинит
число: числе
чистилище: чистилище
чистокровность: чистокровности
читатель: читатели
читать: читает читать
член: членов членом члены
чтобы: чтобы
чудо: чудом
чужая: чужой
шальной: шальным
шармбатон: шармбатон
шелкопряд: шелкопряд
шестеро: шестеро
шея: шее
широкий: широкое
школа: школа школу школе школы
школьный: школьные
шляпа: шляпу шляпа
шрам: шрам
эвакуация: эвакуации
эвакуировать: эвакуирующий эвакуировать
эвакуироваться: эвакуируются
эдинбург: эдинбурге
экземпляр: экземпляров
экранизация: экранизация
электронный: электронной
элемент: элемент
эмбарго: эмбарго
энциклопедия: энциклопедии
эпилог: эпилог
эпоха: эпохи
это: этом это этим
этот: этой эта
являться: является являющийся
язык: язык языки языках языке
языковый: языков
якоб: якобы
яксли: яксли
январь: января
ярость: ярости
