абердинском: абердинском
август: августа
автор: авторы автор авторов
авторитет: авторитету
авторитетный: авторитетно
авторство: авторства
агрессивный: агрессивным
адам: адам адама
азбуковник: азбуковниках
азия: азии
айрширскому: айрширскому
актам: актам
алексей: алексея
аликорнов: аликорнов
аликорном: аликорном
алиса: алиса
алфавит: алфавиту
алхимик: алхимиков
альбом: альбом
амбера: амбера
американский: американский американским американского
аналогичный: аналогичное
анатомический: анатомической
англ: англ
английский: английская
анджей: анджей
андрей: андрей
антиквариат: антиквариат антиквариата
антилопа: антилопа антилоп антилопы
антиохийский: антиохийского
апрель: апреля апрель
аптека: аптекой аптеками
аргумент: аргументы
арденский: арденском
ареал: ареала
аристотель: аристотеля
арсеньев: арсеньев
артемида: артемиде
архив: архив
архивировать: архивировано
архивный: архивная
архитектор: архитектор
асприна: асприна
аста: аст
атаковать: атакующего
атлас: атласах
атласный: атласной
африка: африку африки
барельеф: барельеф
баташевых: баташевых
батлер: батлер
бегство: бегством
бежать: бегут
бейза: бейза
беларуская: беларуская
белово: белова
белозерский: белозерским
белый: белого белый
бенедикт: бенедикт
бер: бер
бестиарий: бестиарий бестиарии бестиариях
библейский: библейской
библиографический: библиографических
библия: библия библии
бивень: бивень
бигла: бигла
биолог: биологом
бир: бир
битва: битва
благовещение: благовещение благовещения
благодаря: благодаря
благоразумие: благоразумия
благословенный: благословен
ближний: ближнем
бог: бог
богатый: богатым
богиня: богине
боговоплощения: боговоплощения
боев: боевой
божий: божьей
болезнь: болезнях болезням болезни
болтиных: болтиных
больший: большим большая больших большею больше
большинство: большинстве
большой: велик большого большой
бонч: бонч
боргезе: боргезе
борис: бориса
борода: бородой
бородка: бородка бородкой
бороздка: бороздками
бороться: борются борется
борьба: борьбу
босх: босх
брат: братьев
брейденбахом: брейденбахом
бренце: бренце
брокгауза: брокгауза
бронзовый: бронзового
бруевичей: бруевичей
брюхо: брюхо
будур: будур
буйвол: буйвол
бурый: бурый
буря: буря
български: български
бывать: бывает
бык: бык быка быку
быстро: быстро
быстроногий: быстроногий быстроногих
быстрый: быстрое
бытовать: бытовала
быть: бывшем бывшей будучи были
важный: важную важное
варлааме: варлааме
вв: вв
ввержет: ввержет
ведьмак: ведьмак
ведьмачке: ведьмачке
век: века веков веку веке
великобритания: великобритании
великое: великого
великолепие: великолепие
венгерский: венгерских
венгрия: венгрия
веригин: веригиных
верить: верили
вернуться: вернувшись
версия: версия версии
весьма: весьма
вечный: вечного
взрослый: взрослую
вид: видом видах видов вид виде
видеть: видя
видное: видное
видывать: видывал
византийский: византийские
викиданных: викиданных
викимедиа: викимедиа
википедии: википедии
википедия: википедия
викисклад: викисклад
викискладе: викискладе
викисловаре: викисловаре
викисловарь: викисловарь
вилль: вилли
вино: вина
вить: витым
виштынец: виштынец
вклад: вклад
власть: власти
влияние: влиянием
вместе: вместе
вначале: вначале
внегда: внегда
внешний: внешние
внешность: внешностью
внимание: внимания
вновь: вновь
вод: воду воде
воды: воды
возбегнет: возбегнет
возвысить: возвышен
воззрение: воззрениях
возможность: возможности
возрастать: возрастает
возрождение: возрождения
война: войне
войти: войти
вокруг: вокруг
волос: волосы
волшебник: волшебники
волшебница: волшебницы
волшебный: волшебные волшебных
воля: волю
вонзаться: вонзался
вообще: вообще
воок: воок
вооруженный: вооруженного
воплощать: воплощал
воплощение: воплощением
вопрос: вопросы
вос: вос
воскрешение: воскрешение
восток: востоке
восточный: восточная восточной
восходить: восходящего
впервые: впервые
впечатление: впечатлением
враг: врага врагами враги
временить: времени
временник: временнике
время: времена время
все: всего всем
вскрай: вскрай
встретить: встретить
встреча: встрече
встречать: встречают
встречаться: встречается встречались встречаются встречался
вступать: вступал
вступительный: вступительной
всякий: всякий всякого
второй: второй
выбор: выбор
вывозить: вывозимый
выдать: выдали
вымереть: вымершего вымер
вымыслить: вымышленных
выпить: выпьет выпивший
вырасти: вырос
высказывать: высказывали
высокий: высочайшее высшим высоко
высота: высоту
выступать: выступал
выходить: выходящим
выясняться: выясняется
г: г
газета: газете
галлий: галлии
галльский: галльской
гарри: гарри
генетический: генетические
георгий: георгием
гера: герой
геральдика: геральдика геральдике
геральдический: геральдический геральдического геральдических
герб: гербе гербах герб герба гербы
гербовый: гербовой
германий: германия
героиня: героини героиня героиней
герой: героя герои
герцинском: герцинском
гинген: гинген
гингена: гингена
гл: гл
глава: главы
главное: главного главные главных
главный: главная главный главной главнейших
глаз: глазами глаза
гмюнд: гмюнд
гмюнда: гмюнда
гнать: гоним
го: го
гобелен: гобелен гобелены гобеленов
говорить: говорит
говориться: говорится
год: гг году лета лет годы года
годунов: годунова
голова: голову голова голове
голубой: голубые
гон: гона
горазд: гораздо
город: городов города
горячка: горячка
государственный: государственной государственных
государство: государствах государстве
гот: готов
гравюра: гравюр гравюрах
грамота: грамот
графство: графстве
греция: грецию греции
греча: греч
греческий: греческом греческой
грешник: грешников
грива: гриву
гримм: гримм
гриф: грифа
грозный: грозного
громадный: громадные
громокошки: громокошки
грудь: груди
грядущий: грядущее
д: д
давом: давом
дальний: дальних
дама: дама
даровать: даровали
дата: дата
датский: датская
датчанин: датчанами
дать: данный данную дал дать
два: два две двух
двор: двора дворе
дворец: дворца дворцов
дворянский: дворянских
двуглавого: двуглавого
двуглавым: двуглавым
двусторонних: двусторонних
де: де
дева: девы дева девой
девственница: девственница девственнице
девушка: девушки девушка
девять: девяти девять девятью
действовать: действовать
делать: делать
делаться: делался
делиться: делятся
день: дней дня
дерево: дерева дерево
деталь: деталь
джейк: джейк
джоан: джоан
дикий: дикий диких дикое
длинный: длинным длинные длинный
добро: добро
довод: доводам
договор: договоров
дол: долу
долгий: долгое долгую
долгодрова: долгодрова
должен: должен
доменикино: доменикино
доп: доп
дополнение: дополнения
дополнительный: дополнительные
дорогой: дорого
доспех: доспех
достаточно: достаточно
доступный: доступен
др: др
драгоценный: драгоценное
дракон: дракона драконом драконов дракон
драконий: драконья
драма: драме
древесина: древесину
древнеегипетский: древнеегипетских
древние: древних
древний: древнем древней древняя
древность: древностей древности
друг: друг другу
другой: другую другими другие других другого
дружба: дружба
дуань: дуань
дух: дух
дюве: дюве
е: е
ева: ева
евр: евр
евразийский: евразийской
евразия: евразии
еврей: евреев
еврейский: еврейская
европа: европе европу
европейский: европейские европейской
егда: егда
единорог: единорогом единорогов единорог единорога единороге единорогами единорогах единорогу единороги
единство: единство
ездить: ездили
ездовой: ездового ездовых
елизавета: елизавета
ермак: ермака
ермолов: ермоловых
естественный: естественной
естествознание: естествознанию
ефрона: ефрона
жан: жан
жанр: жанров
жвачное: жвачных
желязны: желязны
женский: женское
жестокий: жестоко
живой: жив живым живых
животное: животного животным животное животных животные животными животном
жидкость: жидкость
жизнь: жизни жизнь
жолкевский: жолкевский
жорж: жорж
журнал: журнал
завоевание: завоевание
завтрашний: завтрашнего
загадка: загадка
заглавный: заглавная
зазеркалье: зазеркалье
закипать: закипала
заключать: заключает
заманить: заманить
заменить: заменить
заметить: заметил
занимать: занимать
запад: западе
западный: западной
записка: записках
запись: запись
заполнить: заполнить
запотевать: запотевал
запятнать: запятнан
зарегистрировать: зарегистрированный
заслуживать: заслуживает
заставка: заставке
заставлять: заставляют
засыпать: засыпал
затмевать: затмевал
затормозить: затормозить
захватить: захваченный
защититься: защититься
заявление: заявление
зверинец: зверинец
звериный: звериная
зверь: зверь
здравие: здравия
земля: землю
земной: земных
зерно: зерном
зло: зло зла
злой: злую
змея: змеи
знак: знак
знаменитый: знаменитых
знаменовать: знаменует
знамя: знамени
значение: значения значение
значительный: значительную
золотой: золотым золотых золотой
зоология: зоология
зубр: зубр
иван: ивана
игра: игре игры
играть: играют играл
идти: идти шла
иероним: иероним
избранный: избранные
известный: известные
изгнать: изгнаны
издавна: издавна
издание: издание
издать: изданной
изделие: изделия
изо: изо
изображать: изображающих
изображаться: изображался изображается
изображение: изображениями изображения изображением изображение изображениям
изобразительный: изобразительном изобразительных изобразительное
изобразить: изображены изобразил
изогнутый: изогнутым
изящество: изящества
иисус: иисусом
иллирия: иллирии
иллюстрация: иллюстрациях иллюстрация
иллюстрировать: иллюстрированная
имать: имать
именно: именно
именоваться: именуется
иметь: имеющее имел имеющих имеют имея имеет
император: императоры
империя: империи
имя: имена имени
индий: индии
индийский: индийских
индикоплов: индикоплов
индрик: индрик
индский: индской
индус: индусов
иногда: иногда
иной: иных иное
инорога: инорога
инструмент: инструменты
интерес: интерес
интерпретация: интерпретация
иоанн: иоанна
иоасаф: иоасафе
иов: иов
ирландия: ирландия
искорка: искорка
искусственно: искусственно
искусственный: искусственных
искусство: искусстве искусств искусства искусство
искусствовед: искусствоведов
исламский: исламского
использование: использования
использовать: использовал использующие использовали используют
использоваться: использоваться
истолкование: истолкование
историк: историк
исторический: историческим
история: историях история истории
источник: источников источник
италия: италии
иустин: иустины
июль: июля
июнь: июня июне
й: й
йетс: йетс
йорк: йорке
кабаний: кабаний
кавалерист: кавалериста
каждый: каждой
казаться: кажутся
казахстан: казахстана
какой: какие
камень: камень
канада: канады
канадский: канадской
карать: карает
каркадан: каркадан
каркаданн: каркаданн
карман: карману
картазон: картазон
картазоны: картазоны
каталанский: каталанская
каталог: каталогах
категория: категории
качество: качество качестве
керри: керри
кино: кино
кирилло: кирилло
кирин: кирин
китаец: китайцев
китайский: китайского
клавдий: клавдий
клык: клык
клюни: клюни
книга: книгах книги книге
книжный: книжной
князь: князя
ковчег: ковчеге ковчег
код: код
кодекс: кодекс
козел: козла
козий: козьей
козлиный: козлиной
козловский: козловских
козьма: козьма
коллекционирование: коллекционирования
коллекция: коллекция
компания: компании
компьютерный: компьютерные
конец: конце конец конца
конфиденциальность: конфиденциальности
конфуция: конфуция
конь: коню коня конь
копия: копия
копытное: копытное
копыто: копытами копыта
копье: копьем
корвину: корвину
коровий: коровьи
королевский: королевской
королевство: королевства
король: король
корона: корону
короткий: короткими короткий
кость: кости
косуля: косули
который: которое которого которые которых который
крайне: крайне
крайний: крайней
красноярск: красноярска
красный: красную
краткий: кратко
кровь: крови
кроме: кроме
круг: круг
крупный: крупнейших
крылатый: крылатых
крыло: крыльями крылья
ктесий: ктесий
ктесия: ктесия
кудрявцев: кудрявцевых
кук: куки
культура: культуре
купец: купцы
кусок: кусок
кухарка: кухарку
кэрролл: кэрролла
кювье: кювье
ларионов: ларионов
лата: лат
лев: льва
левый: левой лев
легенда: легендах легенда легенды
легендарный: легендарное легендарные
легко: легко
ледниковый: ледниковый ледникового
лей: лея
лекарь: лекарем
лекция: лекции
ленский: ленский
лес: лесу
лесной: лесное
лечить: лечить
лжедмитрия: лжедмитрия
линь: линь
литва: литва
литература: литература литературе
литературный: литературной литературном
лихорадка: лихорадки
лицензия: лицензии
личной: личном личная
личный: личный
лишниц: лишниц
лишница: лишница
лишь: лишь
ло: ло
лоб: лба лбу
ловушка: ловушку
логотип: логотипах
ложиться: ложился
ломаться: ломался
лонг: лонг
лориса: лорис
лошадь: лошади лошадь
лысьва: лысьва лысьвы
львиный: львиный львиным
льюис: льюиса
любой: любой
лютик: лютик
м: м
магический: магической
майнц: майнце
македонский: македонски
малый: малой малый
мальчик: мальчиков
мамонт: мамонта
мансуров: мансуровых
маргарета: маргарет
маржерета: маржерета
мариинский: мариинской
мария: мария марией марии
марта: марта март
мартена: мартен
мартин: мартина
марфо: марфо
маскевич: маскевич
масло: масло
массивный: массивного
мастер: мастер мастеру
материал: материал
мая: мае мая
мегафауны: мегафауны
медиафайлы: медиафайлы
медиевистика: медиевистики
медяный: медяно
меликовых: меликовых
меньший: меньшей
мера: мере
меркине: меркине
место: место
месячный: месячный
метафорический: метафорическое
метод: метод
метрополитен: метрополитен
миниатюра: миниатюре
мир: мира мир мире
мистический: мистическая
миф: миф мифах
мифический: мифическое мифическая мифических
мифологический: мифологическая мифологический мифологические
мифология: мифологии мифология
михаил: михаила михайловича михаил
младший: младший
мнение: мнение
много: более
мобильный: мобильный мобильная
можно: можно
молодая: молодой
молодость: молодость
момент: момент
монашеский: монашеской
монета: монетах
морить: моря
моровой: морового
москва: москве москва
московский: московский московского московском
мотив: мотивов
мочь: мог могут могло могла
мудрец: мудреца
мудрость: мудрость
муж: мужа
мужской: мужское
музей: музей
мультипликация: мультипликация
мультсериала: мультсериала
мультсериале: мультсериале
мультфильм: мультфильме
мураками: мураками
мы: нами
мэн: мэн
н: н
навеки: навеки
навигация: навигации навигация
навсегда: навсегда
навстречу: навстречу
над: над
надлежать: надлежит
назад: назад
название: названий названиях
называть: называет
называться: называется
наиболее: наиболее
накости: накости
наличник: наличниках
намерение: намерение
нападать: нападают
написать: написал
напоминать: напоминал
например: например
напрямую: напрямую
наравне: наравне
нарвать: нарвала нарвал
нарост: нароста
наряд: наряду
наслаждение: наслаждений
настолько: настолько
настоящий: настоящий
насчитываться: насчитывалось насчитывается
наталия: наталия
натуралист: натуралист
наука: науки
научный: научно
находиться: находятся находились
начало: начала
начинать: начиная
нашлемник: нашлемник
небесный: небесных
небо: небе
небольшой: небольшие небольшими
невидимый: невидимый
недостаток: недостатков
нежить: нежен
неизлечимый: неизлечимой
некий: некое
некоммерческий: некоммерческой
некоторые: некоторыми некоторых некоторые
немаловажный: немаловажную
немощь: немощи
необычайно: необычайно
необычный: необычный
неопр: неопр
непарнокопытный: непарнокопытных
непобедимый: непобедим
непомнящий: непомнящий
непорочность: непорочности
непременно: непременно
непримиримый: непримиримы
несколько: несколько
нести: несущие несущую
никогда: никогда
никольский: никольской
новелла: новелле новеллы
новый: новые
нога: ногами ноги
ноев: ноев
норвежец: норвежцами
норвежский: норвежская
носить: носящие носящий
носорог: носорога носорогом носорог
ноябрь: ноября
нрав: нравом нрав
нью: нью
ньюфаундленд: ньюфаундленд
об: об
обитать: обитающем обитающего
обитель: обители
обладать: обладает обладающий
область: областей
обнаружить: обнаружен
обновление: обновление
оборонительный: оборонительном
образ: образу образом
обращение: обращения
обрести: обрела
обсуждение: обсуждение
общественный: общественных
общество: общества обществам
общий: общем
обыгрывать: обыгрывает
обычно: обычно
обычный: обычных
огнев: огневой
огромный: огромный
оделла: оделл
один: одной одна одного один одному одним
одиннадцатый: одиннадцатой
одиночество: одиночеству одиночества
однако: однако
однорогие: однорогие
однорогими: однорогими
однорогих: однорогих
однорогом: однорогом
ок: ок
оканчивать: оканчивая
около: около
оконный: оконных
окрас: окраса
окрестность: окрестностях
окутываться: окутываясь
оленеподобный: оленеподобный
олений: оленьи
олень: олене оленя
олимп: олимп
олма: олма
ольденбург: ольденбург
они: им них
онлайн: онлайн
оно: оно
опасный: опасное опасны
операция: операции операция
описание: описанию описание описании
описать: описан
описывать: описывает описывали
описываться: описывается описывалось
организация: организации организаций
орел: орлом орла
орикс: орикс
оружие: оружия
орфей: орфею
осел: осла ослами ослах ослов
осмотрительность: осмотрительности
основать: основан
основной: основными
особенно: особенно
особенность: особенности
оставить: оставить
остальной: остальная
остаться: остаться оставшись
остафьевых: остафьевых
осторожность: осторожности
острый: острыми острую
осыпать: осыпанный
отбрасывать: отбрасывающий
отважный: отважному
ответственность: ответственности
отдельный: отдельных
отец: отца
отказ: отказ
отказаться: отказавшихся
отклонение: отклонения
отличаться: отличается
отличие: отличие
отмечаться: отмечается
относиться: относится
отношение: отношении
отправляться: отправляется
отрава: отраве
отравить: отравленную отравлен
отразиться: отразился
отредактировать: отредактирована
отросток: отростка
отчасти: отчасти
охарактеризовать: охарактеризованный
охота: охоту охота
оценивать: оценивали
очень: очень
ошейник: ошейника
ошибка: ошибке
падуанский: падуанской
палаццо: палаццо
палочка: палочек
памятник: памятниках памятнике
пантагрюэль: пантагрюэль
панцирь: панцирем
пао: пао
пар: пара
париж: париж париже
пегас: пегаса пегасов
первое: первым первое первые
первый: первой первая
перевод: переводов
переводчик: переводчиками
передать: передано
передний: передними
перейти: перейти
переписка: переписка
перерождение: перерождение
пересадить: пересажены
переть: при
период: периода период
персидский: персидском персидский
персонаж: персонажами персонажи персонажей
персональный: персональные
перспектива: перспективы
печатный: печатной печатного
печать: печатью печать печати печатях
пещерный: пещерной
пират: пиратов
писатель: писателями писателя писатель писателей
писать: писал
письмо: письма
питать: питающий
питаться: питается
питер: питера
питье: питья
пища: пищи
плавать: плавающий
пламя: пламенем
плен: плен
пленение: пленение
пленить: пленил
плиний: плиний
плиния: плиния
плыть: плыть
поведать: поведал
поведение: поведения
повестить: повести
повесть: повесть
поветрие: поветрия
повзрослеть: повзрослевшему
повод: поводом
погибнуть: погибнуть
погоня: погони
подать: поданный
подверженный: подвержен
подземелье: подземелье
поднять: поднятыми
подобный: подобен подобная
подробный: подробнее
подружия: подружия
подтверждать: подтверждает
поединок: поединке
пожаловать: пожалуй
пожертвовать: пожертвовать
поздний: позже
поиск: поиск поиску
поймать: поймать
показаться: показаться
покорение: покорении
покровский: покровского
покрыть: покрыт
покупка: покупка
политик: политика
полный: полной
положение: положении
получение: получения
получить: получила получил получены получить
польский: польский
поляк: полякам поляками
полярный: полярных
поместить: поместил помещена
помещать: помещает помещали
помещение: помещением
помор: поморами
помощь: помощью помощь
пони: пони
понять: понять
поп: попов
попадаться: попадающиеся попадался
попасть: попавшим попав попасть
попросить: попросил
популяризатор: популяризатора
популярность: популярность
популярный: популярной популярен
порой: порой
порошок: порошок порошка
портал: портал
портняжка: портняжка
порча: порчи
поскольку: поскольку
последний: последнее последняя последний последней
последующий: последующем
послужить: послужило
посол: после
посох: посохи
посреди: посреди
посредство: посредством
постоянный: постоянная
потенция: потенцию
потомок: потомков
поттер: поттер
поттерианы: поттерианы
поэма: поэму
появиться: появился
появление: появление
появляться: появляться появляется
правитель: правителя
править: правило править
правка: правка правки
правление: правлением
правосудие: правосудия
празднество: празднество
прато: прато
пребывать: пребывает
предание: преданию
предмет: предметы
предок: предков
предоставить: предоставлена
предохранять: предохраняющим
предположение: предположения предположение
представитель: представитель
представить: представлен
представиться: представились
представлять: представляют представляет
пресс: пресс
префектура: префектур
приближение: приближении
привилегия: привилегию
пригодный: пригодной
придать: придал
приманка: приманкой
примерный: примерно
примечание: примечания
принадлежать: принадлежит
принц: принцев
приобрести: приобрела
приписывать: приписывали
природоохранный: природоохранный
прислониться: прислонившимся
присутствовать: присутствует
притча: притча
про: про
проваливаться: проваливается
провинция: провинции
продаваться: продавался
продлевать: продлевал
продолжать: продолжает
проект: проектах
прозвище: прозвище
произведение: произведении
произвести: произведена
проклясть: проклят
промеж: промеж
прообраз: прообразом прообраз
пропарывать: пропарывал
просмотр: просмотры
пространство: пространства
просуществовать: просуществовать
против: против
противник: противником
противоположный: противоположным
противоядие: противоядии
профиль: профиль
процветание: процветание
процветать: процветала
прочий: прочее
пруд: пруду пруда
прямая: прямым прямой прямыми
прямой: прямо
пс: пс
псмит: псмит
пустыня: пустыню
путешествовать: путешествовать
пушкино: пушкина
пьеса: пьесе
пять: пять
рабле: рабле
работа: работы
равнозначимой: равнозначимой
радость: радость
развитие: развитии
раздвоить: раздвоенными
разделять: разделяющего
различать: различать
различный: различных
размер: размеры размером
разновидность: разновидностях
разный: разных разные
разработчик: разработчики
разрушение: разрушения
разумный: разумным
райнер: райнер
рамка: рамках
рамош: рамош
рамоша: рамоша
ранний: ранних ранним
расправляться: расправляются расправлялся
рассказ: рассказы
рассказов: рассказов
рассказывать: рассказывает
расти: растет растут растущим
расходиться: расходится
расширение: расширение
рафаэль: рафаэль
рая: рай рая
ре: ре
реально: реально
реальность: реальности реальность
реальный: реального реальный
редко: редко
резкий: резко
результат: результате результатом
ресурс: ресурсы
рефл: рефл
ридигер: ридигер
рильке: рильке
рим: рим риме
римский: римской римский
рисунок: рисунки рисунков рисунок
ричард: ричард
роберт: роберта роберт
ровный: ровно
рог: рогом рога рог рогов рогами роге
роговой: роговой роговых
роджер: роджер
родина: родиной
родитель: родители
родиться: родившийся
родовой: родовых
родственный: родственных
роды: родов
рождение: рождение рождением
розовый: розовый
роль: роль
роман: романов романе романа
романов: романова
романовский: романовских
романтический: романтической
роспись: росписи
российский: российских российская
россия: россия
рот: ртами
роулинг: роулинг
ртуть: ртуть
рубрика: рубрика
рука: руки
русская: русские русских русскими
русский: русский
русый: рус
русь: русь
ручной: ручным
рыба: рыбы
рыжий: рыжего
рыхлый: рыхлый
рыцарь: рыцаря
рээм: рээм
ряд: рядом
сад: сад
сайт: сайте
салтыков: салтыковых
сам: самого
самец: самцов самец самцы
самка: самок самка
самый: самым самых
санкт-петербург: спб
сантиметр: см
сапковский: сапковский
сбываться: сбывался
сведение: сведения
свежий: свежие
света: света
свирепеть: свирепеют
свирепый: свирепое
свободный: свободной
свободолюбивый: свободолюбивое
свое: своих своим
свой: свой своей
свойство: свойством свойство свойства
сворачивать: сворачивал
связанный: связанные
связаться: свяжитесь
связывать: связывает
связь: связи связь
святой: святым святых святой
священный: священные
себя: собой
сегодня: сегодня
сезон: сезон сезона
семантика: семантика
семь: семь
семья: семьи
сен: сен
сентябрь: сентября
серебряный: серебряных
сериал: сериале
серия: серии серий серию серия
сечжи: сечжи
сибирь: сибири
сила: силу сил
символ: символом символов символ
символизировать: символизировали символизировал символизируют символизирующие символизирует
символика: символики символике символика
симметричный: симметрично
сиротеть: сиротеет
система: системе
сказка: сказках сказок сказки
сказочный: сказочный сказочная
скала: скалах
скачать: скачать
скачок: скачки
скидать: скидает
скипетр: скипетры скипетр
скорый: скорее
скрепляться: скреплялись
скрытый: скрытые
славянский: славянский славянские
след: след
следующий: следующая
слейтер: слейтер
словарь: словари словарь
слово: словам слово
сложение: сложения
слон: слону слон
слоновий: слоновьи
служба: службу
служебный: служебные
служилый: служил
служить: служить
случай: случае случаях случай
случайный: случайная
случаться: случается
смертоносный: смертоносного
смерть: смерть смерти
смесь: смесь
смирение: смирение
смотреть: смотреть
смутный: смутное
смягчаться: смягчается
сначала: сначала
снег: снег
снова: снова
собрание: собрание
событие: события
совмещать: совмещающее
современный: современных современной
согласно: согласно
согласный: согласна
содержание: содержание
содержаться: содержится
созвездие: созвездие
создать: созданный создать
созерцать: созерцает
сокращение: сокращениями
солдат: солдату
солнце: солнца
сонет: сонеты
сообщать: сообщал сообщает
сообщение: сообщения
сообщество: сообщество
сообщить: сообщить
сородич: сородичам
соскоблить: соскобленный
составитель: составитель
составлять: составляют
состояние: состоянии
сохранение: сохранения сохранением
сочетание: сочетании
сочинение: сочинениях
сочувствие: сочувствие
спасать: спасают
спасаться: спасаясь
спасти: спасти
спастись: спасется
спинка: спинке
спиралевидный: спиралевидным
спиральный: спиральным спиральными
спорный: спорной
справедливость: справедливость
справедливый: справедливого
справка: справка
среди: среди
средневековый: средневековые средневековых средневекового
средний: средние
средство: средством
српски: српски
српскохрватски: српскохрватски
ссылка: ссылка ссылками ссылки
становиться: становится
старина: старину
старший: старшего
старый: старая старый
статистика: статистика
статуя: статуя
стать: стал стать стали
статья: статья статьи
ствол: ствола
стеклянный: стеклянный
стен: стене
степь: степей
стивен: стивен
стоить: стоят стоит
столетие: столетии столетию
сторона: сторону
стр: стр
страбон: страбон
страна: страны стране страна страну стран
страница: страницы страница страницу странице
страшный: страшен
стрекаловых: стрекаловых
стремительный: стремительный
стремиться: стремится
стремление: стремления
строгость: строгости
ступить: ступить
субстанция: субстанцией
сумеречный: сумеречная
суровость: суровости
существо: существо существ существа существом
существование: существование существования
существовать: существуют существующими существует существовало
сходство: сходство
схожий: схожей схожи
считать: считал считают
считаться: считается считались считался
сын: сына сыновей
сюда: сюда
сюжет: сюжет сюжета
сюжетный: сюжетное
т: т
также: также
такой: таким такими
татищев: татищев
текст: текст
текущий: текущие текущем
телевидение: телевидение
тело: тело телом
тереть: три
термин: термина
течение: течение
тимофеев: тимофеева
тип: типов тип типам
ткань: ткани
товар: товара
товарный: товарный
топор: топорах
торговля: торговля
торговый: торговой
тормоз: тормозов
тоскана: тоскане
тот: ту
трава: траву
традиция: традициях
трансплантация: трансплантации
требовать: требующие
третий: третий
третье: третьего
три: тремя
триптих: триптиха триптихе
трон: трона
труд: трудах
туловище: туловище туловищем
тулпар: тулпар
тургенев: тургеневых
туфанова: туфанова
тысяча: тысяч тысячи
уайт: уайт
убивать: убивал
убийство: убийство
уверенность: уверенность
увидать: увидав
угадать: угадал
удалять: удаляющими
удаться: удастся
удача: удача
удержать: удержать
удивиться: удивился
уединение: уединению
уздечка: уздечкой
уильям: уильям
уильямс: уильямса
уйти: уйти
указание: указанием
указать: указан
украшать: украшало
укреплять: укреплял
укротить: укротить
укушения: укушения
улица: улице
умирать: умирает
университет: университета
уподобить: уподоблен
упоминание: упоминание
упоминать: упоминает
упоминаться: упоминаются упоминалось упоминался
упомянуть: упомянувшего
употреблять: употребляли
употребляться: употреблялся
усеять: усеян
условие: условий условия
успеть: успеть
утверждение: утверждениями
уточнение: уточнения
уточнить: уточнить
ухо: уши
участие: участие участии
учение: учение
ученость: учености
ушию: ушию
уязвимость: уязвимости
фантаст: фантаст фантаста
фантастика: фантастики
фантастический: фантастических
фарнезе: фарнезе
фасад: фасад
февраль: февраля
феникс: фениксом
фигура: фигурой фигур фигура
фигурка: фигурку
физиолог: физиологе
философский: философский
фильм: фильме
фонд: фонд
форум: форум
франклин: франклином
франсуа: франсуа
франция: франция
французский: французский
фреска: фреска
фримен: фримен
фукуи: фукуи
фунт: фунтов
фэнтези: фэнтези
характер: характер
харуки: харуки
харутоси: харутоси
хвост: хвост хвоста хвостом
хирургический: хирургический
хлеб: хлеб хлеба
хороший: лучшие
хотеть: хочет
храбрый: храбрый храброго
храм: храма
христианский: христианских
христос: христа христом
художественный: художественном художественная художественных
царить: царя
царский: царский
царствование: царствования
царь: царей
цезарь: цезарь
целительный: целительным
целый: целого
цельный: цельных цельного цельной
цениться: ценился ценилась
центр: центр
центральный: центральной центральную центральный
церемониальный: церемониальных
цзин: цзин
цзюэ: цзюэ
ци: ци
цивилизация: цивилизации
цикл: цикл
цикля: цикле
цилинь: цилинь
цири: цири
цирлот: цирлот
цитировать: цитировать
частить: части
часто: часто
часть: частью частей частях часть
чашечка: чашечками
чаща: чаще
чей: чьи
чеканиться: чеканился
человек: человек людьми человека людей люди людям
червь: червь
череп: черепа
черепаха: черепахой
честность: честность
четверо: четверых
четыре: четыре
чехия: чехия
чжун: чжун
чис: чис
чистота: чистоты
читатель: читатель
читать: читать
чрезвычайный: чрезвычайно
чтение: чтения
чтобы: чтобы
чувство: чувства
чудесный: чудесным чудесного
чудо: чудес чудо
шаблон: шаблонами
шварцвальде: шварцвальде
швебиш: швебиш
шведский: шведской
швейцария: швейцария
шекспир: шекспир
шеншиных: шеншиных
шепард: шепард
шерстистый: шерстистого
шесть: шесть шести шестью
шея: шее
шип: шипами
шонгауэра: шонгауэра
шотландия: шотландии
шотландский: шотландский
шпалера: шпалеры
штат: штата
шу: шу
шувалов: шуваловых
щит: щите щит
щитодержатель: щитодержатель щитодержателями щитодержателей
щусев: щусев
э: э
эвенк: эвенков
эгер: эгер эгера
эдем: эдеме
эйнхорн: эйнхорн
экз: экз
экзотический: экзотическая
экранизация: экранизация экранизации
эксмо: эксмо
эласмотерий: эласмотерия эласмотерий
элемент: элемент
элиан: элиан
эм: эм
эмблема: эмблемой
энциклопедический: энциклопедический
энциклопедия: энциклопедия энциклопедии
эпилепсия: эпилепсии
эпоха: эпоху
этнолингвистический: этнолингвистический
это: это этим
этот: этой этих эта эту
эттиндаузен: эттиндаузен
эффективный: эффективно
ю: ю
южный: южной южнее
юлия: юлий
юрген: юрген
юрченко: юрченко
юстина: юстина
являться: являлся является являются
яд: яд яда
ядовитый: ядовитая
язык: язык языках
якоб: якобом якобы
январь: января январь
янтарный: янтарного
японский: японский японского
яхве: яхве
яхонт: яхонтами
