авад: авада
август: августа
австралия: австралии
автор: автор
авторство: авторства
адский: адским адский
азкабан: азкабан
азкабана: азкабана
азкабане: азкабане
акромантулом: акромантулом
албания: албании
албанский: албанского
алфавит: алфавиту
алхимик: алхимиком
альбус: альбус
альбуса: альбуса
альбусом: альбусом
амелия: амелии
анаграмма: анаграммы анаграммой анаграмме
англ: англ
анимагом: анимагом
антагонист: антагониста антагонист
арагог: арагог
арестовать: арестован
аристократический: аристократической
армия: армией
артефакт: артефакт артефактов
архивировать: архивировано
астория: астории
аудитория: аудиторию
бабушка: бабушки
банк: банке
барда: барда
барти: барти
барьер: барьер
безжизненный: безжизненное
безобразный: безобразного
безопасность: безопасность
безопасный: безопасное
безоружный: безоружная
безответный: безответно
беларуская: беларуская
беллатриса: беллатриса
белый: белое
беременность: беременности
берт: берты
бессмертие: бессмертия
бессмертный: бессмертные бессмертным
бидля: бидля
биография: биография
битва: битвой битва битве битвы
благодаря: благодаря
бледный: бледная
ближний: ближайшая
близкие: близкие
блэк: блэк
богатый: богатую богатой
боггарт: боггарт
боггартом: боггартом
больший: большая больше
большинство: большинство
большой: большое
боунс: боунс
бояться: боятся боится боялся боимся
брат: братом
бреммер: бреммер
бреммера: бреммера
британский: британском
бродяга: бродяга
бросить: бросил
бруствер: бруствер
будущее: будущее
бузинный: бузинной бузинную бузинная
буква: букв
български: български
бывать: бывают
быть: бывшим будучи бывший бывшего были
бэрк: бэрк
вальд: вальд
вариант: вариант
василиск: василиска василиск
вд: вд
великан: великанам великанов
великобритания: великобритания
вернуться: вернуться
верный: верный
версия: версия
весьма: весьма
вещь: вещи
взять: взять
вид: видом виду вид виде
видеть: видят
видно: видно
викиданных: викиданных
викимедиа: викимедиа
википедии: википедии
википедия: википедия
викисклад: викисклад
викискладе: викискладе
викия: викия
вино: вину
вклад: вклад
владелец: владельцем
владеть: владел
власть: власти
влюбить: влюблена
вместе: вместе
вместо: вместо
внешне: внешне
внешний: внешний
внешность: внешности
вновь: вновь
внутренний: внутренне
внутри: внутри
военачальник: военачальники
военный: военные военный
возвращать: возвращает
возвращаться: возвращается возвращаются
возвращение: возвращение
возможность: возможность
возобновляться: возобновляется
возраст: возрасте
возродить: возродить
возродиться: возродился
возрождение: возрождения возрождению
война: война
войти: войти
вокзал: вокзале
волан: волан
волдеморт: волдеморт
волос: волосами
волшебник: волшебника волшебников волшебник волшебники волшебниками
волшебница: волшебница волшебницу
волшебный: волшебной волшебные волшебных волшебного волшебная волшебный волшебным
волшебство: волшебства волшебство
воля: воле
воплощение: воплощение
воспитываться: воспитывался
воспоминание: воспоминаниях воспоминании воспоминаний
восстать: восставший
впадина: впадине впадина
впалый: впалыми
впервые: впервые
впрочем: впрочем
временить: времени
временно: временно
временной: временную
временный: временный
время: временем время
все: всех всего
всеволод: всеволод
вселенная: вселенная вселенной
вселиться: вселился
всемогущий: всемогущим
вскоре: вскоре
вскрыть: вскрыл
вспомнить: вспомнит вспомнить
вспять: вспять
встретить: встретил
встречаться: встречается
вступать: вступает вступать
второе: вторым втором второе
вход: вход
выбрать: выбранное выбрал выбран
выведать: выведал
выглядеть: выглядит
выжить: выжить
вызвать: вызванным
выйти: вышедшей
вымыслить: вымышленные вымышленный
вынудить: вынужден
выпустить: выпустил
вырасти: выросшему выросла вырастет
выходить: выходить
выходка: выходок
выяснить: выяснил
выясниться: выяснилось
выясняться: выясняется
вэнс: вэнс
гарри: гарри
гаррика: гаррика
геллерт: геллерта геллерт
гермиона: гермиона гермионой
героизм: героизме
герой: героев
гигантский: гигантского
гипнотизировать: гипнотизирующим
глава: главы глава
главный: главный
главый: главой
глаз: глазами глаза глазах
глубокий: глубоким
гоблин: гоблинов
говорящий: говорящего
год: году годов лет год годы года
годрикова: годрикова
годриковой: годриковой
гойлом: гойлом
голос: голос
голубой: голубые
гораций: горация
горбина: горбин
готовить: готовить
готовый: готова
гранить: грани
график: графики
грегор: грегоровича грегорович
грейнджер: грейнджер
грим: гримом
грин: грин
гриффиндора: гриффиндора
гриффиндорца: гриффиндорца
грозный: грозного
громкий: громкими
группа: группу
грюма: грюма
д: д
дамблдор: дамблдор
дамблдора: дамблдора
дамблдором: дамблдором
дамблдору: дамблдору
дар: даров дары
даровать: дарует
дата: дата
дать: данный дать
двое: двоих
двор: дворе
де: де
девочка: девочка
девушка: девушки
дедушка: дедушки
действовать: действовать действующему
декабрь: декабря
декан: декана
делать: делает
дело: деле
дельфи: дельфи
дементоры: дементоры
день: дней
департамент: департамента
деревня: деревню
десятилетие: десятилетий
десять: десять
деть: день
дж: дж
джеймс: джеймс
джинни: джинни
джоан: джоан
джоркинс: джоркинс
диадема: диадемы диадеме диадему диадема
диггори: диггори
диктатор: диктаторы
диллэйн: диллэйн
дилогия: дилогия
директор: директором
дискриминировать: дискриминировать
дитя: дитя
длинный: длинными длинные
дневник: дневник дневника
добровольно: добровольно
догадаться: догадавшись
док: док
долгий: долгие
долгопупс: долгопупс
долгопупса: долгопупса
долгопупсом: долгопупсом
должен: должен
должность: должности должность
дом: домом
дополнительный: дополнительные
допустить: допустить
достигнуть: достигший
доступный: доступен
дочь: дочь дочери
драко: драко
древность: древности
друг: друзья друзьями друг другом друга
другой: другим другими другие других
дубляж: дубляж
думать: думал
дурмстранг: дурмстранг
душ: душу души душа
дуэль: дуэль
дэвид: дэвид
дюйм: дюймов
дядя: дядю дядя
единорог: единорога
единственный: единственное единственным единственных
еиналеж: еиналеж
жаба: жаба
желание: желание
женщина: женщина
жестокий: жестоких
жестокость: жестокость
живой: жив живое
жизнь: жизни жизнью
журнал: журнал
заблаговременно: заблаговременно
забрало: забрал
забрать: забравшим
завершать: завершающем
завершаться: завершается
зависимость: зависимости
заглавный: заглавная
задерживаться: задерживался
заинтересоваться: заинтересовался
заклинание: заклинания заклинание
заключаться: заключается
заключение: заключении
заклятие: заклятие заклятию заклятием заклятия
заколдовать: заколдовав
закон: закону
законодательство: законодательства
закрывать: закрывать
закрыть: закрыть закрыла
залесский: залесская
замазать: замазан
замена: замену
заменить: заменено
заниматься: занимавшегося
занятие: занятий
занять: заняли
заодно: заодно
запись: запись
заполучить: заполучить
запрет: запрет
запретный: запретного запретном
запрос: запрос
зарегистрировать: зарегистрированный
заслуга: заслуги
заставлять: заставляли заставляют
затылок: затылке
захват: захват захвату
захолустье: захолустье
защита: защиты защитой
защитить: защитить
защитник: защитникам защитниками защитники защитников
защищать: защищает
заявка: заявку
заявление: заявление
звание: звание
зверь: звери
зелье: зельем
зеркало: зеркале
зло: зло
зловещий: зловещие
злодей: злодеи злодеев
злой: злым
змееподобный: змееподобный
змееуст: змееуст
змеиный: змеиные змеиными
змея: змеи змею змея змеями
знак: знак
знакомый: знакомой
знать: знаете знаешь знающий знает знал зная
значение: значение
значительный: значительные
золотой: золотое
зрачок: зрачки зрачками
зритель: зрители зрителям
зуб: зуб
игорь: игоря
игра: игра игры
играть: играют играет
идея: идеей идеи
избежание: избежание
избрание: избрание
избранный: избранные
известно: известно
известный: известную известным известный известная
извиниться: извинилась
изготовитель: изготовителя
изготовление: изготовления
издательство: издательства
изменение: изменения
изменить: изменил
изначально: изначально
изучать: изучая
именно: именно
иметь: имеет
империус: империус
имя: имя имени
иной: иную
инструкция: инструкцию
инструмент: инструменты
интервью: интервью
интересоваться: интересовался
информационный: информационную
искать: ищет
исключить: исключены
искусство: искусств искусствами искусства
исполнение: исполнения
исполнить: исполнил
исполниться: исполнилось
использование: использования
использовать: используя использована использовал использовала использующие
использоваться: использовался
испытать: испытать
история: история историй истории
источник: источниками источник
исчезновение: исчезновение исчезновения
исчезнуть: исчезнув
итоговый: итоговый
иэн: иэн
июль: июля июле
июнь: июня июне
какой: каких каким
камень: камень
кампания: кампанию
кандиды: кандиды
каникулы: каникулах
капитулировать: капитулировать
капюшон: капюшоном
каркарова: каркарова
карточный: карточная
карьерный: карьерный
категория: категории
качество: качества качестве
квиддич: квиддич
квиддичу: квиддичу
квирелла: квирелла
квиррелла: квиррелла
кедавра: кедавра
кингс: кингс
кингсли: кингсли
кино: кино
кинозлодеи: кинозлодеи
киносаги: киносаги
кладбище: кладбище
клык: клыка
ключевой: ключевые
книга: книг книгах книги книге книга
когтевран: когтевран
код: код
кодекс: кодекс
кожа: кожа
колдун: колдун
колдунья: колдунье колдунья
колебание: колебаний
количество: количеству
коллекционный: коллекционная
кольцо: кольцо
комментарий: комментарии
комната: комнату комната комнаты
компьютерный: компьютерной
конец: конце конца
конструктор: конструктор
контролировать: контролировать
контроль: контроль контролем
конфиденциальность: конфиденциальности
копия: копией
короткий: короткие короткий
который: которым которое которому которой которую которого которые которая который
коулсон: коулсон
коулсону: коулсону
кошачий: кошачьи
красивый: красивый красивого
красный: красные
крауч: крауч
крауча: крауча
краучем: краучем
крах: крахом
крестраж: крестраж
крестража: крестража
крестражам: крестражам
крестражах: крестражах
крестражей: крестражей
крестражем: крестражем
крестражи: крестражи
крестражу: крестражу
крестьянин: крестьянина
крикнуть: крикнула
кристиан: кристиан кристиану
кровавый: кровавый
кровь: крови кровь
кроме: кроме
кросс: кросс
кто: кого кому
кубок: кубком кубка кубок кубке
кузнецов: кузнецов
кук: куки
кульминация: кульминации
курс: курсе курс
кусочек: кусочка
кэтлин: кэтлин
лавгуд: лавгуд
лес: лесу лесам леса
лесничий: лесничего
лестрейндж: лестрейндж
летний: летнего летний
либо: либо
лили: лили
литературный: литературные
литтл: литтл
лицензия: лицензии
лицо: лицо лица лицом
личной: личные
лишать: лишает
лишение: лишениях
лишь: лишь
лоб: лбу
ловить: ловит
ложный: ложного
локация: локации
лонгли: лонгли
лондон: лондон
лорд: лордом лорда лорду лорд
лысый: лысого
любить: любить любили
любовный: любовным
любовь: любви любовь
люпин: люпин
люциус: люциус
м: м
маг: магов маги мага магом
магазин: магазине
магический: магического магической магические магических магическая магическим магическое
магия: магия магии
магл: магл
магла: магла
магле: магле
маглов: маглов
магловского: магловского
магловском: магловском
маглом: маглом
маглы: маглы
макгонагал: макгонагал
македонский: македонски
маленький: мало маленьким
малфоев: малфоев
малфоем: малфоем
малфой: малфой
малфоя: малфоя
малфоям: малфоям
малыш: малыша
мальчик: мальчике мальчик
манипуляция: манипуляций
мантия: мантии
марволо: марволо
марта: марта
массовый: массовые
мастер: мастера
материал: материал материалах
материнский: материнской
мать: мать матери
маховик: маховика
мая: мая
медальон: медальоне медальон
медиафайлы: медиафайлы
мел: мел
мелкий: мелкие
менее: менее
меропа: меропа
мероприятие: мероприятия
меропу: меропу
мертвый: мертвым мертва
место: место места месте
местонахождение: местонахождение
местоположение: местоположение
метать: меча
меч: мечом
мимика: мимикой
минерва: минерва
министерство: министерства министерство министерстве министерству
министр: министра
минута: минуту
мир: мира мир миром мире
миртл: миртл
миссис: миссис
младенец: младенца
младший: младшего младший
многие: многие многих
много: более много
мобильный: мобильная
могила: могилу
могущественный: могущественный
можно: можно
молния: молнии
молодая: молодой
молодой: молодого
молодость: молодости
момент: моменту момента
монгол: монгол
морт: морт
морта: морта
морте: морте
мортом: мортом
морту: морту
морфин: морфина морфин
мочь: мог могут
мракоборца: мракоборца
мракоборцев: мракоборцев
мракс: мракс
мракса: мракса
мужской: мужской
муравей: муравья
мы: нами
навигация: навигации навигация
навык: навыки
нагайна: нагайна
нагайне: нагайне
нагайну: нагайну
нагайны: нагайны
нагонять: нагонять
награда: награду
над: над
надеяться: надеясь
названый: назван
назвать: назвав
назначить: назначенный
назойливый: назойливых
называть: называли называть называют
наиболее: наиболее
наивный: наивного
накладывать: накладывает
наконец: наконец
нападение: нападений
написать: написала
наполнить: наполнит
например: например
напускать: напускать
нарволо: нарволо
наследник: наследником
настоящее: настоящего настоящее
научиться: научиться научившись
находить: находит
находиться: находившиеся находящийся находился
начало: начало начале начал
начальница: начальница
начать: начали
начаться: началась начались
начинать: начинает начиная
наш: наших
невилл: невилл
невилла: невилла
невиллом: невиллом
невозможно: невозможно
невольно: невольно
невыясненности: невыясненности
недавний: недавних
недостаток: недостатками
недостоверный: недостоверный
неестественно: неестественно
неизвестно: неизвестно
неизвестность: неизвестности
некий: некоем
некоммерческий: некоммерческой
некоторые: некоторым некоторых некоторые
некоторый: некоторой
некрасивый: некрасивая
некромант: некроманты
нельзя: нельзя
ненавидеть: ненавидит
необратимый: необратимо
неожиданно: неожиданно
неопознанный: неопознанное
неосторожность: неосторожности
непобедимый: непобедимой
неполный: неполный
неправильно: неправильно
неприязнь: неприязнь
несколько: нескольких несколько
несмотря: несмотря
несовершеннолетний: несовершеннолетних
несокрушимый: несокрушимый
нести: нести
неудача: неудачей неудачи
неудачно: неудачно
неудачный: неудачных
нечистокровный: нечистокровный нечистокровных
никакой: никаких
никогда: никогда
николас: николасом
никто: никого никому никто
новый: новый новые
ноздря: ноздри
нормальный: нормальному
норрис: норрис
нос: нос
ночь: ночь
нужно: нужно
нужный: нужном
нурменгард: нурменгард
об: об
обвинение: обвинения
обвинить: обвинил
обернуться: обернулись
обитание: обитания
обладать: обладающий
обличие: обличье
обнаружить: обнаружил
обожатель: обожатели
обольстить: обольстил
оборотень: оборотнем оборотней
образ: образом образы образ
обращение: обращения
обрести: обрести
обряд: обряд
обсуждение: обсуждение
обучение: обучения
общество: общества
обязать: обязаны
огонь: огонь огня
огромный: огромным огромной огромнейшей
один: одна одном одного один
одиннадцатилетняя: одиннадцатилетняя
однако: однако
одновременно: одновременно
оказать: оказали
оказываться: оказывается
окончание: окончания
октябрь: октября
олливандер: олливандер
олливандера: олливандера
он: нему
они: им
оно: оно
опаска: опаской
опасность: опасность
опасный: опасных опасны опасный
операция: операции
описание: описание описаниям
описать: описанный описан
опоить: опоить
организация: организации организация
организовать: организовали организовал
орден: ордена орден
оригинал: оригинале
оригинальный: оригинальное
осанка: осанкой
освобождать: освобождает
осень: осенью
осколок: осколок
основатель: основателей
основное: основное
особенный: особенный
особняк: особняк
особый: особые
оставить: оставила
остальное: остальных
останавливать: останавливают
остаться: остаться остался
ответственность: ответственности
отвечать: отвечавшей
отдать: отдать
отдел: отдела
отдельный: отдельный отдельных отдельные
отец: отца отцом отец отце
отказ: отказ
отказаться: отказавшегося
отказываться: отказываются отказывается
отклонить: отклонил
открывать: открывает
открытие: открытию
открыто: открыто
открыть: открыла открыть
отличие: отличие
отметить: отмечены
отношение: отношения отношению
отправить: отправлен
отправиться: отправится
отразить: отразил
отразиться: отразилось
отредактировать: отредактирована
отряд: отряд
отскакивать: отскакивает
отслеживать: отслеживает
отстранить: отстранили
отсутствовать: отсутствует
отцеубийца: отцеубийцы
отчаяние: отчаянии
отчаянный: отчаянный
очень: очень
очередной: очередным
ошибка: ошибке
павший: попавшее
падение: падению
палец: пальцами
палочка: палочку палочке палочек палочка палочки палочкой
палый: пало
память: память
параметр: параметры
парк: парк
пародия: пародии
паук: пауком
пенелопа: пенелопы
первое: первое первыми первом
первый: первой первая первый
перевод: переводе
перед: перед
передать: передать
перейти: перейти перейдя
переправить: переправлен
пересмотр: пересмотра
перестановка: перестановке
перестать: переставший
переть: при
период: период
перипетия: перипетий
перо: перья перо
персонаж: персонаж персонажа персонажами персонажи
персональный: персональные
петтигрю: петтигрю
печать: печати
питер: питером
питомец: питомцем
плакать: плакал
плакса: плакса
план: планы план
племянник: племянник
плен: плен
пленять: пленяет
площадка: площадке
победа: победы
побывать: побывал
поведение: поведения
поверить: поверили
повредить: повреждена
повторный: повторный
погиб: погиб
погибать: погибает
погибнуть: погибла
погружаться: погружаясь
подать: подал
подвергнуться: подвергся
подготовка: подготовка
поддержать: поддержала поддержали
подкинуть: подкинул
подозревать: подозревал
подробность: подробности
подробный: подробнее
подросток: подростка
подстраивать: подстраивает
подстроить: подстроив
подтвердить: подтвердила
подходить: подходили
поединок: поединок
пожертвовать: пожертвовать пожертвовал
пожиратель: пожирателя пожирателям пожирателей пожиратель пожиратели
позволять: позволяющих
поздний: позже
поиск: поиски поисков поиск поиску
поить: поить
пока: пока
показной: показную
покинуть: покинули
пол: пол
полагать: полагая
полгода: полгода
политик: политика политике
полностью: полностью
полноценный: полноценную
полный: полное
полтергейст: полтергейстах
полукровка: полукровки полукровка
полумна: полумна
получаться: получается
получить: получил получить
поместить: поместить
поместье: поместье
помешать: помешало
помочь: помог
помощь: помощью помощи
понимать: понимал понимая
понять: понять
пообещать: пообещав
попадать: попадают
попасть: попал попало
попросить: попросил
попытаться: попытался
попытка: попытка попытки попыток
портал: портал
посетить: посетившим
поскольку: поскольку
последний: последнее последнюю последний последнего последним
последователь: последователями
последовательница: последовательница
последующий: последующих
посмотреть: посмотрела
посол: после
посредство: посредством
пост: посты
постобработке: постобработке
постоянный: постоянная
построить: построил
поступить: поступил
потерять: потерял
потомок: потомком потомков потомок
поттер: поттером поттер поттера поттеров поттеру поттере
поттеромания: поттеромания
похитить: похитить
похищение: похищение
похожий: похожее похожие похож
почтить: почти
поэтому: поэтому
появиться: появился
появление: появлении появление
появляться: появляется
правда: правда правду
правильно: правильно
правильность: правильность
править: правило правит править
правка: правки
практический: практически
превратить: превратил
превратиться: превратился
превращение: превращения
предварительно: предварительно
предлагать: предлагает
предмет: предметов предметы предмете предмет
предотвратить: предотвратить
предполагать: предполагает предполагал
предположить: предположила
предпринять: предприняла
предсказание: предсказание
представиться: представились
предыстория: предыстория
презирать: презирает
премьер: премьер
преподаватель: преподаватель преподавателя
препятствие: препятствие
преступление: преступление преступления
преступник: преступники преступник
преступный: преступную
приблизительный: приблизительное
прибыть: прибыл
привести: привело
привлекательный: привлекательный
привязать: привязан
придавать: придают
приехать: приехал
признаться: признался
призрак: призрака призраком
приказать: приказав
приказчик: приказчиком
прикосновение: прикосновение прикосновения
применить: применил
применять: применяет
пример: примеру
примерный: примерно
примечание: примечания
принадлежность: принадлежность
принимать: принимающее
принц: принца принц
присвоить: присвоил
приспешник: приспешники
притворяться: притворяется притворяться
приход: приход
причина: причине причин причина
приют: приюта приюте
про: про
провалиться: провалилось
проверить: проверить
провидица: провидица
проводить: проводит
продажа: продаже
продолжаться: продолжалось
продолжить: продолжит
продумывать: продумывает
продюсер: продюсер
проект: проектах
проживать: проживает
прозвище: прозвища прозвищу
произведенье: произведений
производство: производство
произносить: произносить произносят
произноситься: произносится
произойти: произошли произошло
происходить: происходит
происхождение: происхождение
проклясть: проклятое проклял
проклятие: проклятие
проникнуть: проникнувшим
пророчество: пророчество пророчеством
пророчествовать: пророчествуя
пророчить: пророчили
просмотр: просмотры
пространство: пространства
против: против
противник: противника противников противники
противостояние: противостояния
протяжение: протяжении
профессор: профессора
проходить: проходил
прочий: прочее
прошлый: прошлого прошлом
проявлять: проявлять
проявляться: проявляться
прятаться: прятался
псевдо: псевдо
публика: публикой
путеводитель: путеводитель
путь: путь
пуффендуй: пуффендуй
пытатели: пытатели
пытаться: пытался пытается
пытка: пытками
пьеса: пьесе пьесы
пятый: пятом
пять: пять
равный: равным
ради: ради
развоплотился: развоплотился
разговаривать: разговаривать
разговор: разговоре
раздвоить: раздвоенный
разделить: разделить разделил
различный: различных
разный: разных
разработчик: разработчики
разрешить: разрешил
разрушить: разрушило
рана: рану
ранее: ранее
ранний: ранние
распасться: распавшись
распределять: распределяющая
рассказ: рассказы
рассказать: рассказать
рассказывать: рассказывает рассказывая рассказывала
расследование: расследованием
расспросить: расспросил
расти: рос
ребенок: детей детям дети
реддл: реддл
реддла: реддла
реддлу: реддлу
реж: реже
результат: результате
религиозный: религиозные
реликвия: реликвия реликвии
решать: решает
решить: решили решил
решиться: решилась
риддл: риддл
риддла: риддла
римус: римус
ричард: ричарда ричард
род: род
родитель: родителями родителей
родить: родила
родиться: родилась
родной: родного родной
родственник: родственники
родство: родстве
рождение: рождения рождении
роль: роль роли
роман: романов
рон: роном рона рон
росмэн: росмэн
рост: рост
роулинг: роулинг
рубеус: рубеус
рубеуса: рубеуса
рука: руки
русский: русском русский
рушить: рушат
рэйф: рэйф
рэйфа: рэйфа
ряд: ряды рядом
салазар: салазар
салазара: салазара
сам: самого самом сами сама
самый: самый самым самые
сантиметр: см
саундтрек: саундтрек
сбегать: сбегает
сбежать: сбежал
свалить: свалив свалил
сведение: сведения
свежий: свежие
сверстник: сверстников
свобода: свободу
свободный: свободной
свое: своих свои своему своего своим своими
свой: свой своей свою
связанный: связанные
связаться: свяжитесь
связь: связи
сдать: сдал
сделать: сделать сделала
северус: северус
седрик: седрика седриком
седьмой: седьмой
семь: семь
семья: семья семье семьи
сердцевина: сердцевин
середина: середине
сериал: сериал
серийный: серийный
серия: серии серию серия
сестра: сестра
сивилла: сивилла
сивый: сивым
сила: силу силой
сильный: сильно
симпатизировать: симпатизировала
сириус: сириус
сирота: сироты
сиротский: сиротском
система: системе
сказка: сказки
скачать: скачать
скелетоподобное: скелетоподобное
скелетоподобным: скелетоподобным
скитаться: скитался
скорпиус: скорпиус
скорпиусом: скорпиусом
скрипучий: скрипучий
скрывать: скрывает скрывать
скрытый: скрытые
скупка: скупке
слабый: слабый
след: след
следовать: следуют
следующий: следующем последующей следующей следующим следующие
слепой: слепого
слизерин: слизерин
слизерина: слизерина
слизнорта: слизнорта
слово: словам
словосочетание: словосочетания
сложность: сложность
сложный: сложнее
служебный: служебные
случай: случаях
случайно: случайно
случайный: случайная
случиться: случилось
слышный: слышен
смертельный: смертельное смертельную смертельно
смертоносный: смертоносной
смерть: смертью смерть смерти
смит: смит
смочь: сможет
снаружи: снаружи
снегг: снегг
снова: снова
собирать: собирать
собственный: собственной
событие: события событиях
совершать: совершать
совершить: совершил
согласиться: согласится
согласно: согласно
соглашаться: соглашается
содержание: содержание
содеять: содеянном
создание: создания созданиям создании создание
создатель: создателя создатель
создательница: создательницы
создать: создав создала создано создан создал созданным созданный создать
сообщать: сообщает
сообщество: сообщество
сообщить: сообщить сообщил
сопротивление: сопротивление
соратник: соратник соратником
соревнование: соревнования
составить: составил
сотрудник: сотрудников
сохранение: сохранением
сохранить: сохранить сохранив
социальный: социальный
социопат: социопаты
спаривание: спаривание
специализироваться: специализирующемся
список: список
спора: споры
способ: способом
способность: способности
способный: способны способен способным
справка: справка
спрятать: спрятать спрятан спрятанный
сражение: сражения
сразу: сразу
срисовать: срисовано
српски: српски
српскохрватски: српскохрватски
ссылка: ссылка ссылки
становиться: становилось
становление: становление
староста: старостой
старший: старшего старше старший старшим
статистика: статистика
статус: статус
стать: стал стало стала стать став стали станет
статья: статья статьи
степень: степени
стоить: стоит
столетие: столетия
сторона: стороны стороне сторону
сторонник: сторонники сторонников
стр: стр
страна: страну
страница: страницы страницах страница страницу странице
странный: странным
страх: страхом страх
стремительно: стремительно
строгий: строжайший
студент: студентам
судно: суда
сумасшедший: сумасшедшими сумасшедшим
суперзлодеи: суперзлодеи
существо: существо существ существа
существование: существование
существовать: существующим
схватка: схватки
сцена: сцене сценах
считать: считали считал считают
сыграть: сыграл сыграет
сын: сына сын сыном сыне
сюда: сюда
сюжетный: сюжетных
т: т
таинственный: таинственные
тайна: тайн
тайный: тайная тайно тайной тайную
также: также
таки: таки
такой: такой таким такому таких
талантливый: талантливый
твиттере: твиттере
текст: текст
текущий: текущие
тело: тела тело телом
тем: тем
тематический: тематический
темнота: темноты
темный: темного темной
террорист: террористы
тиран: тиран
тис: тис
тиффин: тиффин
товарный: товарный
том: томом тома
томас: томас
тонкий: тонкие тонкое
тонкость: тонкости
торжество: торжеством
тот: том ту тот тому той та
точно: точно
точный: точных точнее
трагедия: трагедия
трансформация: трансформаций
тратить: тратит
требовать: требовал
трелони: трелони
трио: трио
труп: трупов
турнир: турнир турнира
тюрьма: тюрьму тюрьме
тянуться: тянется
убивать: убивать убивающее убивает
убийство: убийству убийства убийство
убийца: убийцы убийца
убить: убитого убил убить убит убита
увидеть: увидел
увлекаться: увлекался
угнетать: угнетаемая
удаленный: удален
удаться: удалось
ужасный: ужасного
узнать: узнав узнать узнал
узник: узник
уизли: уизли
указание: указанием
украсть: украдена украл
умереть: умер умерла
умирать: умирает
унизительный: унизительная
уничтожение: уничтожение уничтожения
уничтожить: уничтоживший уничтожил уничтожить уничтожен уничтожено уничтожена
уоррен: уоррен
упоминание: упоминания упоминанием
упоминаться: упоминается
управление: управлением
уродливый: уродливого
урок: уроки
условие: условий условия
услышать: услышать
успеть: успела
устранять: устраняя
устроиться: устроился
утверждать: утверждавшим
утверждение: утверждению
ухаживать: ухаживавшего
участвовать: участвовать
участие: участие
участник: участником
ученик: учеником
ученица: ученицу
учитель: учителя
учиться: учится учился
учредить: учреждена
файнс: файнс
файнса: файнса
факт: фактов
факультет: факультета факультет
фамилия: фамилии
фантастический: фантастические
февраль: февраля
феникс: феникса
фенриром: фенриром
физический: физическими физической
философский: философский
фильм: фильм фильме фильмов фильмах фильма
финальный: финальная
фламелем: фламелем
фонд: фонд
форма: форме форму
форум: форум
французский: французской французское французского
франшиза: франшизы
фрэнк: фрэнк
х: х
хагрид: хагрид
хагрида: хагрида
хагриду: хагриду
характеристика: характеристики
харт: харт
хвост: хвост хвоста
хейман: хейман
хепзибу: хепзибу
хепзибы: хепзибы
хиро: хиро
хобби: хобби
хогвартс: хогвартс
хогвартса: хогвартса
хогвартсе: хогвартсе
ход: ходе
хозяин: хозяином хозяину хозяина
хороший: лучшим хороший
хорошо: хорошо
хотеть: хотели хотел хотела
хранить: хранить
худой: хуже
худощавый: худощавого
хэнглтона: хэнглтона
цель: целях целью
цикл: цикла
цитировать: цитировать
цифровой: цифровым
чародейство: чародейства
частить: части
частица: частицы
часть: частью частей часть
чахлый: чахлого
чаша: чаша чашу
человек: человек человека
человеческий: человеческого
чемпионат: чемпионат
череп: череп
череповидным: череповидным
честь: честь
чистокровный: чистокровных
чистота: чистота
чистый: чистой
читать: читать
член: члена члены
чрезвычайный: чрезвычайно
что: чему
чтобы: чтобы
чувствовать: чувствовал
чудовищный: чудовищные
чуть: чуть
шаг: шагом шаг
шар: шар
шармбатон: шармбатон
шест: шестом
шестая: шестой
шкала: шкалу
школа: школа школе школой школы
шляпа: шляпа
шрам: шрам
щека: щеками
элемент: элемент
эммелины: эммелины
энциклопедия: энциклопедия энциклопедии
эпизод: эпизоде
этап: этапе
это: этом это
этот: этой этих эта эту
юноша: юноше
юный: юному
явиться: явиться
являться: являясь является
яд: яд
ядовитый: ядовитой ядовитым
язык: язык языках
январь: январе
