август: августа
авель: авель
авт: авт
автомобиль: автомобиль
автор: автора автору автор
автореферат: автореферат
авторский: авторские авторских
авторство: авторства
агафон: агафона
адам: адама
адамов: адамова
азбука: азбука
академический: академический
академия: академии академия
акимов: акимова
активно: активно
активный: активны
актуальный: актуальной
алатырь: алатырь
албаста: албаста
албастый: албастый
александр: александра александр
алексей: алексея алексей
аленький: аленький
алкоголик: алкоголик
алконост: алконост
аллюзия: аллюзии
алтайский: алтайской
алфавит: алфавиту
альманах: альманах
амбарник: амбарник
американский: американских
амфора: амфоры
анализ: анализ
аналогичный: аналогично
анапрэенка: анапрэенка
анатолия: анатолия
ангел: ангелы ангела
англ: англ
анджей: анджея
андрей: андрей
анимационный: анимационном
ансимова: ансимова
антисказке: антисказке
античный: античная
антон: антонов
антонов: антонова
антропогонические: антропогонические
антропоморфность: антропоморфность
антропоморфный: антропоморфного антропоморфный
антропоним: антропонимом
антютик: антютик
анчутка: анчутка
апокалиптика: апокалиптика
аполлиону: аполлиону
апостол: апостол
апрель: апреля
арзюри: арзюри
аркона: аркона
арконы: арконы
армяк: армяк
арсений: арсения
арт: арт
артыкул: артыкул
арх: арх
архаический: архаических
архангел: архангел
архангельск: архангельск
архангельский: архангельской
архивировать: архивированная архивировано
архивный: архивная
архимандрит: архимандрита
асилки: асилки
аспект: аспектах аспект аспекты
ассоциация: ассоциацию
ассоциироваться: ассоциируется
аста: аст
астафьев: астафьева
астрал: астрале
астрель: астрель
атмосфера: атмосферу
атмосферный: атмосферные
атрибут: атрибутов атрибут
аука: аука
аукнуть: аукнуть
афанасий: афанасия
афанасьев: афанасьева афанасьев
б: б
баба: бабы бабой баба
бабай: бабай
бабий: бабьи
бабка: бабка
баз: базе
байда: байда
бакста: бакста
балакирь: балакирь
балахон: балахона
балет: балет балету балета
балканистика: балканистики
баллада: балладе балладах
бальмонт: бальмонта
банник: банник
баня: бане
бардовый: бардов
барнаул: барнаул
басня: басне
батасовой: батасовой
батог: батог
батька: батька
бахтин: бахтину
башкир: башкир
баюн: баюн
бдпу: бдпу
бду: бду
бегать: бегали
беда: беду
бежать: бежит
бежин: бежин
бежина: бежина
бездна: бездны
безликий: безликий
безответный: безответно
безрезультатно: безрезультатно
безумная: безумных
беларускага: беларускага
беларускай: беларускай
беларуская: беларуская
беларусь: беларусь беларуси
белгородский: белгородского
белка: белок
белово: белова
беловодье: беловодье
белорус: белорусов белорусы
белоруссия: белоруссии
белорусский: белорусской белорусского белорусское белорусский
белые: белым белые
белый: белое бел белом белый
бендил: бендил
берег: берегах
берегиня: берегиня
березня: березня
береста: береста
бес: бесы бесов бес
беситься: бесятся
беспечный: беспечное
беспрепятственно: беспрепятственно
беспричинный: беспричинный
бессмертный: бессмертного бессмертный
бестпрынт: бестпрынт
бесчинство: бесчинства
библейский: библейским библейская
библиографоведение: библиографоведение
библиотека: библиотека
библиотековедение: библиотековедение
билибино: билибина
билл: билл
битва: битвах
бить: бьющий бить
благодарить: благодарит благодарил благодарят
благодаря: благодаря
благополучный: благополучный
благопристойность: благопристойности
благословенный: благословенного
блазнит: блазнит
блазнится: блазнится
бледный: бледные
блестеть: блестящими блестящие
близкие: близких
близкий: ближе близкий близки
блин: блины
блищ: блищ
блища: блища
блуд: блуд
блудник: блудник
блудь: блудь
блуждание: блужданий блуждания
блуждать: блуждая блуждать блуждающие
блукання: блукання
бо: бо
бог: бога богу бог богом боги
богатый: богатых богатые
богатырь: богатыри
богдан: богдановича богданович
богинка: богинка
богомолка: богомолками
богородица: богородица
божественность: божественность
божественный: божественного божественный
божество: божества божеств
божич: божич
бок: бок
болезнь: болезнь болезни
болотник: болотник болотником
болотное: болотное
болото: болот
боль: боли
больший: большим большей большая большие больше
большинство: большинстве большинство
большой: большое
бомж: бомжом
бор: бору
борис: борис
боровик: боровик боровиков
боровит: боровит
боровой: боровой
боровуха: боровуха
боровухи: боровухи
борода: борода бородой
бородатый: бородатый бородатого
борона: боронами
бороться: борется
босой: босой
ботинок: ботинки
бошка: бошка
бояться: боится боялись
брак: брак браке брака
браниться: браниться бранятся
брань: брани брань
брататься: брататься
брать: берут брать
брачный: брачных
бровь: брови
бродить: бродить бродит
брокгауза: брокгауза
броситься: броситься
брусника: брусника
брут: брута
брылеев: брылеев
брянск: брянск
брянский: брянского
будущее: будущее будущем
буйный: буйные
бук: бука
бумага: бумаге
бурелом: буреломом
бурый: бурый
буря: бури бурю
буффонированном: буффонированном
бушкевич: бушкевич
буян: буян
български: български
бывальщина: бывальщине бывальщины бывальщинах бывальщин
бывать: бывает бывают
былина: былинах
быличек: быличек
быличка: быличка
быличках: быличках
быличке: быличке
былички: былички
былой: былой былые
быль: былях
быт: быта
бытовать: бытовали
бытовой: бытовом бытовые бытовой
быть: будучи были
бычков: бычков
бюро: бюро
важный: важны важное
валежник: валежником
валентин: валентин
валита: валит
валить: валящие
валун: валуны валунам
вампир: вампир
ван: ване
ванда: ванда
ваня: ваня
вариант: варианте
василий: василия
василиса: василиса
василиск: василиск
васнецов: васнецов васнецова
вблизи: вблизи
вв: вв
вверх: вверх
вгу: вгу
вдохновение: вдохновения
ведогонь: ведогонь
ведомость: ведомости
ведьма: ведьма ведьмы
ведьмак: ведьмаке ведьмака ведьмак
вежа: вежа
вежливый: вежливыми вежливые
век: века веков веке
велес: велес
велеса: велеса
великан: великаны великан
великанша: великаншей
великий: великой великий
великое: великим
великорусский: великорусского
велимир: велимир велимира
вениамин: вениамина
венка: венок
вера: веры вера
верба: верба
вербный: вербным
верить: верили верит
верлиока: верлиока
вернее: вернее
вернигора: вернигора
вернидуб: вернидуб
верник: верник
верность: верности
вернуть: вернуть
вернуться: вернувшиеся вернувшихся вернуться
верование: верований верованиях верования
вероятный: вероятнее
версия: версия версий версиям
верховный: верховным
верхокамья: верхокамья
верхушка: верхушке верхушками верхушку
вершина: вершин
весенний: весенне весенняя
весить: весь
весна: весны весна
весной: весной
весною: весною
вести: ведут ведущего вести
вестник: вестник
весь: вся
ветвь: ветвях ветвями ветви
ветер: ветер ветры ветра
ветка: веткой ветках
веточка: веточки веточкой веточками
ветров: ветров
ветхий: ветхом
вечность: вечностью
вечорка: вечорка
вешний: вешнего
вештица: вештица
взаимно: взаимно
взаимный: взаимным
взаимодействие: взаимодействии
взаимоотношение: взаимоотношения
взаимосвязь: взаимосвязи
взамен: взамен
взбунтоваться: взбунтовавшийся
взгляд: взглядам
вздыхать: вздыхающий
взять: взятая
виа: виа
вид: видом видов виду вид виде
видение: видениями
видеть: видеть видит видят видя видел
видеться: видится
видимый: видимой
вика: вики
викиданных: викиданных
викимедиа: викимедиа
википедии: википедии
википедия: википедия
викисклад: викисклад
викискладе: викискладе
викисловаре: викисловаре
викисловарь: викисловарь
викитека: викитека
викитеке: викитеке
викитеку: викитеку
викицитатник: викицитатник
викицитатнике: викицитатнике
виктор: виктор виктора
вилой: вилой
вилы: вилы
вильборг: вильборг
вильворг: вильворг
вильно: вильна
винниченка: винниченка
вино: вину
виноградов: виноградова виноградов
вип: вип
випуск: випуск
вирява: вирява
висеть: висеть
виталий: виталия
витебский: витебской
виток: витком
вить: вила
витя: вити
вихор: вихор
вихрь: вихрь вихря
вицин: вицин
вклад: вклад
владение: владениях
владивостокский: владивостокского
владимир: владимир владимира владимиров
владислав: владислава
владыка: владыка
власий: власия
власов: власова власовой
властелин: властелина
властитель: властителем
власть: властью власть
влияние: влиянием влияние влияния
влиять: влияли
вместе: вместе
вместо: вместо
вмешиваться: вмешивающегося
вне: вне
внебрачный: внебрачные
внезапно: внезапно
внешний: внешние внешний
вниз: вниз
внимание: внимание
вновь: вновь
внук: внук
внутренний: внутренней
внучек: внучка
вобразная: вобразная
вова: вова
вовремя: вовремя
вовсе: вовсе
водить: водило водят водить
водка: водки водку
водяник: водяника
водяной: водяными водяного водяным водяных водяные водяной
воевать: воюют
воевода: воеводы
военный: военной
вожак: вожаком
возвращаться: возвращались возвращается возвращалась
воздвижение: воздвиженье
воздействие: воздействием воздействия
воззрение: воззрения
возить: возит
возможно: возможно
возможность: возможностей возможность
возможный: возможна
возникновение: возникновения
возникнуть: возникший возникшее
возраст: возраста возрасте
возрастной: возрастные
возрождать: возрождающей
войекову: войекову
война: войн
войти: войти
вокруг: вокруг
волгоградский: волгоградского
волин: волин
волк: волком волки волк волков
волколак: волколак
волколака: волколака
вологодский: вологодской
волос: волосы волос волосами
волосатость: волосатость
волосья: волосья
волосьями: волосьями
волхв: волхв
волчий: волчий
волшебный: волшебные волшебная волшебный волшебное
волшебство: волшебство
волынцев: волынцев
вольная: вольная вольной
вольный: волен
вольф: вольфа вольф
воля: воле
вообще: вообще
воплощаться: воплощаться
воплощение: воплощения
вопрос: вопросы вопроса вопросу
воровать: ворует воруют
ворон: ворона
воронеж: воронеж
воронежский: воронежского воронежский
вороной: вороном
ворс: ворса
восемь: восемь
воскресенье: воскресеньем воскресенье
воспитывать: воспитывают
восприемник: восприемником
воспринимать: воспринимали
восприниматься: воспринимается воспринимался воспринимались
восприятие: восприятия
восстание: восстанию
восток: восток
восточнославянский: восточнославянский восточнославянская восточнославянского восточнославянских
восточный: восточных восточной
восходить: восходит
впервые: впервые
впереди: впереди
вплетать: вплетая
вполне: вполне
впрочем: впрочем
враждебный: враждебной
враждовать: враждовать
вражонок: вражонок
вредить: вредят вредящей вредить
вредно: вредно
временить: времени
временник: временник
время: временем время
вровень: вровень
врубель: врубеля
все: всему всех всего всем всеми
вселенная: вселенная
всеять: всей
всклокочить: всклокоченные
вскоре: вскоре
вспоминать: вспоминают
вспомнить: вспомнить
встать: встать
встретить: встреченный
встретиться: встретиться встретившемуся
встреча: встреча встречу встрече встречи
встречать: встречают
встречаться: встречается встречающихся
встречный: встречный
вступ: вступ
вступать: вступают
вступительный: вступительная
вступление: вступление
всякий: всякие
второй: вторая второй
вход: вход
входить: входит
выбегать: выбегают
выбивать: выбивать
выбор: выбор
выбрать: выбрать
выводить: выводил
выворотить: вывороченной вывороченного
выглядеть: выглядеть выглядит
выгнать: выгнать
выгон: выгон выгона
выданьне: выданьне
выдать: выдать
выделить: выделив выделен
выдержка: выдержек
выдрин: выдрина
выдумать: выдуманных
выживать: выживают
выжигание: выжигание
вызвать: вызвать вызваны вызвано
выздоровление: выздоровлении
вызывание: вызывание вызывания
вызывать: вызываемые вызывали вызывают вызывая вызывающего
выйти: выйти выйдя выйдут выйдет
вымыслить: вымышленные
вынудить: вынуждены вынужден
вып: вып
выпас: выпас
выпить: выпить
выполнять: выполнять выполняя
выпрашивать: выпрашивающий
выпуклый: выпуклые
выпуск: выпусках
выражать: выражает
выражение: выражениями выражения выражение
выразить: выражено
выродиться: выродилось
высасывать: высасывающего
высказывать: высказывает
высокий: высокая высокие выше
высоцкий: высоцкого высоцкий
выстрел: выстрел
выстрелить: выстрелить
выступать: выступает
вытеснить: вытесненный
вытечь: вытекшей
выходить: выходили
вышина: вышиной
выясняться: выясняется
вьюга: вьюги
вяземский: вяземского
вятский: вятский
г: г
гавришенко: гавришенко
гадание: гадания гаданий
гадать: гадающий гадающие
галерея: галереи галерея
гамаюн: гамаюн
гаркать: гаркая
гаркун: гаркун
гармоничный: гармоничному
гармония: гармонии
гармонь: гармони
гаудеамус: гаудеамус
гвоздить: гвозди
георгий: георгия георгий
гера: герою герой
германа: герман
героиня: героини героиня
герой: героем героях героя героями героям героев герои
герцен: герцена
герцик: герцик
гибель: гибели гибель
гигант: гигант гиганты гигантом
гипотетический: гипотетически
гитара: гитары
гл: гл
глава: главу главы
главное: главному главным главного главные главных
главный: главная главный главной
глаз: глаз глаза глазах
глазунов: глазунова
глаша: глаша
глебов: глебова
глинка: глинки
глубина: глубине глубинах
глубинный: глубинный
глуповатый: глуповатый глуповатым
глупость: глупость
глухой: глухое
гнатюк: гнатюк гнатюка
говорить: говорить говорит говорил говоря
говориться: говорится
говорящий: говорящие
гоголевский: гоголевским
год: гг году годов лет год годы года
годдзю: годдзю
гол: голом
голик: голике
голиков: голикова
голова: голова головы головой голове
головешка: головешка
головной: головные
голод: голода
голодать: голодала
голос: голоса голосом голос
голубков: голубкова
голый: голые голым
гомельскай: гомельскай
гомельшчыны: гомельшчыны
гонка: гонка
гора: гора гор горы
горазд: гораздо
горбатый: горбатый
город: городе
горожанин: горожан
горшок: горшок
горыныч: горыныч
горыныча: горыныча
господин: господин
гость: гости
государственный: государственной государственная государственный государственного
готовый: готовыми
грабли: грабли
граве: граве
грамота: грамота
граница: границей границ границе
греховный: греховная
греческий: греческие
грешный: грешных
гриб: грибов грибами грибам грибы гриб
гродна: гродна
гроза: грозы
гром: грома
громкий: громко
гротеск: гротеска
грубый: грубо
грудь: грудями
группа: группа группы
грымута: грымута
губа: губ губы
губерния: губернии
губернский: губернская
губить: губящие
гудеть: гудеть
гул: гул
гульбище: гульбище
гулять: гуляет
гуманитарный: гуманитарные
гумно: гумно гумнам
гура: гура
густой: густыми
гуцульська: гуцульська
д: д
дабог: дабог
давать: давая дают давать
давно: давно
дажьбог: дажьбог
далее: далее
даль: даль даля
дар: дар дары
даргомыжский: даргомыжского
дарита: дарит
дарить: дарят
даровать: дарующей
дата: дата дат
дать: данным данном данных данной данного
два: два две
дверь: дверь дверей
движение: движениями движение
двое: двое
двоеверие: двоеверии
двоедушники: двоедушники
двойственный: двойственным двойственное
дворовая: дворовой
дева: дева
девать: девана
девка: девка девками
девочка: девочка девочку
девственный: девственной
девушка: девушке девушки девушек девушку девушка
дегтярничают: дегтярничают
дед: дед деду
дедка: дедок
дедушка: дедушка дедушке
дезинтеграция: дезинтеграции
дейнекин: дейнекина
действие: действия действие действиями
действовать: действовать действуют действует
декабрь: декабря
декоммуникации: декоммуникации
делать: делает делать делающей делают делая
делаться: делается
дело: делами
дементьев: дементьева
демифологизирует: демифологизирует
демон: демонов демонами демон
демонический: демонической демонические демонический демоническим
демоничность: демоничность
демонолексика: демонолексика
демонологический: демонологическом демонологический
демонология: демонологии демонология
демонстрировать: демонстрирует
демьян: демьян
денисевич: денисевич
денница: денница
день: дня дне дни
деньги: денег
деревня: деревни деревне деревнями деревням деревню
дерево: дереву дерева деревьях дерево деревом деревья деревьями деревьям дереве деревьев
деревянный: деревянные
держава: держава
державный: державной державного
держать: держит
деромантизирован: деромантизирован
деталь: деталей деталях
детище: детище
детская: детских детская
детский: детский детском
деть: день
деться: денется
деятельность: деятельность
дзед: дзед
диалог: диалог
диаметральный: диаметрально
диво: дива
дивьи: дивьи
дидилия: дидилия
дикенький: дикенький
дикий: дикая дикие диких дикую дикое
дикинькие: дикинькие
диковинный: диковинным
диссертация: диссертации диссертация
дичать: дичают
длинный: длинными длинная длинные длинное
дмитриенко: дмитриенко
днепровский: днепровские
добровольский: добровольский добровольского
добродушный: добродушным
добрый: добрый доброго
добрынин: добрынина
добыча: добычи добычу
довбня: довбня
довод: доводы
догнать: догнав догнать
договор: договоры договор договора договору
договориться: договориться
додола: додола
дождь: дождя
доить: доит
доклад: докладов
долгий: долгой
должен: должно должна должен
долить: долей
долото: долото
доля: доля
дом: дом доме
дома: дома
доманский: доманский
домашние: домашних домашним
домашний: домашнее
доминирование: доминированием
доминировать: доминировать
домовой: домовыми домового домовой домовых
домовый: домов
домотканый: домотканый
домыть: домой
доп: доп
доплетать: доплетает
дополнительный: дополнительные
дополнять: дополняет
допотопный: допотопным
допускаться: допускалось
дорога: дорогам дорогу дороге
дорогой: дорога дорог дороги дорогою
дорожка: дорожках дорожки
досада: досаде
достаточно: достаточно
достижение: достижения достижении
достоевский: достоевского
доступный: доступен
дочка: дочки
др: др
драма: драм драме драмах
драматический: драматической
драматичный: драматичную
драматургия: драматургии
дранникова: дранникова
древесный: древесного древесную древесных
древнегреческий: древнегреческими древнегреческого
древнерусский: древнерусская древнерусской
древние: древним древние древних
древний: древней древнего древний древнее
древность: древности
древо: древо
древовидный: древовидным
древоподобный: древоподобен
дрекавац: дрекавац
друг: друзья друг друзей другом друга
другой: другое другим другой другими другому другая другие других
друкарня: друкарня
дряблый: дряблый
дряхлость: дряхлость
дряхлый: дряхлая
дуб: дуб
дубина: дубина
дубинка: дубинка
дудочка: дудочка
думать: думать
дупло: дупле дупло
дух: духов духа духу духе дух духи духами
духовная: духовная духовной
духом: духом
душ: душу души
душить: душит
дынин: дынин
дыхание: дыхания
дьявол: дьяволом дьявол дьявола
дядя: дяде дядя
е: е
ева: евы
евгения: евгения
евфросина: евфросина
егорий: егория егорий
еда: еда едой еду
единственный: единственным единственный
ездить: ездя ездит
елена: елена елены
еленской: еленской
еловый: еловые еловую
ель: елью ель
енциклопедичний: енциклопедичний
ерофей: ерофея
ерусалим: ерусалим
есенин: есенина
естественный: естественные
ефим: ефим
ефименко: ефименко
ефрона: ефрона
жанр: жанр жанра
жанровый: жанровые
жар: жар
жаровой: жаровою
желание: желанию желанием
железный: железная железной
жена: жены жена жену
жениться: женится
женский: женского женский
женщина: женщины женщиной женщина женщин
женя: женю
жертва: жертву
жестокий: жестоко
живе: живе
живительный: живительного
живица: живицу
живой: живое жива живого живая
живописный: живописная
животина: животину
животное: животного животным животное животных животные животными
жизненный: жизненной
жизнерадостный: жизнерадостный
жизнь: жизни жизнь жизнью
житель: жителей жители жителям житель
житие: жития житиях
жить: жить живущий живущая живут живущие живущих
жрец: жрецы
жуковский: жуковский жуковского
журавика: журавика
журнал: журнал журнала
журналистика: журналистика
з: з
забава: забава
заблудиться: заблудившийся заблудился заблудиться заблудившиеся заблудившемуся заблудившегося заблудится
заболевать: заболевал
заботиться: заботится
забывать: забывает
завести: завести
завет: завете
завещать: завещанная завещана
зависеть: зависит зависела
зависимость: зависимости
заводить: заводящем заводить заводит
завывание: завывания
заг: заг
загальною: загальною
заглавный: заглавная
загнутый: загнутые
заговор: заговоров заговора заговор заговоры
загон: загон
загонять: загоняет
заготавливать: заготавливали
заготовка: заготовка
загрызть: загрызли
загубить: загубить
зад: задом
задавить: задавить
задний: заднее
зайцев: зайцев
закат: закате
закидывать: закидывает
заключать: заключали заключать
заключаться: заключался
заключение: заключения
заключить: заключить заключена заключивший
закончить: закончить закончивший
закопать: закопать
закрепление: закрепления закреплением
закрестить: закрестить
закрыть: закрыть
залезть: залезть
заложные: заложные
заманивать: заманивающие заманивать заманивает заманивающий
замена: замена
заменить: заменить
заменяться: заменяется
заметать: заметает
заметно: заметно
замечать: замечает замечал
замещать: замещая замещает
замкнуть: замкнув замкнул
замок: замок
заморочить: заморочить
замуж: замуж
замыкать: замыкая
заниматься: занимался
заново: заново
западный: западных западно
запас: запас
запахнуть: запахнута
запереть: запертый
запечь: запечь
запирать: запирает
записать: записано записать записанных
записка: записки
запись: запись
заплутать: заплутает
заповедник: заповеднике
заполнить: заполнить
заполнять: заполняет
запрет: запретов запретом запрете
запретить: запрещено
запрос: запрос
запуги: запуги
зара: заре
зарасти: заросшие
зарегистрировать: зарегистрированный
заросль: зарослями
зарыть: зарыть
зарядить: заряженного
засада: засаде
заставать: застают
заставить: заставив
заставлять: заставляют
заступничество: заступничеством
затаиться: затаившееся
затейный: затейный
затерянный: затерянные
затоптать: затоптать
затупить: затупленным
зафиксировать: зафиксирован зафиксированы
захад: захад
захватить: захватившему
захотеть: захочет
зачаровать: зачарованном зачарованный
зачастую: зачастую
зачесться: зачлась
защекотать: защекотать
защита: защиты защита
защититься: защититься
защитник: защитника защитник
защищать: защищает защищая
заявление: заявление
заяц: зайца заяц
зб: зб
зваться: зовутся
зверина: звериной
звериный: звериные
зверь: зверям зверем зверей звери
звук: звукам звуками звуки звуков
звуковой: звуковые
здороваться: здороваться
здухач: здухач
зеленин: зеленин
земельный: земельном
земледелец: земледельцами
земледелие: земледелия
земледельческий: земледельческих
землемер: землемеров
земля: земли земля землю
зеркало: зеркало
зеркальце: зеркальца
зерно: зерно
зима: зиму
зимний: зимнем зимней
зимой: зимой
зиновьев: зиновьев
зло: зло зла
злобный: злобный
злой: злого злой
злыдень: злыдни
змея: змей змея
знадоби: знадоби
знак: знак
знакомить: знакомит
знакомый: знаком знакомого знакомым знакомых
знамение: знамение
знаменовать: знаменует
знание: знания
знать: знает знают знающего
знахарь: знахарями
значение: значения значении
значительный: значительных
золотой: золотые
зооантропоморфным: зооантропоморфным
зооморфности: зооморфности
зооморфность: зооморфность
зооморфный: зооморфного
зоря: зорю
зрение: зрение
зря: зря
зубовский: зубовского
зыбка: зыбка
зыбочник: зыбочник
зыбочником: зыбочником
зыбун: зыбуны
зычный: зычный
иван: ивана иванов ивану иван
иванов: иванова
ивановский: ивановские
иванушка: иванушку
иверень: иверень
игнатов: игнатова
игорь: игорь
игоша: игоша
игра: играх игрой игры
играть: играет играть
игромания: игромания
игромедиа: игромедиа
идентифицироваться: идентифицировались
идея: идею
идти: идущего идти шло
ижакевича: ижакевича
избавиться: избавиться
избегать: избегают
избранный: избранных избранные
избушка: избушках избушке
известие: известия
известно: известно
известный: известны известен
изгородь: изгороди изгородь
изготавливать: изготавливает
изд: изд
издание: издание
издательство: издательство
издать: издали
издеваться: издевался
изменение: изменение
изменять: изменять
изменяться: изменяется
измерение: измерении
изначально: изначально
изнеможение: изнеможения
изображать: изображают
изображаться: изображаются изображаться изображается
изображение: изображениями
изобразительный: изобразительном
изобразить: изображена изображены изобразил
изучение: изучения
икона: иконой
иконка: иконку
илл: илл
иллюстрация: иллюстрациях иллюстрация иллюстрации
иллюстрировать: иллюстрированная
ильин: ильина
илья: илья
именно: именно
иметь: имеющих имеют имеющим имеет имеющими
иметься: имеющиеся
имитировать: имитировали
имущество: имуществом
имя: именами именах имя имени
инаковости: инаковости
индивидуализировать: индивидуализирован
индрик: индрик
инициация: инициации
иногда: иногда
иной: иных ином иной иную иным
инопланетянин: инопланетяне
иностранный: иностранных
институт: института институт
инструмент: инструменты
интеллект: интеллекта
интерес: интереса интерес
интернациональный: интернациональным
интерпретация: интерпретация
интонация: интонация
инфернальность: инфернальность
информант: информанты
информатика: информатика
иоанн: иоанна
ипостась: ипостаси
ирий: ирий
ироничный: ироничное
ирреальный: ирреальные
исаии: исаии
искажаться: искажаясь
искажение: искажению
искать: ищущие искали искала ищущим
исключать: исключает
искусство: искусстве искусств искусства искусство
искусствоведение: искусствоведение
исполниться: исполнится
исполнять: исполняет
использование: использования
использовать: используя использован использует использующие использующих использовано используют
использоваться: использовался используется использовались
испугать: испугать
испугаться: испугавшись
испытание: испытанием
исследование: исследований исследования
исследователь: исследователи исследователей исследователем
истинный: истинный
исток: истоки
истолкование: истолкованию
исторический: историческое историческом
история: историях историю история историй истории
источник: источниках источники источник
исход: исход
исчезать: исчезая исчезает
исчезновение: исчезновений
исчезнуть: исчезнуть исчезли исчезнет
июль: июля
июнь: июня
й: й
йеша: йеша
кабак: кабак
каверин: каверина
каждый: каждой каждом
каженник: каженник
кажется: кажется
казанский: казанских
казаркин: казаркин
казаться: казалось
казахстанский: казахстанского
каин: каин
каков: каков
календарь: календаре
калимуллина: калимуллина
калин: калинов
камень: камнем
кандидат: кандидата
кантэкст: кантэкст
кантэксце: кантэксце
канф: канф
капелла: капелла
капитоныч: капитоныч
караконджул: караконджул
карачун: карачун
карлик: карлики карликам карлик
карна: карна
карнавальности: карнавальности
карпатах: карпатах
карта: карты
картина: картинах картины картине
кастр: кастр
кастрыца: кастрыца
категория: категории
катенин: катенин
катенина: катенина
кафтан: кафтан
кациров: кациров
качание: качание
качаться: качаться
качели: качелях
качество: качестве
каша: кашей
кащеева: кащеева
кащея: кащея
квартальный: квартальный
кдпу: кдпу
кепка: кепку
киборта: киборта
киев: киев
кий: кий
кикимора: кикимора кикиморы
кил: килах
кинематограф: кинематографе
кино: кино
кирейко: кирейко
киркор: киркор
киркора: киркора
киров: киров
китеж: китеж
кладенец: кладенец
классик: классика
классический: классических классической
класть: кладут клали
клетка: клетку
клинообразный: клинообразная
клобук: клобук
клоун: клоуна
клубочек: клубочек
клычкова: клычкова
клюев: клюев клюева
ключ: ключ
кн: кн
книга: книги книге
книговедение: книговедение
книгопродавец: книгопродавец
книжка: книжка
книжность: книжности
кнут: кнут
князь: князя князь
ко: ко
кобченко: кобченко
ковригин: ковригина
ковыряние: ковырянием
коготь: когти когтями
код: код
кодекс: кодекс
кожа: кожа кожей
кожаный: кожаная
кожеезерского: кожеезерского
козий: козья
козлик: козлик
козловый: козлов
козлоногость: козлоногость
кой: кое
колдовство: колдовству
колдун: колдунами колдуном колдун
колечко: колечко
количество: количество
коллективизация: коллективизации
коллективный: коллективный
колокольчик: колокольчики колокольчик
колпак: колпак
колыбель: колыбель
коляда: коляда
коми: коми
комикс: комиксов
комма: комм
коммент: коммент
комментарий: комментарии комментарий
комплекс: комплексов комплексы комплекс
компонент: компонент
компромисс: компромисса
компьютерный: компьютерных компьютерные
кондратьев: кондратьева
конец: конце конца
конкин: конкин
конкурент: конкурентов
конон: кононов
константин: константина константин
контекст: контекст контексте
контролировать: контролировать
конференция: конференции
конфиденциальность: конфиденциальности
концепция: концепции
конь: коней конь
копия: копия
копыто: копыта
кора: коры кора корой кору
корабль: корабли
коргоруши: коргоруши
коренной: коренной
корень: корнях корнями
корзина: корзины
кормить: кормят
корова: коровах корова коровами коровы коров
коровий: коровья
королев: королева
король: король короля
короткий: короткий
корсаков: корсакова
корсунь: корсунь
коряга: корягах
косматый: косматый косматые
костенко: костенко
костра: костра
кострома: кострома
кострубонька: кострубонька
костюм: костюме костюма
кот: котом кот
котигорошка: котигорошка
котигорошко: котигорошко
который: которым которое которому которую которого которые которых которая котором который
коцура: коцура
кочерга: кочергой
кочка: кочке
кошка: кошек кошка
кошкарова: кошкарова
кощей: кощея кощею кощей
край: края краях
красноплеший: красноплеший
красноярский: красноярского
красный: красной красный красном
красочно: красочно
красть: крал
кратер: кратера
крест: крест
крестить: крестит
крестная: крестная
крестьянин: крестьянами крестьянина крестьян крестьяне
крестьянство: крестьянством
кривой: кривой
крик: крик криками
крикнуть: крикнуть
криницына: криницына
криничная: криничная
криничной: криничной
крип: крип
кричать: кричит кричащего
кровь: крови кровью кровь
кродо: кродо
крок: крок
кроме: кроме
крохотный: крохотный
круг: круга круг
круглов: круглова
круговой: круговую круговой
круговорот: круговороту
кругом: кругом
крутиус: крутиус
крыков: крыков
крыло: крылья
крыша: крыши
кувшинчик: кувшинчик
куда: куда
кузина: кузина
кузьма: кузьма
кук: куки
культ: культа
культура: культуре культурах культуры культура культур
культури: культури
культурный: культурным
культурология: культурология культурологии
кульчицкий: кульчицкой
купала: купала
купаться: купалась
купель: купели
кураш: кураш
курский: курский
кусаться: кусаются
кусок: кусок
кусочек: кусочек
куст: куст куста
кустистый: кустистые
куцый: куц
л: л
лабиринт: лабиринт
ладо: лада
ладоши: ладоши
ламя: ламя
лапоть: лапти
латышкевич: латышкевич
лев: льва льву
левкиевская: левкиевская
левкиевской: левкиевской
левый: левого левая левой левую левому
легенда: легенд легенда легенды
легко: легко
лежать: лежащем
лексикографический: лексикографического
леля: леля лель
лениться: лениться
леонид: леонида
лес: лесу лесе лесом леса лес лесов
лесавки: лесавки
лесачихе: лесачихе
лесистый: лесистый
лесник: лесник лесника
лесничий: лесничие
лесной: лесному лесное лесных лесные лесной лесного лесная лесными лесным
лесовик: лесовик лесовики лесовика лесовиков
лесовичок: лесовичок
лесовке: лесовке
лесовой: лесовой
лесовые: лесовые
лесостепной: лесостепной
лесун: лесун
лесуна: лесуна
лесунок: лесунок
лесьмяна: лесьмяна
леся: леся леси
летие: летию
летний: летнего
лето: летом
леха: лех
леша: лешей
лешак: лешаки лешак
лешачата: лешачата
лешачиха: лешачихи лешачиху лешачихе лешачиха лешачих
лешачков: лешачков
лешачонка: лешачонка
лешая: лешая
леший: лешем лешим лешему леший лешего леших лешие лешими
лешки: лешки
лешуки: лешуки
либо: либо
либретто: либретто
либроком: либроком
либуше: либуше
лиминальности: лиминальности
лингвистический: лингвистический
линогравюра: линогравюрах
липовый: липовая
лирика: лирике лирика
лирический: лирический
лиро: лиро
лист: лист листьями листьев листе
листва: листвой
лисун: лисун
литература: литературы литература литературе
литературный: литературных литературные литературном литературного
лихой: лихо лихих лихие
лихорадка: лихорадка
лицензия: лицензии
лицо: лицо лицом
личной: личной
лишайниковый: лишайниковая
лишать: лишает
лишаться: лишается
лишь: лишь
лобач: лобач
ловить: ловили
ловушка: ловушки
логово: логовом
ложиться: ложиться
ложный: ложными
ломать: ломать ломают
лонгин: лонгина
лоскут: лоскутьев
лотман: лотман
лошадиный: лошадиные
лошадь: лошади лошадь лошадей
лубок: лубок
луг: луга луг
лукавый: лукавый
лукаш: лукаша
лукоморье: лукоморья лукоморье
лукошко: лукошко
лукьянов: лукьянова
луна: луны
лутошка: лутошка
луцьк: луцьк
лучина: лучиной
лыбедь: лыбедь
лысая: лысая
лысенко: лысенко
лысый: лысым лысый
любитель: любитель
любить: любят любил любящий любимой любит
любовь: любовь
любой: любое любых любого любую любой любая
людка: людки
людмила: людмила
людоед: людоедом
людская: людскими людским
люлька: люльках люлька
лягушка: лягушка
ляд: ляд
лядова: лядова
ляп: ляп
лясовы: лясовы
лясох: лясох
лясун: лясун
ляцкого: ляцкого
м: м
мавка: мавка
мавками: мавками
мавки: мавки
магический: магической магические магический магическим магическими
магия: магия магию магии магией
мадлевская: мадлевская
мажорный: мажорная
македонский: македонски
маклай: маклая
максим: максимов максима
маленький: маленький маленьких
малороссийский: малороссийских
малый: малый
мальчик: мальчик мальчика
маляр: маляра
мамуна: мамуна
манить: манит манившие
манси: манси
мануковская: мануковская
мара: мара
марин: марины
мария: мария
марк: марк
маркин: маркин
марозава: марозава
марозавай: марозавай
марта: марта
мартин: мартин
маруся: маруся
марья: марье марья
масленица: масленица
массовый: массовым
мастацкае: мастацкае
мастацкая: мастацкая
матвей: матвеем
материал: материал материале материалов материалы
материнский: материнское
матерный: матерной матерная
маточник: маточнике
матывы: матывы
мать: мать матери
матэрыялах: матэрыялах
матэрыяле: матэрыяле
матэрыялы: матэрыялы
мафусаилом: мафусаилом
маца: мац
маша: маши
маэ: маэ
мая: мая
маячить: маячить
мгпу: мгпу
медведь: медведя медведей медведем медведи медведь
медиафайлы: медиафайлы
медный: медными
межд: межд
междометный: междометной
международный: международных международной
мелетинский: мелетинский
мелодия: мелодия
мельница: мельниц
менада: менады
менее: менее
менкв: менкв
ментальность: ментальности
меньший: меньшей
менять: меняет менять
меняться: меняются меняется
меркул: меркулов
мертвец: мертвец мертвецов
меряет: меряет
местами: местами
местный: местные
место: место местах места местом мест месте
месяц: месяц
метель: метель метели
меткий: метким
меткость: меткости
метнера: метнера
меховой: меховая
мечтать: мечтает мечтал
мешать: мешающей мешать мешал
мея: мея
миграция: миграциям
мидгард: мидгард
мизгирь: мизгиря
миклухо: миклухо
миколайчук: миколайчук
миллер: миллер
милляр: милляр
министерство: министерства
минск: минск
минц: минц
минь: мини
мир: мира мир миром мире мирами
мировосприятие: мировосприятие
мироощущение: мироощущение
миросозерцание: миросозерцания
мисаил: мисаил
мистецтво: мистецтво
мистический: мистическим мистических
миф: мифа мифу миф мифы
мифический: мифического мифические
мифо: мифо
мифологизировалось: мифологизировалось
мифологический: мифологическими мифологический мифологической мифологическом мифологические мифологических мифологическое мифологического мифологическим
мифология: мифологии мифологией мифологиях мифология
мифопоэтика: мифопоэтика
мифопоэтический: мифопоэтической
мифоритуальной: мифоритуальной
михаил: михаила михаил
мишулин: мишулин
младенец: младенца младенцев
младший: младшему
мнение: мнению
многие: многие многих
много: более много
многогранный: многогранен
многокомпонентный: многокомпонентным
многоликий: многолик
многообразие: многообразие
многочисленный: многочисленных
множество: множестве множество
мобильный: мобильная
мова: мова
могущественный: могущественного
моделировать: моделирующие
модель: модель
можно: можно
мозырь: мозырь
мой: мою
мокошь: мокошь
мол: мол
молебен: молебен
молитва: молитвами молитвы молитва молитву
молить: молили
молиться: молиться
молодая: молодых
молоко: молоко
молча: молча
молчаливый: молчалив
момент: момент
моргать: моргают
мордва: мордвы
моревна: моревна
мороз: морозу морозов мороз
морозко: морозко
морочить: морочат
морской: морская морской
морщина: морщинах
моряна: моряна
москва: москва
мост: мост
мотив: мотив мотивов мотива мотивам мотивы
мотивировать: мотивированные
мотивный: мотивный мотивные
мох: мох мха мхом
мохнатый: мохнатого мохнатым
моховик: моховик моховиков
мочь: мог могли могут могла
мрачный: мрачную
мудрость: мудрости
мужик: мужиков мужики мужик
мужичка: мужички
мужичок: мужичок мужичком
мужской: мужской
мужчина: мужчина мужчин мужчине мужчины
музееведение: музееведение
музыка: музыке музыку музыка
музыкант: музыканты
мультфильм: мультфильм мультфильмов мультфильма мультфильмы мультфильме
муравейник: муравейник
мусаил: мусаил
мухомор: мухоморами
мученик: мученика
мы: нами нам
мыслить: мысли
мыться: мыться
н: н
наблюдать: наблюдавший наблюдает
наблюдаться: наблюдается наблюдалось
наблюдение: наблюдению
набоков: набокова набоков
набрать: набрать
нав: нав
наваждение: наваждением наваждения
навигация: навигации навигация
навредить: навредит
навук: навук
навукова: навукова
навь: навь
нагина: нагина
нагнуться: нагнуться
нагой: нагая
нагота: нагота
награда: награды
над: над
надвигаться: надвигается
надеть: надета надеть
надобность: надобности
назад: назад
название: названия названий название
назвать: названный
назидание: назиданием
называть: называемом называли называя называть называют
наиболее: наиболее
наизнанку: наизнанку
наименование: наименований наименования
найти: найти
наказание: наказание
наказать: наказать
накануне: накануне
наконец: наконец
налево: налево
наличие: наличие
нана: нан
нанимать: нанимать
наоборот: наоборот
наотмашь: наотмашь
нападать: нападают
нападение: нападений
написать: написать
наподобие: наподобие
напоминать: напоминает напоминающий
направление: направлению
например: например
напугать: напугать
нарис: нарис
нарисовать: нарисовал
народ: народов народ народы народа народе народу
народный: народному народно народная народном народного народным народной народные народных народное
народознавства: народознавства
нарративов: нарративов
нарубить: нарубить
нарушать: нарушать
нарушение: нарушений нарушение
нарушить: нарушивший
население: населения
наслать: наслать
наследовать: наследующих
насмешливый: насмешливый
наставник: наставник
настенный: настенное
настолько: настолько
настоящее: настоящим настоящих настоящего
наступить: наступит
насылать: насылают
наука: наука наук науки
науковий: науковий
наукового: наукового
научить: научить
научный: научный научные научных научной научно
находить: находит
находиться: находились
нац: нац
нация: нация
начало: начало начале начала
начальник: начальник
начинать: начинают начинает начиная
наш: нашему наше нашем наши
небесный: небесной
неблагообразный: неблагообразной
неблагословенный: неблагословенный
небо: небес неба
небольшой: небольшие
небылица: небылицах
неведомый: неведомая неведомых
невидимка: невидимку
невидимый: невидимым невидим невидимые невидимого невидимой невидимыми
невозможно: невозможно
негативный: негативные негативным
недалекий: недалеко
неделя: неделя неделями
недовольство: недовольстве недовольство
недоступный: недоступная
неестественно: неестественно
неестественный: неестественною
нежелание: нежеланием нежелание
нежита: нежита
нежить: нежить нежит
незамерзающий: незамерзающими
незаметно: незаметно
незнаемый: незнаемом
незнакомый: незнакомом незнакомый
неизведанный: неизведанное
неизвестный: неизвестного
неистовый: неистово
неклюдов: неклюдов
некогда: некогда
некоммерческий: некоммерческой
некорректный: некорректный
некоторые: некоторыми некоторым некоторых некоторые
некоторый: некоторое
некошной: некошной
некрасов: некрасова
нельзя: нельзя
немец: немцев
немецкий: немецкие
немногословный: немногословен
немногочисленный: немногочисленные
немой: нем
немухине: немухине
немухинские: немухинские
ненавидеть: ненавидящие
ненадлежащий: ненадлежащее
ненадобность: ненадобностью
ненадолго: ненадолго
необходимо: необходимо
необходимость: необходимостью
необычный: необычных
неопр: неопр
неорганичный: неорганичен
неперсонифицированном: неперсонифицированном
неповоротливость: неповоротливость
непогода: непогода
неподвижный: неподвижные неподвижен
неподвластный: неподвластным
непокрытый: непокрытой
непомнящих: непомнящих
непослушный: непослушные
непременно: непременно
непривычный: непривычных
неприкаянный: неприкаянного
непроходимый: непроходимое непроходимыми непроходимые
нерабочий: нерабочими
нередко: нередко
несказочной: несказочной
несколько: нескольких несколько
несмелова: несмелова
несмотря: несмотря
несоблюдение: несоблюдение
несчастие: несчастья несчастий
несчастный: несчастен
неуважение: неуважением
неуловимый: неуловим
неуспокоенный: неуспокоенных
нехарактерный: нехарактерной
нечистики: нечистики
нечистый: нечистым нечистая нечистую нечистой
нечисть: нечисти нечисть
нечуй: нечуй
нива: нива
низвергнуть: низвергнутые
низкий: низшая низшей
ний: ний
никитин: никитина никитин
никифор: никифора
никифоровский: никифоровский никифоровского
никогда: никогда
никодим: никодима
николай: николаю николая николай
николу: николу
николы: николы
никто: никого никто никому
никуда: никуда
ниточка: ниточкой
нло: нло
новак: новак
новгородский: новгородского
новичкова: новичкова
новогодний: новогоднем новогодние новогодних новогодняя
новосибирск: новосибирск
новый: новая новый новой новые новых новейшего новое
нога: ногами ногах ног нога ногой ноги ногу
ноготь: ногти ногтями
ноздря: ноздри
нора: норам
нормативный: нормативных
нос: нос носом
носить: носить носит
носов: носова
ночевать: ночевать
ночлег: ночлег
ночница: ночницей ночница
ночное: ночные ночное
ночной: ночной
ночь: ночам ночь ночи ночью
ноябрь: ноября
нрав: нраве
нравиться: нравится
нужно: нужно
нюлэсмурт: нюлэсмурт
нячистик: нячистик
об: об
оба: оба
обводить: обводили
обезличивание: обезличивание
оберег: оберег оберегов оберегами
обеспечивать: обеспечивает
обеспечить: обеспечить
обещать: обещал
обзор: обзор
обзорный: обзорная
обидеть: обиженный
обидеться: обиделся обидеться
обиталище: обиталище
обитание: обитания
обитатель: обитателей
обитать: обитают
обитель: обитель
обладать: обладает
область: области
облик: облик облике облика
обличие: обличья обличьях
обложка: обложки
обман: обман
обманщик: обманщика
обменять: обменянные
обнаружить: обнаружить
обновление: обновление
обогатитель: обогатитель
обоз: обоз
обозрение: обозрение
обойти: обойти
оборванный: оборванной
оборотничеству: оборотничеству
обособление: обособление
образ: образу образов образа образах образами образом образы образ образе
образец: образцом
образи: образи
образовательный: образовательный
обрастать: обрастают
обрасти: обросшее обросший обросшая обросшие
обратный: обратно обратную
обращать: обращает
обращаться: обращался обращаясь обращались
обращение: обращением обращения
обряд: обряды обряде обряд обрядов обрядах
обсуждать: обсуждают
обсуждение: обсуждение
обувь: обувь
обхват: обхват
обхитрить: обхитрить
обход: обход
обходить: обходил
общаться: общаться общается
общение: общению
общественный: общественные общественного
общество: обществе общества общество
общий: общие общ
объединять: объединяя
объект: объект объектом
объяснение: объяснение объяснением
объяснять: объясняют объясняли
объясняться: объясняется
обыкновенный: обыкновенная
обычно: обычно
обычный: обычного обычных обычные обычный обычным
овинник: овинник
овца: овец
овчеренко: овчеренко
оги: оги
оглушать: оглушают
огневой: огневого
огненный: огненная огненный
огнестрельный: огнестрельного
огонек: огоньки
огонь: огонь огни
ограда: ограды оградой
оградить: оградить
огромный: огромными огромного огромные огромной
огу: огу
огуменника: огуменника
одеваться: одеваясь
одежда: одежда одежду одежде одежды
одетый: одетый одет
один: одну одной одна одном одного один одному одним одни
одинокий: одинок одиноким
однако: однако
одновременно: одновременно
одолень: одолень
одолеть: одолеть
ожить: ожившими ожившим
озвучивать: озвучивает озвучивают
озеро: озеро
означать: означала означало
оказать: оказали оказанную
оказаться: оказаться оказались
оказываться: оказывается
около: около
окрестить: окрестить окрестив
окружать: окружающей окружающего
октябрь: октября
олександр: олександра
олесь: олеся
олицетворение: олицетворение олицетворений олицетворением
омут: омуты
он: нему
они: им ими них ними
онлайн: онлайн
оно: оно
оноприенко: оноприенко
опасно: опасно
опасный: опасной опасным опасная
опера: опера опере
описание: описания описаниях описание
описывать: описывать
описываться: описывается описывался описываются
оппозиция: оппозицией
определение: определению
определить: определить определено
определяться: определяется
опушка: опушке
организация: организации
орест: ореста
оригинал: оригинала
оригинальный: оригинальных
ориентир: ориентиры
оркестровый: оркестровой
оружие: оружия
орфей: орфей
освободить: освободил
освобождать: освобождают освобождает
освобождаться: освобождающимся
освоить: освоенным
осина: осины осину осина
осиновый: осиновый
основа: основе основу
основное: основном основное
особенно: особенно
особенность: особенностей особенности
особый: особым особые
оспариваться: оспаривается
оставаться: оставался остаются
оставить: оставить оставленному
оставлять: оставляют оставлял оставляет
оставляться: оставляется
остальное: остальные остальных остальными
остальной: остальная
остановка: остановки
остаться: осталось оставшегося
островский: островского
остроконечный: остроконечная
отв: отв
отвадить: отвадить
отведывания: отведывания
отвергать: отвергает
отвергнуть: отвергнутая
ответ: ответом ответ
ответить: ответить
ответственность: ответственности
ответственный: ответственный
отвлекать: отвлекая
отвлекаться: отвлекаясь
отводить: отводит
отворачивание: отворачивания
отголосок: отголоски
отдать: отдай
отдел: отдела
отделение: отделение отделения
отделимый: отделим
отдельный: отдельного отдельный отдельных
отец: отец
отечество: отечество отечеству
отказ: отказ
отказываться: отказывается
отклик: откликом
откликаться: откликаться откликаясь
открывать: открывая открывал открывать
открытка: открытка
открыть: открытый
открыться: открыться
откуда: откуда
отличие: отличие
отмечать: отмечал отмечает отмечают отмечала
отнимать: отнимают
относительный: относительную
относиться: относится относились относятся относился
отношение: отношения отношению отношение
отодвинуться: отодвинулось
отождествление: отождествление
отойти: отойти
отомстить: отомстить
отопление: отопления
отпирать: отпирает
отправляться: отправляясь
отпуск: отпуска отпуск
отражаться: отражающееся
отражение: отражение отражением
отраженье: отражений
отредактировать: отредактирована
отрицательно: отрицательно
отрицательность: отрицательности
отрицательный: отрицательный отрицательных
отрок: отрок
отрубить: отрубить
отстегать: отстегать
отсутствие: отсутствие
отсутствовать: отсутствует отсутствовать
отсюда: отсюда
отход: отхода
отчасти: отчасти
ох: ох
охлаждать: охлаждающего
охота: охоту охоте охоты охота
охотиться: охотились охотится охотиться
охотник: охотниками охотник охотники охотником охотникам охотнику охотника
охотников: охотников
охотничий: охотничьих охотничью
охранять: охранять охраняли охраняет охраняют
оценочный: оценочных
очеловечить: очеловеченные очеловечен
очень: очень
очерк: очерки очерк
очертить: очерченный
очерчивать: очерчивали
очистить: очищенная
ошибка: ошибке ошибками
ошибоч: ошибоч
п: п
паборцава: паборцава
павел: павел павла
пад: пад
падать: падая
падение: падения
палец: пальца
палка: палка
паломник: паломников
памятник: памятниках
памятный: памятная
пан: паном пан
панна: панны
панно: панно
пантелеимон: пантелеимон
пантелей: пантелеевич
папоротник: папоротника
параллельно: параллельно
парень: парень парней парню
паровоз: паровозы
пас: пас
пассивный: пассивный
пасти: пасли пасут
пастир: пастир
пастись: пасутся
пастух: пастухом пастух пастухам пастухи пастухами пастухов пастуху пастуха
пастушеский: пастушеские
пастушка: пастушка
пасть: пасти
пасха: пасху пасха
пасхальный: пасхальное
патриарх: патриархом
патриот: патриот
паутина: паутину
пафос: пафосом
пачатку: пачатку
педагогика: педагогика
педагогический: педагогических педагогического
пейзаж: пейзажа
пение: пение
пенить: пень
пень: пне пнями
пенька: пеньке
пеперуда: пеперуда
первое: первым первого первое первых
первопричина: первопричина
первохрестное: первохрестное
первый: первую первый
перебраться: перебраться
перевернуть: перевернуть
перевес: перевесом
перевод: переводе перевода
перевязать: перевязать перевязанный
перед: перед
передавать: передавая
передать: передать
передвигаться: передвигающийся
переделка: переделок переделке переделки переделкам
передразнивать: передразнивает передразнивать
переехать: переехал
переживать: переживают
пережиток: пережитки
перезапрячь: перезапрячь
перейти: перейти
перекази: перекази
перекладывать: перекладывали
перекрестить: перекрестил
перекреститься: перекреститься
перем: перем
перемена: перемены
перемещаться: перемещаться
перенаправляться: перенаправляется
переодевание: переодевания переодевание
переодеваться: переодевались
переодеть: переодеть
переодеться: переодевшись
переозвучке: переозвучке
переплетение: переплетение
переслать: перешли
переставать: перестают
переть: при пер
переход: переходе
переходить: переходит переходил переходят
переходный: переходные
перешагивать: перешагивать
период: периода период
пермь: пермь
персонаж: персонаж персонажу персонажам персонажа персонажами персонаже персонажем персонажах персонажей персонажи
персональный: персональные
персонификация: персонификацию персонификация
персонифицировать: персонифицирует
перун: перун
перуна: перуна
перхта: перхта
песнь: песнях песнь песни
песня: песня песне
петербург: петербург
петербургский: петербургский петербургского
петр: петра
петрозаводск: петрозаводск
петрозаводский: петрозаводского
петь: поют
печать: печати
печь: печь
пещера: пещере
пивоваров: пивоварова
пигин: пигин
пизамар: пизамар
пировать: пирует
пирог: пироги
писатель: писатель
письменность: письменности
питання: питання
питаться: питающийся
пить: пить
пицен: пицен
пища: пищу
плакать: плачущего плачет
план: плане
планетники: планетники
племенной: племенном
плетение: плетением
плеть: плетью
плечо: плечи
плохо: плохо
плохой: плохой плохое
площадь: площади
плут: плут
пляска: пляски
победа: побед
победить: победить
победоносец: победоносца
побеспокоить: побеспокоили
поблазнилось: поблазнилось
поблизости: поблизости
поболе: поболе
поборник: поборниками
побуждать: побуждает
повалить: поваленную повалила
поведение: поведением поведении поведение поведения
поверхность: поверхности
поверье: поверий поверьям поверье поверья поверьями поверьях
повеселиться: повеселиться
повествовать: повествует
повестить: повести
повивальный: повивальная
повод: поводом повод поводу
повреждаться: повреждаются
повторный: повторное
погибать: погибает погибают
погибнуть: погибнуть погибшей
погода: погода
погреться: погреться
погубить: погубить
подага: подага
подарок: подарок
подать: подан
подвергаться: подвергается
подвешивать: подвешивают
подвеять: подвей
подвластный: подвластными
подгот: подгот
подготовка: подготовка
поделка: поделки
подменивать: подменивать
подменыш: подменыш
подменыша: подменыша
подметить: подмечена
поднимать: поднимает
подносить: подносят
подобие: подобием
подобно: подобно
подобный: подобных подобные подобным
подпоясать: подпоясан
подражать: подражать
подробный: подробнее
подростковый: подростков
подружиться: подружился
подсечный: подсечно
подтверждать: подтверждает
подтыкнута: подтыкнута
подчас: подчас
подчиняться: подчиняется
подшутить: подшутить
подымать: подымают
поезд: поезда
пожар: пожаров
пожертвовать: пожертвовать
позаботиться: позаботиться позаботилась
позвать: позвать
позвизд: позвизд
позднева: позднева
поздний: поздний позднее позднего поздние поздних
позеленеть: позеленевший
поиграть: поиграть
поиск: поисках поиски поиск поиске поиску поиска
поймать: поймано
пока: пока
показать: показан показал показать
показаться: покажись
показывать: показывая показывал показывает
показываться: показывался
покалечить: покалечить
покарать: покарать
покидать: покидает
поклонение: поклонения
покойник: покойники
покоряться: покоряется
покровитель: покровитель покровителя покровителем
покровительство: покровительства покровительство
покрывать: покрывающими
покрыть: покрыты
пол: поле пола пол
полдень: полдень
поле: поля
полевик: полевик
полевой: полевым полевыми полевых полевого
полено: полено поленья
полесье: полесье
полисемантизм: полисемантизм
политик: политика
политология: политология
полить: полей
полностью: полностью
полночь: полночь
полный: полная
половина: половина половине
половой: половую
положительный: положительных
положить: положить
полоса: полосе
полтина: полтину
полудница: полудница
полулюд: полулюд
полусмерть: полусмерти
получать: получают
получеловек: получеловек
получить: полученное получить
пользоваться: пользующийся
польский: польский польской
поляков: поляков
поляна: поляне
поменять: поменять
померанцевый: померанцева
поместить: поместив
помимо: помимо
помогать: помогает помогающий
помолиться: помолиться
помочь: помог помогли помогший помочь
помощник: помощник помощнике
помощь: помощью помощи помощь
помрачать: помрачает
поначалу: поначалу
понести: понести
понижать: понижает
понимать: понимать
пониматься: понимается
понравиться: понравившейся понравиться
понырко: понырко
понятие: понятием понятия
пообещать: пообещав
поп: попа
попадание: попадания
попадать: попадала
попасть: попасть
поплатиться: поплатиться
попросить: попросят попросить
попугать: попугать
популярность: популярность
популярный: популярных популярная популярным
попутчик: попутчике попутчика
попытаться: попытаться
попытка: попытка
пора: пора
поражение: поражений поражение
поревит: поревит
поренут: поренут
порожняковый: порожнякова
портал: портал
порыв: порывами
посадить: посадил
посвистывать: посвистывал
поселение: поселения
посещать: посещать
посещение: посещения
поскольку: поскольку
послать: послав
последний: последнее последняя последний последнего
последствие: последствие последствиям
послужить: послужили
посмотреть: посмотрит посмотреть
пособник: пособник
посол: после
посолони: посолони
посолонь: посолонь
поспешить: поспешит
пост: постом
постепенно: постепенно
постоянный: постоянная постоянный
посуда: посуды
посулить: посулены
посылание: посылания
посылать: посылать посылали
потапенка: потапенка
потеря: потерей
потерять: потерять
потеряться: потерявшимся потерялся потерявшемся
потомок: потомки
потусторонний: потустороннего потустороннюю
потусторонность: потусторонности
похитить: похищенным похитить похищенная похищенный похищенную похищенные похищенных похищенного
похищать: похищать похищает похищают
похищение: похищении похищением похищения
поход: походом
похожий: похожее похож
похоронный: похоронная
почему: почему
почитать: почитаемые
пошка: пошка
пошутить: пошутить
пощупать: пощупает
поэзия: поэзия поэзии
поэма: поэме поэмы
поэт: поэта
поэтика: поэтика
поэтический: поэтические
поэтому: поэтому
появиться: появились
появление: появлении появление появлением
появляться: появляются появляться появляется
пояс: пояса пояс
пр: пр
пра: пра
праблемы: праблемы
правда: правда
праведность: праведность
праведный: праведный
править: править правил
правка: правка правки
православный: православной
правый: правую правое права правая правый право
правящий: правящий
прагматик: прагматика
прадедушкиного: прадедушкиного
празднество: празднествах
праздник: праздник
праздничный: праздничный праздничное праздничных
праздновать: празднуют
практик: практика практики
практический: практически практической
практычнай: практычнай
прасторы: прасторы
праф: праф
праца: праца
пребывание: пребывании пребывания
пребывать: пребывают
превосходство: превосходство
превращать: превращает
превращаться: превращалась превращаться превращается
превращение: превращения
преграда: преградой
преданный: преданный
предательство: предательство
предварительно: предварительно
предвещать: предвещает
предел: пределами
предлагать: предлагает
предлагаться: предлагается
предложение: предложения
предложить: предложенных
предмет: предметы предметом предметами
предок: предкам предка
предполагать: предполагает предполагал
предполагаться: предполагаются
предположение: предположение
предположительный: предположительное
предпочитать: предпочитали
предпринимать: предпринимали
предсказание: предсказания предсказанию
предсказатель: предсказатель
предсказать: предсказать
предсказывать: предсказывать
представать: представать
представитель: представителей
представить: представленные представлен
представиться: представились
представление: представление представлениям представлениями представления представлением
представленье: представлений
представлять: представляли
представляться: представлялся представляется
предстать: предстать
предчувствие: предчувствие
преемственный: преемственно
преимущественный: преимущественно
премудрый: премудрая
преобладать: преобладает
преподносить: преподносили
препятствие: препятствие
прерогатива: прерогатива
приводить: приводит
приводиться: приводиться
привычка: привычка
привычный: привычных
привязать: привязать
приглашать: приглашает
приглашение: приглашение
придать: придало
приезжать: приезжать
призвать: призвать призванных
признак: признаков признаками признаки признаком
призрак: призраки призрака
прийти: придя прийти
прикамье: прикамья
прикасаться: прикасаться
прикинуться: прикинувшись
приключение: приключения
прилагаться: прилагается
прилож: прилож
применение: применение
пример: примере
примета: приметы
примечание: примечания
примитивный: примитивного
принадлежность: принадлежности
принести: принести
принимать: принимали принимает принимал принимать принимающее
приношение: приношение
принять: принято
приобретать: приобретают
приобщение: приобщения
припегала: припегала
приписывать: приписывали
приписываться: приписывается приписываются
приравниваться: приравнивалась
природа: природу природе природы
природный: природного
прислать: пришли
прислуживать: прислуживать
присмотр: присмотра
присоединяться: присоединяется
присутствовать: присутствуют присутствует
присущий: присущие присущим
приход: приходе приход
приходить: приходить приходят
приходиться: приходится
причина: причины причина причиной
причислять: причисляли
про: про
проблема: проблемы
проваливаться: проваливается проваливаются
прове: прове
проведать: проведать
проверить: проверенная
проводиться: проводившихся
проворный: проворными
прогнать: прогнать
прогонять: прогоняет
прогресс: прогресс
продавать: продавать
продажа: продаже
проект: проект проектах
проза: прозы прозе
прозаический: прозаическом
прозвать: прозвали
прозвище: прозвище
прозрачно: прозрачно
проиграть: проиграть
произведение: произведения произведениях
произведенье: произведений
произвести: произвести
произнесение: произнесение
произнести: произнести
произносить: произносить произнося
произойти: произошедшему произошло
происходить: происходящим происходит
происхождение: происхождению происхождение происхождении
проказничать: проказничают проказничающей
проклясть: проклятого прокляли проклятые проклятой проклятый
проклятие: проклятий проклятия проклятие
пролог: прологе пролога
проложить: проложенной проложил
промеж: промеж
промысел: промыслам промысле
проникать: проникающих
пропажа: пропажи пропажа пропажу
пропасть: пропавшего пропавшие пропавших пропавшая пропавшему пропавший пропасть пропавшую
пропитание: пропитании
пропить: пропить пропивший
пророк: пророка пророком пророк
просить: просить просит
проскурин: проскурин
просматриваться: просматриваются
просмотр: просмотры
просто: просто
простой: простым простых
простонародный: простонародных
пространство: пространством пространство пространства
просьба: просьба
против: против
противоборство: противоборстве
противоположный: противоположный
противопоставлять: противопоставляли
противоречивый: противоречивы противоречивым
противоречие: противоречия
противостояние: противостоянии
противостоять: противостоит
протрубить: протрубив
профессионал: профессионала
проходить: проходят проходили проходит проходивших
прохождение: прохождение
прохожий: прохожих
процесс: процессе
процессия: процессия
прочий: прочие прочая прочего прочее
прошение: прошением
прошлый: прошлом прошлое
прощание: прощание
прощать: прощает
проявление: проявление проявлением проявления
проявлять: проявлять проявляет
проявляться: проявляются проявляться проявлялось
прут: прутьями
прыемка: прыемка
прысвеч: прысвеч
прямой: прямо
прятать: прячут прячет
психологический: психологическим
псковский: псковский
псковской: псковского
псоглавцы: псоглавцы
птица: птица птиц птицы
пугало: пугал
пугать: пугает пугающих пугают
пуговица: пуговицами
пуля: пулями
пусть: пусть
путать: путали путает
путник: путник путников
путь: путь пути
пушиться: пушатся
пушкино: пушкина
пушкинский: пушкинского пушкинский пушкинские пушкинское
пуща: пущах пущи пуще
пущевик: пущевик
пущевики: пущевики
пущевиков: пущевиков
пыль: пыль
пытаться: пытавшегося пытались
пьеса: пьесе пьес пьесы
пятка: пятку пяткой
пятница: пятница
р: р
раб: рабом
раба: раба
работа: работ
работник: работники
равноапостольный: равноапостольная
рагойшы: рагойшы
радегаст: радегаст
раденкович: раденкович
ради: ради
радостный: радостный
радость: радостью
раз: раза
разбогатеть: разбогатеть
разбойник: разбойник
разбор: разбора
развадовская: развадовская
развенчать: развенчанный
развитие: развития развитии развитие
развить: развиты
разводить: разводить
разглядеть: разглядеть
разговаривать: разговаривать разговаривает
разговор: разговорами разговоры разговор
разгонять: разгоняют
раздеваться: раздеваясь
разделить: разделены
разделяться: разделяются
раздетость: раздетость
раздеть: раздела
раздражение: раздражением
различный: различные различных
разлука: разлуку
размер: размеру
размыть: размыты
разниться: разнятся
разнообразие: разнообразие
разнообразный: разнообразны
разный: разный разной разных разные разному разными
разозлиться: разозлившись
разработчик: разработчики
разрешение: разрешения
разрушать: разрушает
разрушение: разрушение
разрушительный: разрушительным
разрыв: разрыву
разрыть: разрыв разрыть
разудалый: разудалый
разум: разум
разумов: разумова
район: района
ракита: ракит
ран: ран
ранее: ранее
ранний: ранних раннего
рано: рано
рарог: рарог
раскаиваться: раскаивается
раскат: раскатам
раскатистый: раскатисто
раскаяться: раскаявшимися
раскидать: раскидать
раскидывать: раскидывает раскидывали
раскрываться: раскрывается
распахивание: распахиванием
расплывчатый: расплывчат
распознаваться: распознавался
расположить: расположенную
распоряжаться: распоряжается
распоряжение: распоряжении
распределять: распределяет
распространение: распространение
распространить: распространены распространено
распространиться: распространилось распространились
распустить: распущенными
распутье: распутье
рассказ: рассказе рассказам рассказы рассказах
рассказов: рассказов
рассказчик: рассказчик рассказчика
рассказывание: рассказывание
рассказывать: рассказывали рассказывал рассказывают
рассказываться: рассказывается
рассматривать: рассматривали рассматривать рассматривают
рассматриваться: рассматриваться рассматривался рассматривались рассматривалось
рассмешить: рассмешить
расставаться: расставаясь
расстаться: расстаться
расстояние: расстоянии
рассудок: рассудок
растворение: растворении
растворяться: растворяются
растение: растение растения
растенье: растений
расти: растущими
растительность: растительностью растительности
растительный: растительного растительной растительные растительный
ратайчик: ратайчик
рациональный: рациональное
рая: рай
рвв: рвв
рггу: рггу
реализация: реализации
реально: реально
реальность: реальности
реальный: реальная реальные реальных
ребенок: детей детях дети
ребро: ребром
ребята: ребятами
ревзин: ревзин
ревю: ревю
регион: регионе регионах
региональный: региональных региональной
регл: регл
регулярно: регулярно
редактор: редактор
редакция: ред
редко: редко
редкол: редкол
реж: реже
результат: результате
река: река рекой реки
религиозность: религиозности
религиозный: религиозные
ремиз: ремизов
ремизов: ремизова
ремизовские: ремизовские
реминисценция: реминисценции
репертуар: репертуара
репродуктивный: репродуктивной
рерих: рерих рериха
ресница: ресницы
республиканский: республиканский
ресурс: ресурсы
рецепция: рецепция
речной: речные
речь: речь
решать: решать
решение: решение
решиться: решившуюся
римский: римского римские
рисунок: рисунке рисунок
ритуал: ритуала ритуалу ритуалы ритуал
ритуальный: ритуальной ритуальном ритуальный ритуальная ритуальных ритуальные
рог: рога
рогатый: рогатый
родина: родину родине родиной
родины: родины
родительский: родительское
родник: родник родника
роднить: роднит
родные: родных
родовой: родовым
родственник: родственники родственников родственника родственником
родственный: родственные
родство: родства родство
роды: родах роды
рождать: рождает
рождение: рождения
рождественский: рождественской
рожок: рожками рожки
рок: роке рок
роль: роль
роман: романов романе романа
романов: романова
романтик: романтиков
романтичный: романтичны
роспись: росписи
российский: российских российского российская российский
россия: россии россия
рост: рост роста росте
роща: роще
рубить: рубят рубить
рубль: рубля
ругательство: ругательствах
ругаться: ругаться
ругевит: ругевит
рудин: рудин
ружье: ружья
рука: руку рукой рука руках руки
рукав: рукавами
руководство: руководство
русалка: русалка русалкой русалки русалками
руслан: руслан
русская: русские русских русская русскими русской
русский: русском русского русское русский
русскоязычный: русскоязычного
русый: рус
рута: рута
ручей: ручей
рыба: рыбу
рыболов: рыболов
рыжий: рыжими рыжие
рыжков: рыжкова
рысы: рысы
рыть: роют
рычать: рычит
рэд: рэд
рэдагаванне: рэдагаванне
рэдкал: рэдкал
рюбецаль: рюбецаль
рябина: рябина
рябиновый: рябиновой
ряд: ряду ряд рядом ряде
ряз: ряз
рязань: рязань
ряса: рясы
савва: савва
савельев: савельева
саврасый: саврас
сага: саге
садиться: садились
сайфиева: сайфиева
сакральний: сакральний
сало: сала
сам: самого сами сама
самовал: самовал
самойлов: самойлова
самостоятельность: самостоятельностью
самостоятельный: самостоятельных
самоубийство: самоубийство
самоходный: самоходную
самуил: самуилом
самый: самый самым самых самые
санаров: санаров
санкт-петербург: спб
санкт: санкт
сантиметр: см
сапковского: сапковского
сапог: сапоги
саратовский: саратовского
сарафан: сарафане
сатанаил: сатанаил
сатанаилом: сатанаилом
сатира: сатирами сатиры
сб: сб
сбивать: сбивают сбивающем сбивает
сбить: сбить
сближать: сближает
сближаться: сближаться
сборище: сборище
сборник: сборник сборники сборнике сборника
свадебный: свадебного
свадьба: свадьбы свадьбами свадьба
сварог: сварог
сварожич: сварожич
сват: сватом
свататься: свататься
сведение: сведения
свежий: свежие
свергнуть: свергнутые
сверхъестественный: сверхъестественную
света: света свете
светлана: светлана
свинцовый: свинцово
свист: свист свистом
свистать: свищет
свистеть: свистят свистит
свободный: свободной
свод: свод
сводить: сводят
свое: своих свои своему своего своим своими
своенравный: своенравный
своеобразие: своеобразие
свой: свой своей свою
свойство: свойство
связанный: связано связанные связана связанный связанного связаны
связаться: свяжитесь
связка: связку
связывать: связывали
связь: связи связь связей
святки: святок святки
святовит: святовит
святой: святым святого святых святые святой
сгонять: сгоняли
сделка: сделка
себя: собой
север: севере северу севера
севернорусские: севернорусские
севернорусских: севернорусских
севернорусского: севернорусского
севернорусской: севернорусской
северный: северного северных
сегодня: сегодня
седой: седой седые седая седого седым
седьмой: седьмой
сезон: сезона
сейчас: сейчас
сексуальный: сексуальной
селиван: селиване
семантика: семантика семантики
семантико: семантико
семантический: семантический
семейство: семействе
семиотика: семиотика
семиотическая: семиотическая
семиотические: семиотические
семью: семью
семья: семьями
сентябрь: сентября
серб: серб
сербохорватский: сербохорватский
сербский: сербский сербская
сервис: сервиса
сергей: сергея сергей
сердце: сердце
серебряный: серебряного
середина: середины
сериал: сериала
серия: серии серия
серый: серым серый сер серыми
серыя: серыя
сестра: сестру сестре
сесть: сел сесть
сжигать: сжигают
сзади: сзади
сибирка: сибирка
сибирский: сибирского сибирских
сибирь: сибири
сивобородый: сивобородый
сидеть: сидеть сидит сидящий сидя
сила: силу силой сила сил силы силе
силен: силен силена
сильный: сильного сильным сильный сильна
сим: сим
симаргл: симаргл
символ: символом символ
символизировать: символизирует
символика: символике символика
симпатизировать: симпатизирует
симфонический: симфоническая
синий: синий синяя синие
синкретичностью: синкретичностью
синкретичный: синкретично
синодальный: синодальном
сирин: сирин
сиротинушка: сиротинушка
система: системе система системы
сказание: сказаний
сказать: сказать сказал
сказаться: сказались
сказка: сказка сказках сказок сказки сказку сказке
сказочный: сказочный сказочных сказочные
сказываться: сказывается
скачать: скачать
скаче: скаче
сквозь: сквозь
скептицизм: скептицизм
сколько: сколько
скопление: скопления
скоро: скоро
скорульского: скорульского
скот: скотом скот скоту скота
скотий: скотьего
скотина: скотину скотина скотины
скотовод: скотоводами
скрытый: скрытые
скрыть: скрыть
слабеть: слабела
слабоумный: слабоумных
слабый: слабо
славянин: славян славянам
славяно: славяно
славяноведение: славяноведения
славянский: славянский славянская славянские славянских славянском славянской славянского славянское
слать: шли
след: следам след следы
следовать: следует следовало
следствие: следствие
следующий: следующих
сливаться: сливающегося сливается сливаясь
слияние: слиянием слияние
словарь: словари словарь
словесный: словесный
словник: словник
слово: слов слова словами слово
сложить: сложен сложить
сложиться: сложилось
сложность: сложность
сложный: сложных
слуга: слуг
служба: службу
служебный: служебные
служилый: служило служил
служить: служили служат
случай: случае случаях
случайный: случайная
случиться: случится
слышать: слышать слышат
слышаться: слышатся
смазать: смазать
сманивать: сманивает
смена: сменой смену
смениться: сменилась
смертельный: смертельный
смерть: смертью смерть смерти
смесь: смесь
смех: смех смехом
смешанный: смешанного смешанное
смешивание: смешивание
смешной: смешное смешных
смеяться: смеются
смирнов: смирнов
смола: смолы
смоленский: смоленской
смоленщине: смоленщине
смолкин: смолкин
смородина: смородина
смотреть: смотрит смотреть
смутить: смутить
смысл: смысл
сначала: сначала
снег: снег
снегирев: снегирев
снегурочка: снегурочку снегурочки снегурочка
снежимочка: снежимочка
снежище: снежище
снежный: снежного
снимать: снимают
сниться: снится
сноп: снопы снопов
сноровистый: посноровистей
сносить: сносит
снять: снять
собака: собак собаки собака
собачка: собачка
собеседник: собеседнику
собиратель: собирателями собирателем
собирать: собирали собирать
собираться: собираются собираться
соблазнить: соблазнить
соблюдать: соблюдать
собрат: собратьями
собрать: собраны
собственный: собственные собственных собственно собственным
событие: события событиях
совершать: совершали совершал
совершаться: совершались совершался
совершенно: совершенно
совершить: совершить
советский: советский советская советской
совмещение: совмещение
совпадать: совпадающие
современность: современностью
современный: современном современный современные современных современной современную
согласие: согласия
согласно: согласно
соглашаться: соглашался
согревать: согревающего
содержание: содержание
содержать: содержат
содержаться: содержится
соединять: соединяет
соединяться: соединяются соединяется
создать: создано создан создавший созданы созданном создать
сознание: сознания
соискание: соискание
сойти: сошедший
соколов: соколов
сокращаться: сокращаться
солдат: солдаты солдата
солдатенкова: солдатенкова
солдатчина: солдатчине
соловеть: соловей
соловка: соловки
солома: соломы
соль: солью соль
сома: сом
сомовый: сомова
сон: сон сном сне сны
сонливый: сонлив
сообщение: сообщения
сообщество: сообщество
сообщить: сообщить
сообщник: сообщники
соответствие: соответствии
соответствующий: соответствующие
сопровождать: сопровождает сопровождать
сопряжение: сопряжение
сорок: сорока
сосед: соседа
соседний: соседней
соседствовать: соседствовал
сосна: сосна сосну
сосновый: сосновый
сосредоточить: сосредоточены
сост: сост
состав: состав
составление: составление
состариться: состарится
состояние: состояние состоянии состоянием состояния
сотворение: сотворение
сотня: сотни
сохранение: сохранении сохранения сохранением
сохранять: сохраняет
социальный: социальной
социокультурный: социокультурная
сочить: сочат
спадать: спадают
спартак: спартак
спасать: спасая спасает
спасаться: спасаясь
спасение: спасения
спасти: спасти
спастись: спастись
спать: спящий спящее спать
спбгу: спбгу
спектакль: спектакля
спереди: спереди
специальный: специально
специфика: специфика
спина: спине
сплющить: сплющенное
спорить: спорят
способ: способ способы способов
способность: способности способность
способный: способный способна способен способного
спохватиться: спохватившись
справедливый: справедливым справедливого
справиться: справиться
справка: справка
справлять: справляют
справляться: справляются
спрашивать: спрашивали
спрос: спроса
спросить: спросить
спрятать: спрятать
спутник: спутник
спячка: спячки
сравнение: сравнением
сравниваться: сравниваются
сравнительно: сравнительно
сразу: сразу
среда: среда
среди: среди
средневековый: средневековые
средство: средства средств
срезать: срезать
срезневский: срезневский
срезневского: срезневского
сронилось: сронилось
срочный: срочным
српски: српски
срубить: срубить
срывать: срывающие
ссора: ссора
ссср: ссср
ссылать: ссылают
ссылаться: ссылается
ссылка: ссылка ссылками ссылки
стабильный: стабильная
ставиться: ставилась
стагоддзя: стагоддзя
стадо: стадо стада
сталинский: сталинскую
стан: стан
становиться: становятся становится становился становиться
стараться: старается стараясь
старец: старца
старик: старик старика
старина: старина
старичок: старичка старичком старичок
старое: старым старых
старость: старости
старуха: старуха старухой
старченко: старченко
старший: старший
старый: старой старую стар
стаскивать: стаскивал
статистика: статистика
статус: статусе статус
стать: стал стать став стали станет
статья: ст статей статья статьи
стелька: стельки
степанов: степанов
степанченко: степанченко
степенный: степенным степенный
степень: степени
степь: степях
стер: стер
стиль: стилю
стимулироваться: стимулируется
стих: стихах
стихия: стихией стихий
стихотворение: стихотворениях стихотворение стихотворении стихотворений
стоить: стоит
столетие: столетиями столетия
столкнуться: столкнулся
столь: столь
столько: столько
стопан: стопан
сторожка: сторожку
сторона: стороны сторону
страж: страже стражи
страна: страны стран
страница: страницы страница страницу странице
страсть: страсть
страх: страхом страх страхи страхами
страшный: страшный страшным страшных страшное
стрела: стрела
стрелять: стрелять
стремиться: стремится
стремление: стремление
стрибог: стрибог
стричь: стричь
строгий: строго
строительство: строительства
структура: структура структуры
структурный: структурно
стрыга: стрыга
студенец: студенец
субстанциональный: субстанциональной
судьба: судьбы судьбу судьбе судьба
суеверный: суеверные суеверных
суеверье: суеверий
сулить: суля
сумського: сумського
сундук: сундука
супрунова: супрунова
сусветнай: сусветнай
сутки: сутки суток
сухой: сухих
сучаснасць: сучаснасць
сучасная: сучасная
сучасне: сучасне
сучасных: сучасных
сучок: сучками
существо: существо существ существом существа существе
существование: существовании существованию существования
существовать: существуют существовали существовал существует существующим существующей существовало
сущность: сущности
сфальсифицировать: сфальсифицировать
сфера: сфере сферу сферы
сходить: сходит
сходный: сходный
сходство: сходство
схожий: схожих схожие схожими
считать: считает считали считал считать считала
считаться: считается считалось считались считался
съесть: съела
сырой: сыра
сюда: сюда
сюжет: сюжет сюжеты сюжетов сюжетом сюжета
сюжетный: сюжетно
сюита: сюита
сямженский: сямженского
т: т
табу: табу
таинственный: таинственное
тайга: тайге
тайна: тайне тайну
тайный: тайные тайной
также: также
таки: таки
такой: такой такое таким таком таких такие
таланчук: таланчук
тамбов: тамбов
тамбовский: тамбовского
татарин: татар
тащить: тащить
таять: таять
тварини: тварини
твгу: твгу
тверская: тверской
тверь: тверь
творение: творения
творить: творили
творческий: творческого творческой
творчество: творчестве
театр: театр
театральный: театральном
тезис: тезисы
тейх: тейх
текст: текст тексты текстов текстах текстам текста
текущий: текущие
телевидение: телевидение
телега: телеги телеге телегу
телефильм: телефильмы
тело: теле телу тела тело
тем: тем
тема: темы
тембровый: тембровой
темнота: темнотой
тенденция: тенденции
тенишев: тенишева
тень: тень
теория: теория теории
тереть: три
термин: термина
территория: территория территорией
терять: теряющий теряет
тесно: тесно
тесный: тесное
техник: техники
технический: технической
течение: течение
тиманова: тиманова
тип: типы
типичный: типичная типичного
типограф: типограф
типография: типография
типология: типология
титянин: титянин
ткань: ткань ткани
тлумачення: тлумачення
товариства: товариства
товарищество: товарищество
товарный: товарный
тождество: тождеством
токарев: токарев
толковый: толковый
толстый: толстая толстого толстой
томск: томск
томский: томского
тонконогий: тонконогий
топор: топором топоры
топорков: топорков
топоров: топоров
топосу: топосу
топот: топот
топь: топями
тоска: тоска тоске
тот: том ту тех те тот тому та
тотемический: тотемической тотемического тотемические
тотемный: тотемного тотемным
точка: точке
трава: травы травой траву трава
травкин: травкина
трагический: трагическим
трагичный: трагичную
традиционный: традиционной традиционных традиционным традиционная традиционный
традиция: традициях традицией традиция традиции традиций традициям
трансфармацыя: трансфармацыя
трансформация: трансформация трансформации
трансформировать: трансформированного
требоваться: требовалось
тредиаковского: тредиаковского
треск: треск
трескун: трескун
третий: третьей
третье: третьего
третьяковский: третьяковская третьяковской
трещать: трещать
три: тремя
триглав: триглав
тридевятый: тридевятое
тридцать: тридцать
трижды: трижды
тринадцатый: тринадцатом
трифон: трифон
троп: тропы тропе тропу
трофим: трофим
труба: трубу
труд: труд трудах труды трудов труду
труднодоступный: труднодоступное
труднопроходимый: труднопроходимые
трын: трын
трясина: трясину
туда: туда
тулуп: тулупе
туман: тумана
тундра: тундры
турган: турган
тургенев: тургенева
турупит: турупит
тусклый: тусклые
тэма: тэма
тяготение: тяготение
тяжелый: тяжела
тяжкий: тяжко
тянуть: тянет
тяп: тяп
убегать: убегает убегают
убедительный: убедительными
убежать: убежать
убеждать: убеждает
убеждение: убеждений
убежденный: убеждены
убивать: убивать убивающий
убить: убить убивших
убор: уборы
уважаемый: уважаемый
уважать: уважающим
увеличиваться: увеличиваться
увечить: увечить
увидеть: увиденное увидеть
уводить: уводят
угодник: угодник угодника
уголь: угля
угостить: угостить
угощаться: угощались
угрожать: угрожали угрожая
удар: ударом
удаться: удалось
удача: удачи удачу удача
удельница: удельница
удельницей: удельницей
удержать: удержать
удивление: удивление
удмурт: удмуртов
удмуртский: удмуртского
узда: узды
уйти: уйти
указание: указанием указание
указат: указат
указатель: указатель
указать: указан указать
указывать: указывали указывает указывающие указывающая указывают указывала указывал
указываться: указывается
уклад: уклад
укладанне: укладанне
укладывать: укладывают
укр: укр
украинец: украинцев
украинка: украинки
украинский: украинских украинской украинский
украсть: украсть украл
улетать: улетает
ум: ума умом
уменьшаться: уменьшаться
уменьшение: уменьшением
умерший: умершего умерших умершие
уметь: умеет
умирать: умирает умирающего
умный: умный
уна: ун
университет: университет университета
уничтожать: уничтожающие
уничтожить: уничтоживших
уносить: уносимого
упадок: упадка упадок
упасть: упала упавшие
уподобить: уподоблены
уподобляться: уподобляются
упоминание: упоминание
упоминать: упоминаемое
упоминаться: упоминался упоминается
управлять: управляет
упырь: упырь
ураганный: ураганные
уральский: уральского
уродливый: уродливое уродливых уродливого уродливый
урусов: урусов
усвятский: усвятские
усиление: усиление
усков: усковой ускова
ускользать: ускользающим
условие: условий условии условиях условия
услышать: услышать
усовершенствование: усовершенствования
успешный: успешной
устать: уставший
устный: устной
устроить: устроить
устроиться: устроились
уступный: уступны
усход: усход
утверждать: утверждала утверждающие
утверждаться: утверждается
утратить: утратил
утренний: утренней
утро: утром
ухо: ухо
ухова: ухова
уходить: уходит
участвовать: участвует
участие: участие
участковый: участков
участок: участки
учитывать: учитывая
учить: учит
учиться: учатся
уютный: уютной
уявлення: уявлення
ф: ф
фавн: фавны
фадеев: фадеева
фактор: фактор
факультэта: факультэта
фалькларыстычныя: фалькларыстычныя
фальклор: фальклор
фальклорнай: фальклорнай
фальклору: фальклору
фантазия: фантазия фантазии
фараонки: фараонки
фармер: фармер
февраль: февраль
федеровского: федеровского
федоровский: федоровский
федута: федута
феликс: феликс
феномен: феномене
фет: фета
фетовский: фетовском
фигурировать: фигурирует
фиксировать: фиксирующих
филин: филин
филологический: филологических филологические
филология: филология
философский: философская
фильм: фильме фильмов фильмах фильма фильмы
фирсова: фирсова
фитоантропоморфным: фитоантропоморфным
флинс: флинс
флинт: флинта
фольклор: фольклор фольклора фольклоре
фольклоризме: фольклоризме
фольклористика: фольклористики
фольклорный: фольклорно фольклорная фольклорные фольклорных фольклорной фольклорную
фома: фома
фон: фоне
фонд: фонд
фоп: фоп
форма: форма форме форм
формат: формат
формировать: формирует
формула: формулы
фортепианный: фортепианная
форум: форум
фраза: фразы
фразеология: фразеологии
франк: франка
фундаментальный: фундаментальных
функциональный: функциональные
функционирование: функционирования
функция: функций функции
футбол: футбол
фэнтези: фэнтези
х: х
хабар: хабаров
хаберница: хаберница
хала: хала
хантов: хантов
хаос: хаос
характер: характером характер
характеризовать: характеризующих характеризует
характерный: характерны характерно характерные характерное характерным
харченко: харченко
хасанова: хасанова
хвалить: хвалящий
хватать: хватало
хвойный: хвойных
хворост: хворосте
хворостянник: хворостянник
хвост: хвост хвостом
хеннил: хеннил
херувим: херувим
хитрец: хитреца
хитрость: хитрость
хитрый: хитрый
хищник: хищников
хладнокровный: хладнокровно
хлеб: хлеб хлеба
хлебник: хлебников
хлебникова: хлебникова
хлестать: хлестать
хлопанье: хлопаньем
хлопать: хлопать
хлопок: хлопки
хобзей: хобзей
ходить: ходить ходили ходит
ходьба: ходьбе
ходячий: ходячего
хозяин: хозяин хозяева хозяином хозяину хозяине хозяина
хозяйка: хозяйкой хозяйка
хозяйство: хозяйстве
хомут: хомут
хор: хора
хорив: хорив
хороший: лучше лучшие лучший лучшим
хорошо: хорошо
хоррора: хоррора
хорс: хорс
хохот: хохот хохотом
хохотать: хохочет хохоча хохотать
хохрик: хохрик
храбрый: храбрый храброго
хранитель: хранитель
хранить: хранить
храниться: хранится
христианский: христианских христианские христианский
христианство: христианстве христианства христианство
христосование: христосования
христофорова: христофорова
хромая: хромым
хуберт: хуберту
худенький: худенький
художественный: художественное художественных художественной
художник: художников художника
художньомовний: художньомовний
художня: художня
худой: худой
цар: цар
царевич: царевичу царевич
царевна: царевне царевна
царить: царит цари
царство: царством царстве царство
царь: царь
цвет: цвета цвет цвете
цветок: цветок
цветочек: цветочек
целенаправленный: целенаправленно
целостность: целостностью целостность
целый: целом целый целая
цель: целях целью
ценный: ценнее ценно
центр: центра центр
цивилизация: цивилизации
цивиной: цивиной
цикл: цикл цикла
циклизация: циклизация
циклический: циклическом
цикля: цикле
цитата: цитаты
цитировать: цитировать
цмок: цмок
цмока: цмока
ч: ч
чайковский: чайковского
чаплыгин: чаплыгина
чар: чары чар
чарка: чарки
чародей: чародея чародей
час: час часу
частить: части чащу
частичный: частичной
частка: частка
часто: часто
часы: часы
чачина: чачина
чаща: чаще
чебанюк: чебанюк
чело: челом
человек: человек человеку людьми человека людях людей человеком люди людям
человечек: человечек
человечески: человечески
человеческий: человеческому человеческий человеческого человеческом человеческие человеческих
челябинский: челябинской челябинского
червона: червона
через: через
черепанов: черепанова черепановой
черничный: черничном
чернобог: чернобог
черноглав: черноглав
чернокнижник: чернокнижник
черт: чертями чертей чертям
черта: черт черту чертой черты чертам
чертухинский: чертухинский
чесать: чесать
честный: честной
четверг: четверг
чех: чех
чехов: чехова
чеш: чеш
чиновник: чиновник
число: число числе
чистый: чистый
читатель: читателя
читать: читать
чорт: чорт
чтение: чтения
чтобы: чтобы
чуваш: чувашей
чугайстер: чугайстер
чугайстир: чугайстир
чудесный: чудесном
чудиться: чудится чудятся чудился
чудище: чудище
чудо: чудо чудеса
чудотворец: чудотворцев
чудь: чудь
чужак: чужаков
чужая: чужой чужая
чуждый: чуждая
чужой: чужого
чур: чур
чурай: чурай
чурка: чурку
шаг: шаги
шалак: шалак
шамякина: шамякина
шапка: шапка шапки шапку
шатова: шатова
шевченка: шевченка
шевченко: шевченко
шеин: шеина
шерсть: шерстью шерсть
шерстяной: шерстяной
широкий: широко широкими широкая
шишига: шишига
шишка: шишку шишки
шишкин: шишкин
школа: школа школы
школьный: школьную школьные
шкура: шкуру шкуры
шлемоносцы: шлемоносцы
шляпа: шляпа
штиль: штиль
што: што
шуликуны: шуликуны
шум: шум шумом
шуметь: шумят шуметь шумя шумит
шумный: шумными шумны
шумска: шумска
шурале: шурале
шут: шут шута
шутить: шутят
шутка: шутки
щедро: щедро
щека: щек
щекотать: щекотать
щекотуном: щекотуном
щепанская: щепанская
щепанской: щепанской
э: э
эволюция: эволюции
эвфемизм: эвфемизма
экз: экз
экономика: экономика экономики
экономический: экономическом
экранизация: экранизациях
эксмо: эксмо
электронный: электронный
элемент: элементов элементы элемент
эмигрантский: эмигрантской
эмиграция: эмиграции
эмигрировать: эмигрировать
энлонавты: энлонавты
энцикл: энцикл
энциклопедический: энциклопедический
энциклопедия: энциклопедия энциклопедии
энцыклапедычны: энцыклапедычны
энцыклапедыя: энцыклапедыя
эпик: эпике
эпилепсия: эпилепсию
эпический: эпическими
эпичный: эпичном
эпоха: эпоху эпохе эпохи эпох
эскиз: эскизе эскиз
этикет: этикету
этнографический: этнографическая этнографическое этнографический
этнография: этнография этнографии
этнолингвистический: этнолингвистический
этнология: этнология
этнос: этноса
это: этом это этому этим
этот: этой этих эта
эхо: эхо эху
ю: ю
юган: юган
юда: юда
юдо: юдо
южный: южным южных
юношеский: юношеском
юрий: юрий юрия
ютробог: ютробог
яблоко: яблоко яблоки
явиться: явись
явление: явления явлениях явлениями
являться: являлся является являются являлась
явно: явно
яга: яги ягой яга
ягода: ягоды ягодами ягод
яе: яе
язык: язык языках языка языке
языковой: языковые
языкознание: языкознание
языческий: языческие языческих языческая
язычество: язычества язычество
яйцо: яйцо
як: як
якевича: якевича
якоб: якобы
яковлев: яковлев
якунчиковой: якунчиковой
яма: яму
январь: января январь
янський: янський
яренгских: яренгских
яровит: яровит
ярыни: ярыни
