автомобиль: автомобилей
авторство: авторства
александр: александр
англ: англ
англоязычный: англоязычных
апрель: апреля
арх: арх
архивировать: архивировано
архивный: архивная
бегство: бегства
бедствие: бедствиях бедствий бедствиями
безвозмездный: безвозмездное
беларуская: беларуская
беспорядок: беспорядках
богомол: богомолов
боев: боевых
больший: большая
бомбардировка: бомбардировкам
български: български
бэнкси: бэнкси
вводить: вводящая
ведение: ведения
версия: версия версии
верховный: верховного
вещь: вещей
вид: вид
видео: видео
видеть: вижу
викиданных: викиданных
викимедиа: викимедиа
википедии: википедии
википедия: википедия
викисклад: викисклад
викискладе: викискладе
викисловаре: викисловаре
викисловарь: викисловарь
виновный: виновного виновных
вклад: вклад
включать: включает
вне: вне
военнослужащий: военнослужащих военнослужащим
военный: военного военные военных военное военный
война: войны
войти: вошло войти
волков: волкова
волнение: волнениях
волшебный: волшебные
время: время
вступить: вступила
вынудить: вынужденной
г: г
гл: гл
глоссарий: глоссарий
год: году лет года
горкин: горкин
грабить: грабить
гражданский: гражданских гражданского
граффити: граффити
дата: дата
движение: движения
действие: действия действий
действовать: действующих действовать
десять: десяти
дмитрий: дмитрий
дополнение: дополнениями
дополнительный: дополнительные
доступный: доступен
другой: другие других
жертва: жертв
житель: жителями жителей
журн: журн
забросить: заброшенных
зависимость: зависимости
заглавный: заглавная
закон: законы закон
законодательство: законодательстве
запись: запись
запрос: запрос
зарегистрировать: зарегистрированный
заявление: заявление
здание: зданий
землетрясение: землетрясения
знак: знак
значение: значения
значительно: значительно
избранный: избранные
изменение: изменениями
изображать: изображающие
изъятие: изъятие
имущество: имущества
инструмент: инструменты
интернет: интернет
интерпретировать: интерпретируют
информация: информации
использование: использования
использовать: использовать использующие используют
история: история
источник: источник
июнь: июня
казнь: казнью казнь
калифорний: калифорнии
карцев: карцев
катастрофа: катастрофы катастрофах
категория: категории
квалифицировать: квалифицируют
классик: классик
классифицироваться: классифицировались
код: код
кодекс: кодекс
конфиденциальность: конфиденциальности
конфликт: конфликта
копия: копия
короткий: короткий
корыстный: корыстной
кража: кража
кук: куки
кыргызча: кыргызча
либо: либо
лицензия: лицензии
лицо: лицах лиц
лишение: лишением лишения
лутерами: лутерами
лутеры: лутеры
лутинг: лутинг
лутинга: лутинга
максимально: максимально
мародер: мародеров мародер
мародерство: мародерство
марта: марта
материал: материал
медиафайлы: медиафайлы
медуза: медуза
международный: международным международном международного
мирный: мирное
много: более
мобильный: мобильная
москва: москва
мочь: могут
мы: нами
навигация: навигации навигация
называть: называют
называться: называлось
наказание: наказание
наказываться: наказывается
население: населения
наталья: наталья
находиться: находящихся находящегося
начаться: началось
негодяй: негодяй
некоммерческий: некоммерческой
необходимость: необходимостью
неопр: неопр
неприятельский: неприятельской
несколько: нескольких
несчастная: несчастных
новость: новостях
новый: новые
ноябрь: ноября
нтв: нтв
об: об
обозначение: обозначения
оборот: оборот
обращение: обращение обращения
обстоятельство: обстоятельств
обстрел: обстрелам
обсуждение: обсуждение
общий: общие
обычный: обычных
ограбление: ограбления ограбление
однако: однако
оказаться: оказалось
октябрь: октября
описание: описание
опытный: опытными
организация: организации
оставить: оставленного
ответственность: ответственности
отдельный: отдельный отдельных
отказ: отказ
открыть: открытое
отличаться: отличаться отличаются
отношение: отношении
отредактировать: отредактирована
отягчать: отягчающих
официальный: официальный
ошибка: ошибке
п: п
перейти: перейти
перенаправить: перенаправлено
перенаправляться: перенаправляется
переть: при
период: период
персональный: персональные
печать: печати
пиллаж: пиллаж
пленум: пленум
поведение: поведения
повсеместный: повсеместный
подвергнуть: подвергнутых
подобный: подобных
подробный: подробнее
пожертвовать: пожертвовать
поиск: поиск поиску
пока: пока
пол: поле
политик: политика
политический: политические
положение: положения
получить: получить
польза: пользу
понимать: понимающая
пониматься: понимается
понятие: понятие
поправка: поправка
портал: портал
последний: последнее последний
посол: после
постоянный: постоянная
потоп: потопа
похищение: похищение
править: править
правка: правка правки
право: праве
правовой: правовой
правомерность: правомерность
правопорядок: правопорядка
правый: правом
практика: практикой
представиться: представились
предусматривать: предусматривающая предусматривал
преступление: преступлений преступление преступления
применять: применять
применяться: применяться
примечание: примечания
проверить: проверенной
проверка: проверки
проверяться: проверялась
проект: проектах
просмотр: просмотры
пространство: пространства
против: против
противоправный: противоправные
профессия: профессия
работа: работы
разбой: разбой
разграбление: разграбление
разный: разные разному
разработчик: разработчики
район: районах
раненый: раненых
рассматриваться: рассматривается
редакция: ред
результат: результате
рекомендовать: рекомендовал
рипол: рипол
родственный: родственных
российский: российская российской
россия: россии
рсфср: рсфср
русский: русский
русскоязычный: русскоязычных
русый: рус
рф: рф
сантиметр: см
сведение: сведения
свежий: свежие
свобода: свободы
свободный: свободной
связанный: связанные
связаться: свяжитесь
связь: связи
сегодня: сегодня
сентябрь: сентября
сила: силу
система: системе
ситуация: ситуации
скачать: скачать
скрытый: скрытые
словарь: словарь
слово: слова слово
служба: служб
служебный: служебные
случай: случаях случаев
случайный: случайная
смертный: смертной смертную
сми: сми
смысл: смысле
событие: события
содержание: содержание
создать: создать
сообщество: сообщество
сообщить: сообщить
сотрудник: сотрудников
сохранение: сохранением
спитакский: спитакского
справка: справка
ср: ср
сражение: сражения
среди: среди
срок: срок
српски: српски
српскохрватски: српскохрватски
ссср: ссср
ссылка: ссылка ссылками ссылки
статистика: статистика
стать: стала стали
статья: статью статья статье статьи
стихийный: стихийными стихийных
страна: странах
страница: страницы страница страницу странице
строгий: строгом строго
судно: суда
судья: судьям
сша: сша
сюда: сюда
т: т
тайный: тайное
также: также
такой: такое таких такие
текст: текст
текущий: текущие текущая
термин: термин
территория: территории
техногенный: техногенных
товарный: товарный
тот: том
требовать: требует
три: трех
тридцатилетний: тридцатилетней
убить: убитых
уголовный: уголовное уголовном уголовный
угроза: угроза
ук: ук
указание: указанием
условие: условий условиях условия
утратить: утратил
участие: участие
участник: участниками
февраль: февраля
федеральный: федеральный
федерация: федерации
фз: фз
фонд: фонд
форум: форум
фр: фр
франц: франц
характер: характера
хищение: хищение хищений хищениях
цель: целью
цитировать: цитировать
частность: частности
чаща: чаще
человек: людей
число: числе
читать: читать
чрезвычайный: чрезвычайной
чужой: чужого
широкий: широко широком
штат: штатов
эвакуация: эвакуации
экз: экз
экстренный: экстренных
элемент: элемент
энциклопедический: энциклопедический
энциклопедия: энциклопедия энциклопедии
этимология: этимология
это: это
этот: эта
язык: языках
