авторство: авторства
алфавит: алфавиту
англ: англ
английский: английской английские
архивировать: архивировано
баг: баг
бить: бьет
боггарт: боггарт
боггарта: боггарта
боггарту: боггарту
богл: богл
боглеман: боглеман
больший: больше
боуги: боуги
боугимен: боугимен
бояться: боится
брауни: брауни
бук: бука
вд: вд
версия: версия версии
веселый: веселее
вика: вики
викиданных: викиданных
викимедиа: викимедиа
википедии: википедии
википедия: википедия
вклад: вклад
вместе: вместе
внешний: внешние
войти: войти
волшебный: волшебные
все: всего
высмеять: высмеять
г: г
гарри: гарри
германий: германии
германский: германской
год: году года
дата: дата
действовать: действовать
дженни: дженни
джоан: джоан
диалект: диалекта
дом: дому
дома: дома
домашний: домашний
домовой: домовой
дополнительный: дополнительные
допустить: допустим
доступный: доступен
другой: других
дружелюбный: дружелюбно
дух: дух духи
единственный: единственный
заглавный: заглавная
заклинание: заклинанием
закоулок: закоулках
запись: запись
зарегистрировать: зарегистрированный
зарисовка: зарисовка
заявление: заявление
злой: злые
знак: знак
знать: знает
значительно: значительно
избавиться: избавиться
избранный: избранные
известный: известны
имя: именем
иногда: иногда
иной: иных
инструмент: инструменты
использование: использования
использовать: использующие
история: история
источник: источник
июнь: июня
карандашный: карандашная
карточка: карточки
категория: категории
книга: книгах
код: код
кодекс: кодекс
конфиденциальность: конфиденциальности
короткий: короткий
который: которого
красть: крадет
кровать: кроватью
кроме: кроме
кто: кого
кук: куки
культура: культурах
легкий: легче
литература: литература
лицензия: лицензии
любить: любят
марта: марта
материал: материал
мир: мире
мифический: мифические
мифологический: мифологические
мифология: мифологии мифология
мобильный: мобильная
можно: можно
мочь: могут
мы: нами
навигация: навигации навигация
называть: называли
напольный: напольных
настоящее: настоящими
настроить: настроен
находиться: находится
некоммерческий: некоммерческой
низкий: низшей
новый: новые
нортгемптоншира: нортгемптоншира
ночь: ночью
об: об
обитатель: обитателями
обитать: обитают
образ: образ
обращение: обращения
обсуждение: обсуждение
объект: объект
обычно: обычно
однако: однако
они: них
описание: описание описании
опытный: опытными
организация: организации
основать: основанная
основное: основном
ответственность: ответственности
отвязывать: отвязывает
отдельный: отдельных
отказ: отказ
отличаться: отличаться отличается
отредактировать: отредактирована
отчаиваться: отчаивается
ошибка: ошибке
параметр: параметров
переехать: переехать
перейти: перейти
персонаж: персонажи
персональный: персональные
печать: печати
пища: пищу
поведение: поведения
подобный: подобные
подпись: подписи
подробный: подробнее
пожертвовать: пожертвовать
поиск: поиск поиску
пока: пока
показываться: показываются
политик: политика
получить: получить
поскольку: поскольку
последний: последняя последний
постоянный: постоянная
посуда: посуду
поттер: поттер поттера поттере
править: править
правка: правок правка правки
превращаться: превращаться
предмет: предмет
представиться: представились
представлять: представляет
привидение: привидение привидения привидений
привязать: привязаны
примечание: примечания
про: про
проверить: проверенной
проверка: проверки
проверяться: проверялась
проделка: проделки
проект: проектах
просмотр: просмотры
пространство: пространства
прочий: прочих
прошлый: прошлом
пугать: пугать
пустой: пуст
разработчик: разработчики
расширение: расширение
ридикулус: ридикулус
роулинг: роулинг
русская: русской
русский: русский
русый: рус
сантиметр: см
сведение: сведения
свежий: свежие
свободный: свободной
своеобразный: своеобразный
связанный: связанные
связаться: свяжитесь
себя: собой
семья: семья
система: системе
скачать: скачать
скот: скот
скрытый: скрытые
служебный: служебные
случай: случае случаях
случайный: случайная
случаться: случается
событие: события
содержание: содержание
создать: создать
сообщество: сообщество
сообщить: сообщить
сохранение: сохранением
способ: способ
способный: способен
справка: справка
спутать: спутать
ссылка: ссылка ссылками ссылки
статистика: статистика
статья: статья статьи
страница: страницы страница страницу странице
существо: существо существа
сша: сша
сюда: сюда
т: т
также: также
текст: текст
текущий: текущие текущая
тем: тем
темнота: темноту
товарный: товарный
трактовка: трактовке
требовать: требуют
труд: труд
указание: указанием
уметь: умеет
умывальник: умывальником
условие: условий условия
участие: участие
участник: участниками
февраль: февраля
фольклор: фольклора
фонд: фонд
форум: форум
футляр: футляре
хозяин: хозяевам
цитировать: цитировать
частично: частично
часы: часов
человек: человек
читать: читать
чудовище: чудовищами
шаблон: шаблон
шкаф: шкафу шкафах
шотландия: шотландии
штернберга: штернберга
элемент: элементы элемент
энциклопедия: энциклопедии
это: этом
этот: эта
эттин: эттин
язык: языках
ящик: ящике
