абердинского: абердинского
аболиционист: аболиционистом
абсолютно: абсолютно
аванс: аванса
август: августа августе
автобиография: автобиографии
автограф: автограф
автомобиль: автомобиль
автор: автора автор авторе автором авторов
авторитетный: авторитетной
авторство: авторство авторства авторстве
агент: агентов агент агентом
агентство: агентство агентством
адаптация: адаптации
адвокат: адвокатов
адрес: адрес адресу
азкабана: азкабана
академический: академической
аккаунт: аккаунте
активистка: активистка
активно: активно
актриса: актриса
акцентировать: акцентировали
алан: алану аланом
алекс: алекс
александр: александром
алексей: алексея
алисе: алисе
алфавит: алфавиту
альберт: альбертом
альбус: альбус
альбуса: альбуса
альфонсо: альфонсо
альфред: альфред
амер: амер
америка: америке
американский: американской американского
амнистия: амнистии
анализ: анализ
аналитический: аналитического
англ: англ
английский: английский английские английском
англия: англия
андре: андре
анестезиолог: анестезиолога
анонсировать: анонсировала
антитрансгендерные: антитрансгендерные
антология: антологии
апелляция: апелляцию
апрель: апреле апреля
арантиш: арантиш
арантишем: арантишем
арброт: арброт
арран: арран
архив: архив
архивировать: архивированная архивировано
архивный: архивная
астурийского: астурийского
астурийской: астурийской
аткинсон: аткинсон
аудио: аудио
аудитория: аудитория
аукцион: аукциона аукционе аукцион
бабушка: бабушка бабушки
бакалавр: бакалавра
бар: баре
барда: барда
барри: барри
барроном: барроном
бедность: бедности бедностью
бедный: бедной
бежать: бегущая
бездомный: бездомной
безопасность: безопасности
безосновательный: безосновательным
беларуская: беларуская
белизна: белизна
белые: белым
беовульфа: беовульфа
беречь: берегу
бесплатно: бесплатно
беспокойство: беспокойство
беспрецедентный: беспрецедентный
бестселлер: бестселлером
би: би
библиографический: библиографических
библиография: библиография
библиотека: библиотеки библиотек
бидля: бидля
билет: билетов
биограф: биографы
биография: биография биографии
бирюзовый: бирюзовый
благой: благо
благополучие: благополучие
благотворительность: благотворительность
благотворительный: благотворительной благотворительных благотворительная благотворительный благотворительным
блогер: блогер
блэке: блэке
блэкфейс: блэкфейс
блэр: блэр блэром
богатый: богатейшей богатых богатейших
боль: боль
больница: больнице
больной: больна
больший: большим большая большие больших больше
большинство: большинство
большой: большой наибольшее
бонни: бонни
борьба: борьбе борьбу борьба
брайони: брайони
брак: брак браке
браун: браун брауна
бренд: бренд
бриджет: бриджет
бристоль: бристоля
британия: британии
британский: британских британские британскими британская британской британский британским
бритый: брит
бродвейский: бродвейском
брукс: брукс
бруксу: бруксу
брэй: брэй
будущее: будущим будущем
будущий: будущий будущей
бумага: бумаге
бумажный: бумажном
бухарест: бухарест
български: български
бык: быков
быстро: быстро
быть: будут бывшей будучи бывший бывшая были
бюст: бюсте
вайдин: вайдин
вакансия: вакансию вакансия
вальда: вальда
введение: введения введение
вдохновение: вдохновение
вдохновить: вдохновил
веб: веб
век: века
великобритания: великобритания великобритании
вернуть: вернула вернуть
вернуться: вернувшись вернулся
версия: версия версии
вест: вест
вести: ведущих
весь: вся
вето: вето
вечер: вечерам вечер
взволновывала: взволновывала
взгляд: взгляды
взрослый: взрослых взрослого
взять: взяла
вид: виде
видео: видео
видимо: видимо
викиданных: викиданных
викимедиа: викимедиа
викиновости: викиновости
википедии: википедии
википедия: википедия
викисклад: викисклад
викискладе: викискладе
викитеку: викитеку
викицитатник: викицитатник
викицитатнике: викицитатнике
винтербурн: винтербурн
вклад: вклад
включать: включает
включить: включил включившее
вкус: вкусов
владеть: владеет
владимир: владимиру владимир
власть: власти
влияние: влияние
влиятельность: влиятельности
влиятельный: влиятельной
вместе: вместе
вместо: вместо
внешний: внешние
внимание: внимание
вновь: вновь
вовлечь: вовлечена
военный: военным военной
возвращаться: возвращалась
возвращение: возвращение
возглавить: возглавила
возглавлять: возглавляет
возмещение: возмещение
возможно: возможно
возможность: возможности возможность
возникать: возникали
возразить: возразила
возраст: возраста возрасте
война: войны
войти: вошла войти
вокзал: вокзале
волан: волан
волос: волосами
волшебник: волшебник
волшебный: волшебные волшебный
волшебство: волшебства
вообще: вообще
вопрос: вопрос
ворот: ворот
восток: востоку
восторженный: восторженного
восьмилетней: восьмилетней
восьмой: восьмой восьмая
впервые: впервые
впоследствии: впоследствии
враждебный: враждебную
врач: врачи
временить: времени
время: время
вручать: вручающей
все: всему всех всего
всезнайка: всезнайки
вселенная: вселенной
вскоре: вскоре
вспоминать: вспоминала вспоминал
вступительный: вступительные
вторжение: вторжения вторжению вторжение
второе: второе
второй: вторая второй
выбор: выборе выбором
выбрать: выбрала
выглядеть: выглядела
выгнать: выгнал
выговор: выговор
выдаваться: выдающийся
вызвать: вызвали
вызывать: вызывающие
выиграть: выиграл выиграло
выйти: вышла вышел выйдет
выкидыш: выкидыш
выкладываться: выкладывается
вымыслить: вымышленном
выпуск: выпуска выпуском
выпускать: выпускает
выпускник: выпускники
выпустить: выпустив выпустила выпущен выпущена
выражать: выражать
вырасти: выросли
выручить: вырученные
высасывать: высасывающих
высказать: высказала
высказаться: высказалась высказались
высказывание: высказываниях высказывания
высказывать: высказывали
высказываться: высказывались
высокий: высоких высокий
высокооплачиваемый: высокооплачиваемых
выступить: выступила выступит выступивших
выступление: выступлений
выход: выхода
вэл: вэл
газета: газеты газета
галерея: галерея
гарвардский: гарвардского
гарри: гарри
гвенффреви: гвенффреви
гейст: гейст
гелбрейт: гелбрейт
гендерно: гендерно
гендерный: гендерная
генеалогия: генеалогия
георгианским: георгианским
гермиона: гермиона
героизм: героизме
героиня: героиней
гигантский: гигантская
гиллиам: гиллиам
глаад: глаад
глава: главу главе глав главами главы глава
главенствовать: главенствовал
главный: главную
глаз: глаза
глобальный: глобальный глобальном
глостершир: глостершир
глостершире: глостершире
глубокий: глубокое
глупый: глупа
го: го
говорить: говорит говорил говорила
год: году лет год годы года
голова: голову
голос: голоса
голосовой: голосовое
гольденберг: гольденберг
гонорар: гонорары
гор: гором
горазд: гораздо
гордиться: горжусь
гордон: гордона гордон
город: города
горячо: горячо
госсажа: госсажа
госсажу: госсажу
гостиничный: гостиничном
гражданский: гражданской гражданское
гражданство: гражданство
граница: границ
грант: грант
графство: графстве
грейнджер: грейнджер
грин: грин
гринспеном: гринспеном
гринт: гринт
группа: группой группы
гэлбрейт: гэлбрейт
гэлбрейта: гэлбрейта
д: д
давать: давала
дальнейший: дальнейшей
дамблдор: дамблдор
дамблдора: дамблдора
данна: данн
дар: даров дарах дары
дата: дата
датский: датская
дать: дала данного дал дать
два: два две двух
двенадцать: двенадцать
двоюродный: двоюродная
де: де
дебют: дебют дебютом
дебютный: дебютный дебютным
девочка: девочки девочек
девять: девяти девять
дед: дед
действие: действие
действительно: действительно
действовать: действовать
декабрь: декабря декабре
делать: делать делающей делала делаю
делий: делию
делиться: делиться
дело: делу деле делах
дементоров: дементоров
день: дней дня
деньга: деньги
деньги: денег
депрессия: депрессией
депутат: депутат
деревня: деревни деревне деревню
десять: десяти
деталь: детали
детектив: детектив детективов
детективный: детективный
детская: детские детских детскую детской детская
детский: детский
детство: детство
деть: день
деятель: деятелей
деятельность: деятельности деятельность
дж: дж
джеймс: джеймсе джеймса
джейн: джейн
джек: джеком
дженнифер: дженнифер
джессика: джессики джессика джессику
джин: джина джин
джинсовый: джинсовой
джо: джо
джоан: джоан
джон: джоном
джонс: джонс
джуд: джуд
диана: диана
диккенс: диккенса
дилетант: дилетант
дилогия: дилогия
директор: директор директора
дитя: дитя
дневной: дневную
дно: дно
добиться: добилось добиться
доверие: доверие
довольный: довольно
док: док
доктор: доктора
документальный: документальном
должен: должны
должное: должное
должность: должность
доллар: долларов
долларовый: долларовым
дом: дом домом доме
дома: дома
домашний: домашнего домашнему домашняя домашнее
домыть: домой
дополнение: дополнения
дополнительный: дополнительной дополнительные
дорогой: дорогой
доска: доска
доставить: доставила
доставлять: доставляло
достижение: достижения
достояние: достоянием
доступный: доступен
доход: доходом доход доходов доходы
дочь: дочь дочери дочерью
драко: драко
драматург: драматургом
древность: древности
друг: друзья друг друзей друга
другой: другим другой другими другие других
дугалд: дугалд
думать: думаю думала
дурмстранг: дурмстранг
дурной: дурная
душ: душу
дэвид: дэвидом дэвид
дэниел: дэниел
е: е
европарламента: европарламента
европейский: европейских
единственный: единственной
ежедневно: ежедневно
ехать: ехала
жажда: жажду
жанр: жанр
желание: желании
жена: жены жена
женский: женские
женщина: женщиной женщин
жертва: жертвой
жестокий: жестокие
живить: живя
живой: живой жива
жизнь: жизни жизнь
жила: жила
жорж: жоржи
журнал: журнал журналов журнала
журналист: журналисты
заболеваемость: заболеваемости
заболевание: заболеванием
заболеть: заболела заболел
забыть: забыла
завершение: завершение завершения
заглавный: заглавная
задержать: задержали
задержка: задержки
задумываться: задумывалась
зайвый: зайвый
заключительный: заключительная
закон: законом
закончить: законченной закончила
закрытый: закрытая
зало: зала
замедлить: замедлила
заменить: заменить
заметить: заметила заметить
заметка: заметки
заметный: заметным
замуж: замуж
заниматься: занимаются заниматься
запад: западе
западный: западными западном
записать: записала
запись: запись
заполнить: заполнить
запрещать: запрещающего
запрос: запрос
запуск: запуска
заработать: заработала заработать
заработок: заработок
зарегистрировать: зарегистрированный
зарождение: зарождение
заслуга: заслуги
застенчивый: застенчива
засыпать: засыпала
затем: затем
зафиксировать: зафиксировать
захотеть: захотят захотеть
защита: защите защиту
защитить: защищено
заявить: заявив заявили заявил заявила
заявление: заявление
зверь: звери
зима: зимы
зло: зла
знак: знак
знакомый: знакомых
знаменитость: знаменитость знаменитостей
знание: знаний
знать: знали знал знала знаю
значение: значения
значительный: значительную
значить: значила
зов: зов зова
зрение: зрения
зять: зятю
ивенса: ивенса
игра: игра игр игры
идентичность: идентичность
идея: идеи идея
изабель: изабель
избавление: избавление
избранный: избранные
известие: известия
известно: известно
известный: известные известный известными известная
извинение: извинения
издание: издание издании
издатель: издатели издатель издателя
издательство: издательству издательство издательства издательств
издать: издать
издержка: издержек
изменение: изменении
изображение: изображениями
изучать: изучала
икабог: икабог
илверморни: илверморни
иллюстрация: иллюстраций
иллюстрировать: иллюстрированных
именно: именно
иметь: имеют имеет
империя: империи
имя: именем имя имени
индий: индия
инженер: инженера
инициал: инициала инициал
иногда: иногда
иностранный: иностранные
инструмент: инструменты
интеллектуал: интеллектуалами
интервью: интервью
интерес: интерес
интересно: интересно
информация: информация информацию информацией информации
ирвингом: ирвингом
исключительный: исключительную
исполнение: исполнении
исполнитель: исполнителям
исполнительный: исполнительный исполнительным
исполниться: исполнилось
использование: использованию использования
использовать: использовала использовать использующие
использоваться: используется
испытывать: испытывает
исследование: исследованиями исследования
исследовательница: исследовательница
исследовательский: исследовательскую исследовательском
история: историю история истории
источник: источники источниками источник
исчезновение: исчезновение
исчезнуть: исчезла
иэн: иэн
иэном: иэном
июль: июля июле
июнь: июня июне июнь
й: й
йейт: йейт
йейте: йейте
йейтс: йейтс
йейтсом: йейтсом
йорк: йорке
кавалер: кавалер кавалеров кавалеры
какой: какие какую
калифорнийский: калифорнийском
каллегари: каллегари
каменный: каменное
камень: камень камня
камео: камео
кампания: кампании
канадский: канадская канадских
каннингем: каннингем
каннингема: каннингема
карикатура: карикатура
карточный: карточная
карьер: карьера
касательно: касательно
каспаров: каспаров
кассовый: кассовому кассовых
каталанский: каталанская
каталог: каталогах
катание: катании
категория: категории
кауфман: кауфман
каф: кафе
качество: качестве
квартира: квартиры квартире квартиру
квиддич: квиддич
квиддичу: квиддичу
кейт: кейт
кеннеди: кеннеди
кеннилуорти: кеннилуорти
кенсингтон: кенсингтоне
километр: километрах
кинг: кингом
кингс: кингс
кино: кино
киноискусство: киноискусство
кинопоиск: кинопоиск
кинопродюсер: кинопродюсер кинопродюсеры
киносценарий: киносценарии
кинросс: кинросс
класс: классе
классический: классической
клетка: клеток
клиника: клинике клинику
клинический: клинической
кловис: кловис
кловиса: кловиса
кловисом: кловисом
клуб: клуб
клубника: клубникой
книга: книгами книг книгах книги книгу книгой книгам книге книга
книжный: книжный книжном книжных
код: код кода
кодекс: кодекс
коламбус: коламбус
коламбуса: коламбуса
количество: количестве
коллекционный: коллекционная
колтрейну: колтрейну
комментарий: комментарии комментариев
комната: комнате комната комнаты
компания: компания
компаньон: компаньон
компетентный: компетентную
компьютер: компьютеров
конец: конце
конкурс: конкурсе конкурс конкурса
конструктор: конструктор
конт: конт
контракт: контракт
контроль: контроль
конфиденциальность: конфиденциальности
конфликт: конфликта конфликт
концепция: концепции
концерт: концерт
копия: копия
копье: копий
кормило: кормила
корморан: корморан
корморане: корморане
королевский: королевского
короткий: короткие короткое короткий
корь: корью
коста: коста
который: которое которому которыми которой которую которого которые которых которая котором который
коттедж: коттедж
крест: крестом
кризис: кризис кризиса
криминальный: криминальные криминального криминальный
крис: крис криса
кристофер: кристофером
критик: критиков
критика: критике критику критикой
критиковать: критиковать
критичный: критичных критичного
кровать: кроватей
кровь: кровь
кролик: кроликов кролике кролик
кроличий: кроличью
кроме: кроме
кросс: кросс
круг: кругу
круглосуточный: круглосуточной
кругосвет: кругосвет
кто: кого кому
куарона: куарона
куароном: куароном
кубок: кубка кубок
кук: куки
кукушка: кукушки
кулинарный: кулинарных
культ: культа
культура: культуре культуры культура культуру культурой
курсель: курсель
куртка: куртке
кыргызча: кыргызча
кэмпбелл: кэмпбелл
кэрри: кэрри
кэти: кэти
кэтлин: кэтлин
л: л
лаборатория: лабораторию лаборатория
ламлаш: ламлаш
лауреат: лауреаты
ле: ле
легион: легиона
лентапедия: лентапедия
летие: летия
летний: летнем летних
лечение: лечение лечения
либо: либо
лили: лили
лингвистический: лингвистический
линия: линии
лист: листе
литератор: литераторы
литература: литературы литература литературе
литературный: литературных литературным
литовский: литовская
литтлом: литтлом
лицензия: лицензии
личной: личном личных
лишать: лишает
лишение: лишениях
локация: локации
лондон: лондоне лондон
лондонский: лондонском лондонского
лоренса: лоренса
лужайка: лужайке
луи: луи
льюнг: льюнг
любить: люблю любимая любимой любила
м: м
магазин: магазине магазинов магазинах
магдалена: магдален
магия: магия магии
маглы: маглы
майк: майком
майкл: майкл майкла
макдермид: макдермид
македонский: македонски
макканн: макканн
маккензи: маккензи
макколлом: макколлом
маленький: мало
малфой: малфой
мальчик: мальчике мальчик мальчиков
манделой: манделой
манчестер: манчестер манчестера
марта: марта марте
мартин: мартин
масштаб: масштабе
материал: материал материалы
материнский: материнской
мать: мать матерью матери
машинка: машинка машинке
мая: мае маи мая
медиафайлы: медиафайлы
медицина: медицины
медицинский: медицинской
международный: международной
менструировать: менструирующие
мера: мере
мероприятие: мероприятия
местный: местных
место: место местах места местом месте
месяц: месяцев месяца
миллиард: млрд
миллиардер: миллиардер миллиардером миллиардера миллиардеры
миллион: миллионов миллиона млн
министерство: министерство
министр: министром
минь: мини
мир: мира миру мир мире
мировой: мировой
мисгендеринг: мисгендеринг
миссис: миссис
митфорд: митфорд
михаил: михаила
младший: младшая
мнение: мнению
многие: многими многих
многий: многом
много: более много
многочисленный: многочисленных
мобильный: мобильная
могила: могила
мозг: мозгу
мой: моих моему мой моей моим мою моя
молодая: молодой
молодежь: молодежи
молодость: молодости
момент: момент
монгол: монгол
монолог: монолог
монтгомери: монтгомери
монти: монти
мор: мор
моральный: моральное моральную
морт: морт
морта: морта
мотив: мотивами
мочь: мог могут могу
муж: мужем муж
мужчина: мужчин
музыкальный: музыкальных
мультимиллионер: мультимиллионера
мультсериал: мультсериал
мур: муру
мы: нами
мыслить: мысли
мысль: мыслей
мьюзик: мьюзик
мэдлин: мэдлин
мюррей: мюррея мюррей
н: н
навальный: навального
наверное: наверное
навигация: навигации навигация
награда: награду наград награды
над: над
надеть: надела
надувной: надувного
название: названия названием названии название
названый: названа
назвать: назвал
назойливый: назойливых
называть: называет называл называла
называться: называется
наиболее: наиболее
найт: найт
найти: найти
накладывать: накладывала
наконец: наконец
налоговый: налогов
наложить: наложило
намерен: намерена
напарница: напарницу
напечатать: напечатал
написание: написании написание написания
написать: написавшей написал написан написана написала написать написанную
наполовину: наполовину
направить: направить направлены
направлять: направлять
направляться: направлявшемся
нарратив: нарратив
нарушение: нарушение
наряд: наряду
население: население
насилие: насилию насилия насилие
насколько: насколько
настолько: настолько
настоящее: настоящее
наука: науки
научный: научно научной
нахлынуть: нахлынули
находиться: находясь находилась
национальный: национального национальная
начало: начале начал начала
начальный: начальной начальным
начать: начав
начаться: началась начался
начинаться: начинается
наш: наших
небинарных: небинарных
небольшой: небольшие
неврология: неврологии
недалекий: недалеко
неделя: недели
недовольный: недовольна
недостоверный: недостоверный
нежели: нежели
неизвестно: неизвестно
неизвестный: неизвестным
некий: некой
некоммерческий: некоммерческой
некоторые: некоторые
некрополистика: некрополистика
нельсон: нельсоном
немедленно: немедленно
немецкий: немецкий
ненавидеть: ненавидимого
ненавистнический: ненавистнических
ненависть: ненависти
необходимо: необходимо
необходимость: необходимости
неоднократно: неоднократно
неожиданный: неожиданное
неопр: неопр
неотапливаемый: неотапливаемую
неполный: неполным неполный
непрерывно: непрерывно
неравенство: неравенством
нераспознанный: нераспознанным
несколько: несколько
неспособность: неспособность
несущественный: несущественного
неудача: неудача неудачу
неудачница: неудачницей
никакой: никакой
никогда: никогда
николсон: николсон
никто: никто
нил: нил нилом нила
новость: новости
новый: нового новым новый новом новую новой новые новых новое
номер: номере
номинация: номинации номинациях
нона: нон
нора: нору
норвежский: норвежская
норрис: норрис
нортон: нортон
ночь: ночи
ноябрь: ноября ноябрь ноябре
нравиться: нравится
нужно: нужно
нью: нью
ньюте: ньюте
ньютон: ньютон
ньюэллом: ньюэллом
об: об
оба: обеих обе оба
обвинение: обвинения
обитание: обитания
обитать: обитают
область: области
обнаружить: обнаружив обнаружила
обожать: обожала
обозреватель: обозреватель
образование: образования образование
образовательный: образовательный
обращение: обращении обращения обращению
обсуждать: обсуждать
обсуждение: обсуждение
общаться: общалась
общественность: общественности
общество: общества
общий: общего общим
объект: объектах
объективный: объективные
объявить: объявила объявило объявлено
объявление: объявление
обязать: обязана
обязывать: обязующего
огонь: огня
огромный: огромному
один: одну одной одна одном одного один одним
одиннадцатилетней: одиннадцатилетней
одиночка: одиночкой
однако: однако
одновременно: одновременно
ожидание: ожидания
ожидать: ожидать ожидаем
озвучки: озвучки
означать: означала
оказать: оказавшую
оказаться: оказалась
около: около
окончание: окончания
окончить: окончила
оксфордский: оксфордский
октябрь: октября октябре
оливья: оливье
олимпийский: олимпийских
он: нему
они: них
онлайн: онлайн
опасаться: опасается
опасный: опасных
описание: описания описание
описать: описал описала
описывать: описывает описывала
описываться: описывается
оправдывать: оправдывать
опре: опре
опровергнуть: опровергла
опубликовать: опубликовано опубликованы опубликованной опубликовать опубликовала опубликован опубликована опубликовал
организация: организациям организации организация
орден: ордена орден
ордер: ордер
оригинал: оригинала
оригинальный: оригинальный
ориентировать: ориентированную
освещение: освещении освещение
освободиться: освободилась
освобождение: освобождение
осень: осенью
оскорбительный: оскорбительную
оскорбление: оскорбление
осмысленно: осмысленно
основа: основой
основать: основанное основанной основали основана
основной: основных основной основная
особенно: особенно
оставить: оставив
остаться: оставшиеся остались
остин: остин
остров: острове
осудить: осудила
осуществить: осуществлена
отвергнуть: отвергли
ответ: ответами ответ ответе
ответить: ответила ответив
ответственность: ответственности ответственность
отвечать: отвечала
отдать: отдала
отдел: отделе
отделение: отделениями
отдельный: отдельных отдельные
отец: отцом отец отце
отзыв: отзывы отзыва
отказ: отказ
отказаться: отказались отказалась
открытие: открытия
открыть: открытое
откуда: откуда
отличаться: отличаться
отличный: отличные
отмена: отмены
отметить: отметили отметив отметила
отметка: отметка
отношение: отношения
отозвать: отозвала
отопление: отопления
отправить: отправит отправил отправлена
отправиться: отправилась
отредактировать: отредактирована
отрицать: отрицала
отряд: отряд
отцовский: отцовской
отчаяние: отчаянии
офицер: офицер офицеры
официально: официально
официальный: официальный официального
охрана: охраной
оценивать: оцениваемый
оценить: оценил оценить
оценка: оценки
очень: очень
очередь: очередь
очки: очках
ошибка: ошибке
пайтон: пайтон
памятный: памятная
панк: панк
пар: пару пара
параллельно: параллельно
париж: париже
парк: парк
пародия: пародии
парок: парков
педагогический: педагогическую
первое: первым первого первых первые первом
первый: первой первую первая первый
перевести: переведена
перевод: переводу перевод
переводчик: переводчиком
перед: перед
передать: передала передана
переехать: переехать переехала
пережить: пережила
переименовать: переименованного
перейти: перейти перешла
перенаправить: перенаправлено
перенаправляться: перенаправляется
переписать: переписала
переполнить: переполненном
перерыв: перерыва
перерыть: перерыв
пересматривать: пересматривала
перестать: перестала
перестроить: перестроила
переть: перт при
период: период
персонаж: персонаж персонажах персонажи персонажей
персоналия: персоналии
персональный: персональные
печатать: печатала
печать: печати
писатель: писателями писателя писателях писателей писатели
писательница: писательницы писательница
писать: писал писать писала
письменный: письменный
письмо: письмо
питер: питера
пишущий: пишущей пишущая
план: план
планировать: планирует
планироваться: планировалась
платье: платье
победить: победившая
побить: побил побила побило
поведение: поведения
повернуть: повернула
повлиять: повлияла
повод: поводу
подавить: подавила
подарить: подарила
подать: подала
подвергаться: подвергалась
подвергнуть: подвергла
подводить: подводила
подданство: подданство
поддержать: поддержанных
поддерживать: поддерживала поддерживая поддерживаемая
поддержка: поддержку поддержки
подкасты: подкасты
подписать: подписала
подробно: подробно
подробный: подробнее
подростковый: подростковом
подросток: подростком
подруга: подруга
подряд: подряд
подтвердить: подтвердила подтвердив подтвердил
подтверждать: подтверждают
подумать: подумала
поезд: поезде поезда
поездка: поездки
пожелание: пожелания
пожениться: поженились
пожертвование: пожертвование пожертвований
пожертвовать: пожертвовать пожертвовала пожертвует
пожиратель: пожиратели
поздний: позже
познакомиться: познакомились познакомилась
поиск: поиски поисков поиск поиску поиска
пойти: пойдя
пока: пока
показать: показан
поклонник: поклонников поклонникам
поклонница: поклонница
покупатель: покупателям
пол: пол
полагать: полагает
политик: политика политике
политический: политическими политическое
полиция: полиции
полностью: полностью
полный: полное полной
положение: положении
положительный: положительные
полпути: полпути
полтергейст: полтергейстах
полукровка: полукровку полукровка
получать: получать получаете
получить: получила получил получившим получили получив получившая получивший получить
польза: пользу
пользоваться: пользовалась
польша: польша
помнить: помню
помогать: помогают помогает
помощь: помощью помощь
понятие: понятия
понять: понять
поппи: поппи
попросить: попросил попросить попросила
популярный: популярным
пора: пор
поросенок: поросенок
порт: порту порт
портал: портал
портрет: портрет
портретный: портретная
португалия: португалии португалию португалия
посвятить: посвятила
посвящение: посвящение
посетить: посетила
посещать: посещающем
поскольку: поскольку
последний: последнее последнюю последний последнего последние последних последней
последовательно: последовательно
последующий: последующих последующие
пособие: пособие
посол: послом после
пост: посте пост
поставить: поставила поставлена поставив
постановление: постановления
постоянный: постоянная
построить: построен
поступить: поступила
поступление: поступления поступлением
посчитать: посчитав
потеря: потерю
потребовать: потребовало потребовала
поттер: поттером поттер поттера поттеру поттере
похожий: похож
почему: почему
почтить: почти
появиться: появившись появилась
появление: появлению появлением
править: правило править правил
правка: правки
правый: права прав право
прадед: прадед
праздник: праздник
предвидеть: предвидя
предел: пределами
предисловие: предисловия предисловие
предлагать: предлагали
предложить: предложили предложено
предмет: предметы
предполагать: предполагала предполагаемое
предположение: предположения предположение
предположить: предположил
председатель: председателя
представить: представлено представила
представиться: представились
представлять: представляют представлять
предстать: предстала
предшественник: предшественника
предыдущий: предыдущего
предыстория: предыстория
прежде: прежде
президент: президент
прекращение: прекращении
премия: премий премии премия премию
премьер: премьер премьера
премьера: премьерой
преподавать: преподавала преподавать преподавал
пресс: пресс прессе пресса
преступление: преступления
преуменьшение: преуменьшением
преуспеть: преуспела
прибыль: прибыль
прибыть: прибыли прибыл
привести: привело
привить: привила
привлечь: привлечь
приехать: приехав
признавать: признавала
признаваться: признавалась
признание: признанию
признать: признано признана
признаться: призналась
прийти: пришла
прийтись: пришлось
приквела: приквела
прикрепить: прикрепила
приложение: приложения
примерный: примерно
примечание: примечания
принадлежать: принадлежало принадлежат
принести: принесли
принц: принца принц
принцесса: принцессы
принять: приняла
приобрести: приобретена приобрела
прислать: пришли
присоединиться: присоединились
притворяться: притворяться
причина: причин причинам
про: про
проверять: проверяла
программа: программ программе
прогулка: прогулке
продавать: продаваемая продаваемых продаваемые продаваемой
продаваться: продающийся
продажа: продажи продаж продажу
продать: продала продан продана продано продал проданы проданной
продлить: продлили
продолжать: продолжать
продолжение: продолжение
продолжить: продолжил продолжила
продюсер: продюсером продюсерами продюсеров продюсер
проект: проектом проектах проекте проекта
проиграть: проиграл
произведение: произведения произведение
произведенье: произведений
производство: производство
произвольный: произвольное
происходить: происходит
пройти: прошла прошло
проклясть: проклятое
проникновение: проникновения
просмотр: просмотр просмотры
просто: просто
пространство: пространства
против: против
противоречить: противоречили
прототип: прототипом
профессиональный: профессиональной
профессор: профессором
проходить: проходила
процент: процентов
процесс: процесс
прочесть: прочесть прочла
прочий: прочая прочее
прочитать: прочитал прочитала
прочный: прочным
прямой: прямо
псевдоним: псевдоним псевдонимом псевдонимами псевдонима псевдонимы
психиатрический: психиатрических
публикация: публикация публикацию публикации
публиковать: публиковать
публиковаться: публикуются публиковались
публичный: публично
пузыриться: пузырились
путеводитель: путеводитель
путина: путину путин
путь: путь
пчела: пчела
пьеса: пьесу пьесы пьеса
пэна: пэна
пятый: пятая пятого
пять: пять
работа: работы работу
работать: работает работать работала
рабочий: рабочей
радикальный: радикальной
радио: радио
раз: раза
развестись: развелась
развлеченье: развлечений
развод: развод
разговаривать: разговаривает
разговор: разговор
раздать: раздала
раздел: разделе
различие: различия
размер: размером размере
разойтись: разойдясь
разочарование: разочарованию
разочаровать: разочарована
разработчик: разработчики
разрешить: разрешить
разрядка: разрядка
райт: райт
ранее: ранее
ранний: раньше
расизм: расизме
раскритиковать: раскритиковала раскритикованы раскритиковали
раскрытие: раскрытия
раскрытый: раскрыты
раскрыться: раскрылось
распасться: распался
расположить: расположенным
распределять: распределяющая
распространить: распространены
распутывать: распутывает
рассеять: рассеянным рассеянного рассеянный
рассказ: рассказы рассказ
рассказать: рассказанная рассказал
рассказов: рассказов
рассказывать: рассказывала
расследование: расследования расследование расследовании
расследовать: расследует
расстаться: рассталась
расти: растущего
растрогаться: растрогалась
расширение: расширении
рбк: рбк
ргб: ргб
реакция: реакции
реализоваться: реализовался
реальность: реальность
реальный: реальным
ребенок: детей детям дети
регенеративный: регенеративной
регулирование: регулированию
редактор: редактора редактор редактору редакторами
реджины: реджины
редмэйн: редмэйн
резка: резкой
результат: результатам
рейтинг: рейтинг
река: реки
рекламный: рекламный рекламным
рекорд: рекорд рекорды
рекордный: рекордные рекордных
религиозный: религиозные религиозного
релиз: релизе
ресурс: ресурсы
ретейлер: ретейлер
ретейлером: ретейлером
реформатор: реформатором
речь: речей
решать: решать
решение: решение решением
решимость: решимость
решить: решили решил
рика: рик
рикману: рикману
ричард: ричарду
рнб: рнб
робби: робби
роберт: роберта роберт
робин: робин
род: рода род
роджер: роджеру
родитель: родителей родителем родители
родиться: родился родившиеся родилась
рождение: рождения рождение рождении
рождественский: рождественский
роль: роль
роман: романов роману романе романом романа роман романы
рон: рон
росмэн: росмэн
российский: российского российская российское
россия: россии россия
роуза: роуза
роулинг: роулинг
роулинга: роулинга
рубеус: рубеус
рука: руках
рукописный: рукописных
рукопись: рукопись
руперт: руперт
русская: русская
русский: русский
русый: рус
ручка: ручки ручкой
рэдклифф: рэдклифф
рэнкин: рэнкин
рэнкином: рэнкином
ряд: ряда ряд рядом
сажать: сажает
сайт: сайта сайте сайт сайты
саламандра: саламандре
сам: самой самом самим сама самое
самоубийство: самоубийство
самый: самый самыми самым самых самые
сантиметр: см
сара: сарой
саундтрек: саундтрек
саха: саха
сбор: сбора сборов сбору
сборник: сборнику сборника
св: св
свадьба: свадьбы
сведение: сведения
свежий: свежие
света: свет
свидетельство: свидетельство
свобода: свободы
свободный: свободной
свое: своих свои своему своего своим
свой: свой своей свою
свойство: свойство
связанный: связанные связан связаны
связаться: свяжитесь связался
связь: связи
сдать: сдав сдать
сделать: сделали сделанные сделал сделало
себя: собой
северный: северным северной
северо: северо
северус: северус
сегодня: сегодня
седьмой: седьмого седьмой седьмую
сей: сих
сейчас: сейчас
секрет: секреты
сексуальный: сексуальное
секунда: секунды
семейный: семейный
семизначную: семизначную
семь: семь семи
семья: семья семьям семье
сенат: сенат
сент: сент
сентябрь: сентябре сентября
сердиться: сердились
сердце: сердце
середина: середине
сериал: сериал сериала
серия: серии серией серию серия
сестра: сестра сестрой сестре
сеть: сетях
си: си
сидеть: сидела
сиквел: сиквел
сиквелов: сиквелов
сильный: сильно
симпсон: симпсоны
сириус: сириусе
система: системе
сити: сити
ситуация: ситуации
сказать: сказать сказав сказал сказала
сказка: сказок сказки сказку сказкой
скандал: скандала
скачать: скачать
складываться: складывались
склероз: склерозом склероз склероза
сколько: сколько
скрипичный: скрипичный
скрываться: скрывалась
скрытый: скрытые
слава: славы
следить: следя
следователь: следователь
следующий: следующем последующей следующей следующий следующее следующих следующие
слишком: слишком
словарь: словари
слово: слов словам слова
словом: словом
сложный: сложные сложное
служба: служба службе
служебный: служебные
слух: слухи слух
случай: случаях
случайный: случайная случайную
случиться: случилось случился
слушать: слушала слушая
сменить: сменивший
смертельный: смертельная
смерть: смерть смерти
смех: смехом
сми: сми
смит: смитом смит
смочь: смогла сможет сможете
сначала: сначала
снегг: снегг
снимать: снимать
сниматься: сниматься снимавшиеся
снова: снова
снять: снят снял снята
сняться: снялась
собираться: собирается
собрать: собрали собраны собрать
собственный: собственному собственное
событие: события событий событиями
совершить: совершенный
совет: совета
советовать: советовал
совместно: совместно
современник: современников
современный: современной
согласиться: согласилась согласился
согласный: согласна
содержание: содержание содержании
сожалеть: сожалеет
создавать: создавали
создание: созданию создание
создатель: создателя
создать: создала созданный создать
сознание: сознание
сомнительный: сомнительного
сообщество: сообщество сообщества сообществом
сообщить: сообщила сообщить
соотносить: соотносят
сопроводить: сопроводила
сопровождаться: сопровождалось
сопротивляться: сопротивляющееся
соррелл: соррелл
соседний: соседнюю
сослаться: сославшись
сосредоточить: сосредоточен
состав: состав
составить: составлен составил составившие
состояние: состояние состоянии
состояться: состоялась
сотрудник: сотрудников
сотрудница: сотрудницей сотрудницы
сотрудничество: сотрудничестве сотрудничества
сохранение: сохранением
социальный: социальных социальное социальным
сочинить: сочинить
спектакль: спектакль
спектр: спектр
специальный: специальном
спилберг: спилберг спилберга
список: списке список
спонсорский: спонсорскую
спора: споры
справка: справка
спрашивать: спрашивал
спрос: спроса
спустя: спустя
сравнить: сравнил
сразу: сразу
среда: среду
среди: среди
средний: среднего средней
средство: средства
српски: српски
српскохрватски: српскохрватски
ссылка: ссылка ссылками ссылки
ставить: ставит ставили
ставка: ставок
стандарт: стандарта
становиться: становился
станция: станцию станция
старое: старое старых
староста: старостой
старый: старая старой старую
статистика: статистика
статус: статус статуса
стать: стал стало стала ставшей став стали
статья: статья статьи
степень: степенью
стерлинг: стерлингов
стив: стивом стива стив
стивен: стивеном стивен
стираться: стирается
стоить: стоят стоящим
столько: столько
страдать: страдающих страдала
страйк: страйк
страйка: страйка
страйке: страйке
страна: странах стране
страница: страницы страница страницу страниц странице
страх: страх
страховка: страховки
стрит: стрит
строка: строк
строчить: строчит
студентка: студентку
суд: суд
судебный: судебных судебного
суицид: суициде
сумма: сумму
суммарный: суммарный
супермодели: супермодели
существо: существ существа
существование: существование
существовать: существующая
сфера: сферу сферы
сформировать: сформированной
сходство: сходство
сцена: сцена
сценарий: сценарием сценарии сценарий
сценарист: сценариста сценарист сценаристы
сценаристка: сценаристка
счастливый: счастлива
считать: считает считанные считала
считаться: считалось
сша: сша
сыграть: сыграла сыгравший сыграл
сын: сын
сыщик: сыщик
сюда: сюда
сюжет: сюжет сюжете
т: т
таблоидом: таблоидом
тайный: тайная тайной тайны
также: также
такой: такой такое такие
тасс: тасс
татарча: татарча
татшилл: татшилл
тварь: твари
твит: твит
твиттер: твиттер
твиттере: твиттере
твиты: твиты
творческий: творческий творческого творческом
творчество: творчества
театр: театре
текст: текст
текущий: текущие
телеведущая: телеведущую
телевидение: телевидения
телевизионный: телевизионном
тележурналист: тележурналистом
телепрограмма: телепрограмме
телесериал: телесериала
тем: тем
тематический: тематический тематические тематических
тереть: три
термин: термин
терри: терри
тесно: тесно
течение: течение
тея: тей
тираж: тираж тиражом
тиффани: тиффани
тихий: тихую
товарный: товарный
толкина: толкина
торн: торном
тот: том те тот тому
точка: точки
точно: точно
тощий: тощий
травить: травит
трагикомедия: трагикомедия трагикомедию
транс: транс
трансгендерная: трансгендерная
трансгендерного: трансгендерного
трансгендерной: трансгендерной
трансгендерным: трансгендерным
трансгендерных: трансгендерных
трансфобии: трансфобии
трансфобию: трансфобию
трансфобные: трансфобные
третий: третий третьей третья
три: тремя
трилогия: трилогии
трудный: трудная
трюк: трюком трюк
турист: туристов
тыл: тыла
тысяча: тысяч
тюрьма: тюрьму
уверить: уверенной
увидеть: увидел увидев увидеть
угроза: угрозу
ударить: ударил
удовлетворение: удовлетворения
удовольствие: удовольствие
ужасный: ужасное
узнать: узнала
узник: узник узника
уизли: уизли
уилберфорсом: уилберфорсом
уильям: уильямом
уинфри: уинфри
уисп: уисп
указание: указанием
указать: указан
украина: украину
украинский: украинских
улица: улице
улыбка: улыбки
умалчивать: умалчивали умалчивая
умереть: умерла
универсальный: универсальная
университет: университет университете университета
унижать: унижающую
унизительный: унизительным
уничтожать: уничтожает
уотсон: уотсон
упасть: упала
упомянуть: упомянутых
управление: управление
уровень: уровень
урок: уроки
усадебный: усадебный
усилие: усилий
условие: условий условие условия
услуга: услугами
успех: успеха успех
устрашать: устрашающую
утверждать: утверждала
утверждаться: утверждалось
утверждение: утверждения утверждение
утечка: утечку
утратить: утратила
утро: утра
участие: участие участии
учитывать: учитывал
учить: учила
учиться: училась
учреждение: учреждениях
уэльс: уэльс
фаза: фазу
факсимиле: факсимиле
факт: фактах
фанат: фанатов
фансайты: фансайты
фантаст: фантасты
фантастика: фантастики
фантастический: фантастические
февраль: февраля феврале
феминизм: феминизма
феминистка: феминисткой феминисток
феникс: феникса
фестиваль: фестивале
фикшн: фикшн
филантроп: филантропом
филантропия: филантропии
филантропка: филантропка
филдинг: филдинг
филология: филологии
философский: философский философского
фильм: фильм фильме фильмами фильмов фильмах фильма фильмы
фильмография: фильмография
финансировать: финансирует
финансовый: финансово
фирма: фирма фирмы
фон: фоне
фонд: фонд фонда фонду
форстейтер: форстейтер
форум: форум
фото: фото
фотография: фотографию фотографией
фрагмент: фрагментов
фраем: фраем
фраза: фразу
франция: франция
француженка: француженка
французский: французскому французский французского
фулхэмская: фулхэмская
фундамент: фундаментом
фунт: фунтов
фэнтези: фэнтези
хагрид: хагрид
ханной: ханной
характер: характером
характеризацией: характеризацией
харрис: харриса
хвалить: хвалили
хейманом: хейманом
хелен: хелен
хинь: хини
хобби: хобби
хогвартс: хогвартс
хогвартса: хогвартса
ход: ход ходе
холл: холле
холлидей: холлидей
хорватский: хорватская
хороший: лучшем хороши хорошую лучше лучшую лучшие лучшая хорош лучший лучшего
хорошо: хорошо
хотеть: хотела
храбрость: храбрость
художник: художникам
хьюго: хьюго
целевой: целевая
целый: целом
цель: целях целью
центр: центра
церемония: церемония церемонии
цитата: цитаты
цитировать: цитировать
чайковский: чайковского
чарли: чарли
час: часа
частить: части
частично: частично
частный: частный
часто: часто
часть: частью частей частях часть
часы: часов
человек: человек человека людях людей человеком люди людям
челтнеме: челтнеме
чемодан: чемодане
чемпионат: чемпионат
чепстоу: чепстоу
через: через
чернильный: чернильно
черноволосый: черноволосый
честь: честь
четыре: четыре
число: числе
читатель: читателя читателей
читать: читать читала
член: члены член
чтение: чтение чтению
чтобы: чтобы
чувство: чувство
чуть: чуть
шаг: шаг
шанс: шанс шансов
шармбатон: шармбатон
шеймуса: шеймуса
шелкопряд: шелкопряд
шельмование: шельмование
шест: шестом
шестая: шестая шестой
шестилетнего: шестилетнего
шестой: шестого
шесть: шесть
школа: школу школе школы
шляпа: шляпа
шон: шона
шотландия: шотландии шотландия
шотландка: шотландка
шоу: шоу
штатский: штатский
штраф: штраф
шутка: шутка
эдди: эдди
эдинбург: эдинбург эдинбурге
эдинбургский: эдинбургского эдинбургском
экзамен: экзамены
экземпляр: экземпляры экземпляров
экран: экраны
экранизация: экранизацию экранизация экранизации
экранизировать: экранизированы экранизирован экранизирована экранизирует
эксетер: эксетер
эксетерский: эксетерский
эксетерского: эксетерского
эксклюзивный: эксклюзивной
элемент: элемент
эллакотт: эллакотт
эмма: эмма
энд: энд
энде: энде
эндрюсского: эндрюсского
энергия: энергию
энна: энн
энтони: энтони
энциклопедия: энциклопедией энциклопедии
эпизод: эпизоде эпизодов эпизода эпизоды
эпилог: эпилога
эссе: эссе
это: этом это этим
этот: этой эта эту
ю: ю
южный: южный южным
юридический: юридической
являться: является
явно: явно
яд: ядом
язык: язык языках языке языком
языковой: языковом
языковый: языков
яйцо: яиц
якоб: якобы
январь: январе января
яркий: яркими
