абернэти: абернэти
аберфорт: аберфорт
август: августа
авторство: авторства
азад: азад
азкабана: азкабана
айзекс: айзекс
айнесон: айнесон
алан: алан
аластор: аластор
алек: алек
алекс: алекс
александр: александр
алекто: алекто
алисий: алисия
альберт: альберт
альбус: альбус
альфи: альфи
альфонсо: альфонсо
альфред: альфред
амбридж: амбридж
амелия: амелия
амельда: амельда
амикус: амикус
амос: амос
англ: англ
английский: английской английского английском
анджелина: анджелина
анжелика: анжелика
анна: анна
анонсировать: анонсирован
антон: антон
антонин: антонин
апрель: апреле апреля
арабелла: арабелла
арагог: арагог
арбен: арбен
аргус: аргус
ариан: ариана
ариэлла: ариэлла
армандо: армандо
арнольд: арнольд
артур: артур
архивировать: архивировано
архивный: архивные
астория: астория
аттербери: аттербери
аурелиус: аурелиус
афшан: афшан
байрактарай: байрактарай
бакл: бакл
банти: банти
барбари: барбари
барбэ: барбэ
барда: барда
барлону: барлону
барон: барон
баррон: баррон
бартемий: бартемий
батильда: батильда
бауэр: бауэр
бежать: бегущая
безголовый: безголовый
бейли: бейли
бейстегуй: бейстегуй
бейтсон: бейтсон
бекер: бекер
беларуская: беларуская
белац: белац
белби: белби
белизна: белизна
белла: белл
беллатриса: беллатриса
бенджамин: бенджамин
бенедикт: бенедикт
беннисон: беннисон
бербидж: бербидж
берти: берти
бест: бест
библиографический: библиографических
биггерстафф: биггерстафф
бидля: бидля
бизли: бизли
билл: билл
бирдсолл: бирдсолл
бирн: бирн
благроув: благроув
блейз: блейз
блетчли: блетчли
близнец: близнецы
блисдейл: блисдейл
блэк: блэк
богрод: богрод
бойд: бойд
больший: большая
большой: велика
бонем: бонем
бонни: бонни
боунс: боунс
боуэн: боуэн
брайс: брайс
браный: брана
браун: браун
бреммер: бреммер
брендан: брендан
бреннер: бреннер
бретт: бретт
бриджитт: бриджитт
бродбент: бродбент
бродейкер: бродейкер
бронтис: бронтис
брук: брук
бруствер: бруствер
брэдли: брэдли
брюно: брюно
булстроуд: булстроуд
български: български
бэгшот: бэгшот
бэйлер: бэйлер
бэйн: бэйн
бэйфилд: бэйфилд
бэрбоун: бэрбоун
бюджет: бюджет
вакансия: вакансия
валери: валери
вальд: вальд
вальда: вальда
варнава: варнава
вейн: вейн
великобритания: великобритания великобритании
верн: верн
вернон: вернон
вероника: вероника
версия: версия версии
весить: весь
викиданных: викиданных
викимедиа: викимедиа
викиновости: викиновости
википедии: википедии
википедия: википедия
викисклад: викисклад
викискладе: викискладе
виктор: виктор
викторий: виктория
вильгельмина: вильгельмина
винда: винда
винсент: винсент
висенция: висенция
вклад: вклад
включать: включая
владелец: владелец
власть: власти
внешний: внешние
внутренний: внутренняя
вогтэйл: вогтэйл
возвращение: возвращение
возможно: возможно
войт: войт
войти: войти
вокзал: вокзале
волан: волан
волшебный: волшебные волшебный
вольф: вольф
вонг: вонг
время: время
вселенная: вселенной
второй: вторая
вуд: вуд
выйти: вышла вышел выйдет
выпустить: выпущена
вырезать: вырезаны
выход: выхода
вэнс: вэнс
габриэль: габриэль
гай: гай
гарднер: гарднер
гарри: гарри
гаррик: гаррик
гатри: гатри
геба: геба
геллерт: геллерт
генри: генри
генриетта: генриетта
гермиона: гермиона гермионы
героизм: героизме
герой: героев
гиббс: гиббс
гидеон: гидеон
гилберт: гилберт
главное: главные главных
глаз: глаз
гласкотт: гласкотт
глисон: глисон
гловер: гловер
гнарлак: гнарлак
год: году лет год годы года
гойл: гойл
голденберг: голденберг
голдштейн: голдштейн
голова: голова
гонт: гонт
гораций: гораций
горбина: горбин
гордон: гордон
готобед: готобед
граббли: граббли
грегор: грегорович
грегори: грегори
грейвс: грейвс
грейвса: грейвса
грейнджер: грейнджер
гриммсон: гриммсон
грин: грин
гринвуд: гринвуд
гринт: гринт
гриффитс: гриффитс
грозный: грозный
грохх: грохх
группа: группа
грюм: грюм
гузман: гузман
гунар: гунар
гэмбон: гэмбон
гэри: гэри
дадли: дадли
дама: дама
дамблдор: дамблдор
дамблдора: дамблдора
даниэль: даниэль
данна: данн
дар: дары
дарри: дарри
дарси: дарси
дата: дата
дафна: дафна
два: два двух
двадцатилетие: двадцатилетия
де: де
девон: девон
дедалус: дедалус
дейв: дейв
действие: действия действие
действовать: действовать
декабрь: декабря
делакур: делакур
дельбоннель: дельбоннель
дельфингтон: дельфингтон
день: дней
депп: депп
дерек: дерек
деспла: деспла
детство: детстве
дж: дж
джарвис: джарвис
джаситн: джаситн
джейд: джейд
джейми: джейми
джеймс: джеймс
джейсон: джейсон
джемма: джемма
дженн: дженн
дженнифер: дженнифер
джеральдин: джеральдин
джесси: джесси
джессика: джессика
джефф: джефф
джим: джим
джимми: джимми
джин: джин
джиневра: джиневра
джоан: джоан
джон: джон
джонни: джонни
джонс: джонс
джонсон: джонсон
джордан: джордан
джордж: джордж
джорджина: джорджина
джошуа: джошуа
джуд: джуд
джули: джули
джулиан: джулиан
диггори: диггори
дидман: дидман
диллейн: диллейн
дилогия: дилогия
дина: дин
дингл: дингл
диппет: диппет
дитя: дитя
добби: добби
дож: дож
дойл: дойл
док: док
долгопупс: долгопупс
долиш: долиш
долорес: долорес
долохов: долохов
дон: дон
донаган: донаган
донал: донал
дополнительный: дополнительные
доступный: доступен
драко: драко
древность: древности
друг: другом
другой: другие других
дуглас: дуглас
дурмстранг: дурмстранг
дурной: дурная
дурсль: дурсль
дэвид: дэвидом дэвид
дэвис: дэвис
дэйв: дэйв
дэйл: дэйл
дэн: дэн
дэниел: дэниел
дэниэл: дэниэл
дюк: дюк
е: е
единственный: единственная
елена: елена
жанр: жанре
женевьев: женевьев
забини: забини
завершение: завершения
заглавный: заглавная
заканчивать: заканчивая
заключительный: заключительная
занимать: занимает
запись: запись записи
запрос: запросы
зарегистрировать: зарегистрированный
засохнуть: засохшая
захария: захария
заявление: заявление
зверь: звери
златопуст: златопуст
зло: зла
змея: змеи
знак: знак
значительно: значительно
зов: зов
зоя: зои
зритель: зрителей
иванс: иванс
игорь: игорь
игра: игра игры
идзяк: идзяк
изабелла: изабелла
изаура: изаура
избранный: избранные
известно: известно
икабог: икабог
имельда: имельда
иметь: имеет
имя: имена
ингвар: ингвар
инглби: инглби
инструмент: инструменты
информация: информация
ирма: ирма
использование: использования
история: история
источник: источник
итог: итогов
иэн: иэн
июль: июля июле
июнь: июня
йа: йа
йейтс: йейтс
йетс: йетс
кадоган: кадоган
каждый: каждой
каллум: каллум
кама: кама
камень: камень
канада: канада
кандиду: кандиду
каркаров: каркаров
кармена: кармен
каролин: каролин
картер: картер
карточный: карточная
картрайт: картрайт
кассовый: кассовые
каталог: каталогах
категория: категории
кафф: кафф
квиддич: квиддич
квиддичу: квиддичу
квирелл: квирелл
квиринус: квиринус
кевин: кевин
кей: кей
кейв: кейв
кейт: кейт
келли: келли
кеннет: кеннет
керли: керли
киаран: киаран
кикимер: кикимер
ким: ким
кингсли: кингсли
киновселенной: киновселенной
киносерии: киносерии
китайский: китайская
кларк: кларк
клаудия: клаудия
клеманс: клеманс
клиз: клиз
клиффорд: клиффорд
кловис: кловис
клэйдон: клэйдон
книга: книг книгах книги книге книга
кобурн: кобурн
ковальски: ковальски
когтевран: когтевран
код: код
кодекс: кодекс
койл: койл
кокер: кокер
коламбус: коламбус
колин: колин
коллекционный: коллекционная
колтрейн: колтрейн
комната: комната
компания: компанией
композитор: композитор
конструктор: конструктор
конфиденциальность: конфиденциальности
корбан: корбан
корби: корби
кордис: кордис
кормак: кормак
корморане: корморане
корнелиус: корнелиус
корнелл: корнелл
короста: коросты
короткий: короткие короткий
который: которого которая который
коул: коул
коулсон: коулсон
кравиц: кравиц
кралл: кралл
крам: крам
крамб: крамб
крауч: крауч
кривить: криви
криденс: криденс
крис: крис
кристал: кристал
кристи: кристи
кристиан: кристиан
критик: критиков
кровавый: кровавый
кровь: кровь
крокфорд: крокфорд
кроткотт: кроткотт
крыса: крысы
крэбб: крэбб
крюкохват: крюкохват
ксенофилиус: ксенофилиус
куарон: куарон
кубок: кубок
кузнецов: кузнецов
куинни: куинни
кук: куки
кукушка: кукушки
кунзе: кунзе
кэмпбелл: кэмпбелл
кэрроу: кэрроу
кэти: кэти
кэтрин: кэтрин
ла: ла
лаванда: лаванда
лавгуд: лавгуд
лайонел: лайонел
лафлэнд: лафлэнд
леджено: леджено
лейла: лейла
ленни: ленни
лента: лента
леонидас: леонидас
лесли: лесли
лестрейндж: лестрейндж
летие: летия
лианный: лианна
либноу: либноу
лиза: лиза
лили: лили
линден: линден
линч: линч
лита: лита
лиф: лиф
лицензия: лицензии
лишение: лишениях
ллойд: ллойд
логический: логической
локация: локации
локонс: локонс
лорд: лорд
лорена: лорена
лоу: лоу
лу: лу
луиса: луис
льюис: льюис
льюнг: льюнг
лю: лю
люк: люк
люпин: люпин
люциус: люциус
магия: магия магии
маглы: маглы
магориан: магориан
мадам: мадам
мадс: мадс
мазуччи: мазуччи
майк: майк
майкл: майкл
майлс: майлс
майял: майял
макберни: макберни
макгонагалл: макгонагалл
макдональд: макдональд
макдугалл: макдугалл
македонский: македонски
маки: маки
макилвейн: макилвейн
маккрори: маккрори
маклагген: маклагген
маклин: маклин
макманус: макманус
макмиллан: макмиллан
макнейр: макнейр
максим: максим
малкольм: малкольм
маллан: маллан
малфой: малфой
маргулис: маргулис
марджери: марджери
марджори: марджори
мария: мария
марк: марк
маркус: маркус
марта: марта
мартин: мартин
материал: материал
матиас: матиас
мая: мая
медиафайлы: медиафайлы
мейсон: мейсон
меллинг: меллинг
место: место места
миккельсен: миккельсен
милисента: милисента
миллар: миллар
миллер: миллер
миллиард: млрд
миллион: млн
мимси: мимси
минерва: минерва
министерство: министерство
министр: министр
мир: мира мир
миранда: миранда
мириам: мириам
мировой: мировой
мирон: мирон
миртл: миртл
миссис: миссис
мистер: мистер
митчелл: митчелл
мишель: мишель
младенчество: младенчестве
младший: младший
много: более
множественный: множественные
мобильный: мобильная
могила: могила
модести: модести
модсли: модсли
молли: молли
молодость: молодости
монах: монах
моран: моран
морт: морт
мортемор: мортемор
мортон: мортон
мочь: можете могут
муркрофт: муркрофт
муфалда: муфалда
мы: нами
мэгги: мэгги
мэйсон: мэйсон
мэнди: мэнди
мэри: мэри
мэтилок: мэтилок
мэттью: мэттью
мюриэль: мюриэль
мюррей: мюррей
навигация: навигации навигация
нагайна: нагайна
над: над
надилам: надилам
наземникус: наземникус
назойливый: назойливых
найджел: найджел
найджелус: найджелус
найи: найи
найт: найт
нарцисс: нарцисса
наталия: наталия
научный: научно
начало: начале начала
начинать: начиная
наш: наших
невилл: невилл
недостоверный: недостоверный
некоммерческий: некоммерческой
неопр: неопр
неполный: неполный
никнуть: ник
николас: николас
нимфадора: нимфадора
нина: нина
нинетт: нинетт
новость: новость
новый: новые
нокс: нокс
норрис: норрис
нортон: нортон
нохчийн: нохчийн
ноябрь: ноября ноябре
ньют: ньют
ньютон: ньютон
ньюэлл: ньюэлл
об: об
обитание: обитания
обитать: обитают
обличие: обличии
образ: образе
образовательный: образовательный
обращение: обращения
обслуживание: обслуживание
обсуждение: обсуждение обсуждения
общий: общее
огонь: огня
одиннадцать: одиннадцати
озвучивание: озвучивание
окончание: окончания
окталогии: окталогии
октябрь: октября
олден: олден
олдмен: олдмен
оливандер: оливандер
оливер: оливер
олимпий: олимпия
опасный: опасных
оператор: оператор
описание: описание
опытный: опытными
организация: организации
орден: орден
орсайно: орсайно
основа: основе
основать: основанных основанный
основной: основной основную основная
ответственность: ответственности
отдельный: отдельных отдельные
отзыв: отзывов отзывы отзыва отзыв
отказ: отказ
отличаться: отличаться
отредактировать: отредактирована
отряд: отряд
отто: отто
оулавюр: оулавюр
оулафссон: оулафссон
официальный: официальный
офф: офф
оффы: оффы
ошибка: ошибке
падма: падма
пайпер: пайпер
пак: пак
папворт: папворт
парадайс: парадайс
парвати: парвати
парк: парк
паркинсон: паркинсон
пародия: пародии
патил: патил
патрик: патрик
паттинсон: паттинсон
пенелопа: пенелопа
первое: первого первое первых
первый: первая
перевод: перевод перевода
перейти: перейти
перлман: перлман
перси: перси
персиваль: персиваль
персиваля: персиваля
персонаж: персонаж персонажи
персональный: персональные
петер: петер
петтигрю: петтигрю
петунья: петунья
печать: печати
пивз: пивз
пий: пий
пиквери: пиквери
пиклз: пиклз
пинс: пинс
пирс: пирс
писательница: писательницы
питер: питер
плакса: плакса
план: планах
планировать: планируют
платформа: платформе
поведение: поведения
подведение: подведения
поделить: поделена
подробный: подробнее
пожертвовать: пожертвовать
пожиратель: пожиратели
поиск: поиск поиску
пока: пока
показ: показ
пол: пол
политик: политика политике
полкисс: полкисс
полнометражный: полнометражных
полный: полная
полтергейст: полтергейстах
полукровка: полукровка
полумна: полумна
получить: получить
помона: помона
помочь: помочь
помощь: помощью
помфри: помфри
поппи: поппи
порпентина: порпентина
портал: портал
портрет: портрет
последний: последний
постоянный: постоянная
поттер: поттер поттера поттере
поул: поул
почтить: почти
поэзи: поэзи
появиться: появилась появившиеся
появляться: появлялся
пояснение: пояснение
править: править
правка: правок правки
пранг: пранг
пратт: пратт
предлагаться: предлагается
предмет: предметы
предраг: предраг
представиться: представились
предыстория: предыстория
премьер: премьера
премьерный: премьерный
преступление: преступления
прибыльный: прибыльных
прибыть: прибыли
приквелы: приквелы
примечание: примечания
принц: принц
принять: приняли
причина: причин
проверить: проверенной
проверка: проверки
проверяться: проверялась
продавщица: продавщица
продолжение: продолжением
продюсер: продюсер
проект: проектах проекту
произведение: произведения произведение
производство: производство
произойти: произошедших
происходить: происходит
происхождение: происхождения
проклясть: проклятое
просмотр: просмотры
просрочить: просроченные
пространство: пространства
профессор: профессор
прочий: прочее
путеводитель: путеводитель
пьюси: пьюси
пэдли: пэдли
пэйтон: пэйтон
пэм: пэм
пэнси: пэнси
пэчнер: пэчнер
пять: пять
работа: работы
работать: работали работает
рада: раде
раздел: разделе
разделение: разделению разделения
разделить: разделить
разнести: разнести
разработчик: разработчики
райалл: райалл
райан: райан
райт: райт
ральф: ральф
рамон: рамона
ранкорн: ранкорн
распределять: распределяющая
рассказ: рассказы
рассказывать: рассказывает
расширить: расширив
реакция: реакция
регбо: регбо
регулус: регулус
реддл: реддл
реджинальд: реджинальд
редмэйн: редмэйн
религиозный: религиозные
ресурс: ресурсы
ретроспективный: ретроспективный
ридделл: ридделл
рика: рик
рикман: рикман
римус: римус
рисунок: рис
рита: рита
риттер: риттер
ричард: ричард
ричардсон: ричардсон
ричмонд: ричмонд
роба: роб
робби: робби
роберт: роберт
роджер: роджер
родри: родри
рождественский: рождественский
роза: роза
розмерта: розмерта
розье: розье
роланда: роланда
роль: роль роли
роман: романов романы
ромильда: ромильда
рон: рона рон
рональд: рональд
российский: российская
рот: рот
роул: роул
роули: роули
роулинг: роулинг
роулинс: роулинс
рохан: рохан
рошель: рошель
ру: ру
рубеус: рубеус
рудольф: рудольф
руперт: руперт
русло: русло
русский: русский
русый: рус
руфус: руфус
рэд: рэд
рэдклиф: рэдклиф
рэдклифф: рэдклифф
рэй: рэй
рэйф: рэйф
рэнделл: рэнделл
рэнкин: рэнкин
сага: саги
сазерленд: сазерленд
сайкс: сайкс
саймон: саймон
сайт: сайт
сакурай: сакурай
саламандер: саламандер
салли: салли
саманта: саманта
самый: самых
сангвини: сангвини
сантиметр: см
сантос: сантос
саузерн: саузерн
саундерс: саундерс
саундтрек: саундтрек
сбор: сборы
сведение: сведения
свежий: свежие
свободный: свободной
связанный: связанные
связаться: свяжитесь
связность: связности
северус: северус
седрик: седрик
седьмой: седьмая
сезон: сезонов
селуэй: селуэй
семь: семь семи
сентябрь: сентября
серафина: серафина
сердце: сердце
серезин: серезин
сериал: сериал сериала сериалом
серия: серии серий серией серию серия
серра: серра
серый: серая
сеть: сетях
сибилла: сибилла
сивый: сивый
сигурдссон: сигурдссон
сиквелы: сиквелы
сила: сил
симнонишек: симнонишек
симус: симус
сириус: сириус
система: системе
ситар: ситара
сказка: сказки
скарлетт: скарлетт
скачать: скачать
скендер: скендер
скеоч: скеоч
скиттер: скиттер
скорпиус: скорпиус
скот: скот
скримджер: скримджер
скрытый: скрытые
славомир: славомир
сладость: сладостей
следующий: следующих
слизнорт: слизнорт
слишком: слишком
словарь: словари
служба: службе
служебный: служебные
служитель: служитель
случай: случаях
случайный: случайная
смертельный: смертельная
смерть: смерти
сми: сми
смит: смит
снегг: снегг
снейп: снейп
снять: снять
событие: события событиях
содержание: содержание
содержимое: содержимое
создание: создания
создать: создать
сомервилль: сомервилль
сообщество: сообщество
сообщить: сообщила сообщить
состоять: состоит
состояться: состоялась
софи: софи
сохранение: сохранением
социальный: социальных
спецвыпуска: спецвыпуска
спецэпизод: спецэпизод
спина: спин
спиннет: спиннет
список: списке список
сполл: сполл
спора: споры
справка: справка
сприггс: сприггс
спродюсирована: спродюсирована
српски: српски
ссылка: ссылка ссылки
станислав: станислав
старший: старший
статистика: статистика
стать: стало стала
статья: статью статья статьи
стебль: стебль
стеффан: стеффан
стив: стив
стивен: стивен
стонтон: стонтон
страйке: страйке
страна: страны страна
страница: страницы страница страницу страниц странице
строма: строма
струпьяр: струпьяр
стэн: стэн
стюарт: стюарт
судол: судол
существо: существа
сцена: сцены
сценарист: сценарист
сша: сша
сыграть: сыграли
сьюзан: сьюзан
сьюзи: сьюзи
сэм: сэм
сэр: сэр
сюда: сюда
табор: табор
тав: тав
таваре: таваре
тайный: тайная тайны
также: также
тао: тао
тварь: твари тварей тварях
твиттер: твиттер
театр: театр
тейлор: тейлор
текст: текст
текущий: текущие текущую текущая
телевидение: телевидение
телесериал: телесериалом
тематический: тематический
тен: тена
теннант: теннант
теренс: теренс
тесеус: тесеус
тиана: тиана
тикстон: тикстон
тимоти: тимоти
тиффин: тиффин
тоби: тоби
товарный: товарный
толстоватый: толстоватый
толстый: толстый
томас: томас
томпсон: томпсон
тонкс: тонкс
тоня: тони
торкуил: торкуил
торфинн: торфинн
тот: том
тоуз: тоуз
требовать: требуют
трелони: трелони
тремлетт: тремлетт
тройер: тройер
трэверс: трэверс
трюк: трюк
тур: тур
туча: туч
тьюлис: тьюлис
тюдор: тюдор
уайтхаус: уайтхаус
удалять: удаляйте
узник: узник
уигрэм: уигрэм
уизли: уизли
уилдман: уилдман
уилл: уилл
уильям: уильям
уильямс: уильямс
указание: указанием
указать: указан
уолден: уолден
уолперт: уолперт
уолтерс: уолтерс
уонамейкер: уонамейкер
уордер: уордер
уорик: уорик
уорпл: уорпл
уоррен: уоррен
уотерстон: уотерстон
уотсон: уотсон
урок: уроки
условие: условий условия
утечин: утечин
участие: участие участием
участник: участниками
уэйлетт: уэйлетт
фадж: фадж
файнс: файнс
фантастический: фантастических фантастические
фаррелл: фаррелл
февраль: февраля
фелпс: фелпс
фелтон: фелтон
феникс: феникса
фенрир: фенрир
фернанда: фернанда
феррис: феррис
фига: фиг
фила: фил
филипп: филипп
филиус: филиус
филлипс: филлипс
философский: философский
филч: филч
фильм: фильм фильме фильмов фильмах фильма фильмы
финеас: финеас
финниган: финниган
финч: финч
фиона: фиона
фирн: фирн
фирон: фирон
фиш: фиш
фишер: фишер
фламель: фламель
флетчер: флетчер
флетчли: флетчли
флинт: флинт
флитвик: флитвик
флитвуд: флитвуд
флоренц: флоренц
фогель: фогель
фоглер: фоглер
фонд: фонд
форум: форум
франшиза: франшиза франшизы
фрастон: фрастон
фред: фред
фредди: фредди
френч: френч
фрэнк: фрэнк
фрэнсис: фрэнсис
фэйт: фэйт
фэнтези: фэнтези
фэрли: фэрли
хагрид: хагрид
хайндс: хайндс
хайнс: хайнс
ханна: ханна
хант: хант
хантер: хантер
харди: харди
харрис: харрис
харт: харт
хвост: хвост
хедайя: хедайя
хейзел: хейзел
хейман: хейман
хейманом: хейманом
хелен: хелен
хелена: хелена
хельмут: хельмут
хендерсон: хендерсон
хердман: хердман
хиггс: хиггс
хизер: хизер
хикс: хикс
хиро: хиро
хиткот: хиткот
хмелкирк: хмелкирк
хобби: хобби
ховард: ховард
хогвартс: хогвартс
хогвартса: хогвартса
ходоровски: ходоровски
хопкинс: хопкинс
хоффман: хоффман
хронология: хронология
хупер: хупер
хью: хью
хьюго: хьюго
хьюз: хьюз
хьюс: хьюс
цитировать: цитировать
чан: чан
чанг: чанг
чарити: чарити
чарли: чарли
чарльз: чарльз
часть: частей часть
чемпионат: чемпионат
чернильный: чернильно
честити: честити
честь: честь
чжоу: чжоу
читать: читать
чоудхури: чоудхури
шаблон: шаблон
шана: шан
шанпайк: шанпайк
шарлотта: шарлотта
шармбатон: шармбатон
шаффер: шаффер
шах: шах
шелкопряд: шелкопряд
шербеджия: шербеджия
шефали: шефали
шиннер: шиннер
ширли: ширли
ширма: ширм
шляпа: шляпа
шон: шон
шоу: шоу
шпильман: шпильман
ы: ы
эббот: эббот
эванна: эванна
эверард: эверард
эггерт: эггерт
эдварда: эдвард
эдди: эдди
эджого: эджого
эдит: эдит
эдриан: эдриан
эдуард: эдуарду
эзра: эзра
экранизация: экранизации экранизаций
экранизировать: экранизирована
элдред: элдред
элемент: элемент
элизабет: элизабет
элинор: элинор
элиса: элис
элисон: элисон
элли: элли
элфиас: элфиас
эмиль: эмили
эмма: эмма
эммелин: эммелин
энди: энди
энох: энох
энциклопедия: энциклопедии
эппл: эппл
эрик: эрик
эрни: эрни
этот: эта эту
юлали: юлали
юсуф: юсуф
язык: язык языках языке
языковой: языковом
якоб: якоб
яксли: яксли
январь: января
янг: янг
янгблад: янгблад
яневский: яневский
янеский: янеский
